3.0,1.0,1180,1.0,0,0,1180,0,1955,221900.0
3.0,2.25,2570,2.0,0,0,2170,400,1951,538000.0
2.0,1.0,770,1.0,0,0,770,0,1933,180000.0
4.0,3.0,1960,1.0,0,0,1050,910,1965,604000.0
3.0,2.0,1680,1.0,0,0,1680,0,1987,510000.0
4.0,4.5,5420,1.0,0,0,3890,1530,2001,1225000.0
3.0,2.25,1715,2.0,0,0,1715,0,1995,257500.0
3.0,1.5,1060,1.0,0,0,1060,0,1963,291850.0
3.0,1.0,1780,1.0,0,0,1050,730,1960,229500.0
3.0,2.5,1890,2.0,0,0,1890,0,2003,323000.0
3.0,2.5,3560,1.0,0,0,1860,1700,1965,662500.0
2.0,1.0,1160,1.0,0,0,860,300,1942,468000.0
3.0,1.0,1430,1.5,0,0,1430,0,1927,310000.0
3.0,1.75,1370,1.0,0,0,1370,0,1977,400000.0
5.0,2.0,1810,1.5,0,0,1810,0,1900,530000.0
4.0,3.0,2950,2.0,0,3,1980,970,1979,650000.0
3.0,2.0,1890,2.0,0,0,1890,0,1994,395000.0
4.0,1.0,1600,1.5,0,0,1600,0,1916,485000.0
2.0,1.0,1200,1.0,0,0,1200,0,1921,189000.0
3.0,1.0,1250,1.0,0,0,1250,0,1969,230000.0
4.0,1.75,1620,1.0,0,0,860,760,1947,385000.0
3.0,2.75,3050,1.0,0,4,2330,720,1968,2000000.0
5.0,2.5,2270,2.0,0,0,2270,0,1995,285000.0
2.0,1.5,1070,1.0,0,0,1070,0,1985,252700.0
3.0,2.25,2450,2.0,0,0,2450,0,1985,329000.0
3.0,2.0,1710,1.5,0,0,1710,0,1941,233000.0
3.0,1.75,2450,2.0,0,0,1750,700,1915,937000.0
3.0,1.0,1400,1.5,0,0,1400,0,1909,667000.0
3.0,1.75,1520,1.0,0,0,790,730,1948,438000.0
4.0,2.5,2570,2.0,0,0,2570,0,2005,719000.0
3.0,2.5,2320,2.0,0,0,2320,0,2003,580500.0
2.0,1.5,1190,3.0,0,0,1190,0,2005,280000.0
4.0,1.75,2330,1.5,0,0,1510,820,1929,687500.0
3.0,1.0,1090,1.5,0,0,1090,0,1929,535000.0
4.0,2.75,2060,1.0,0,0,1280,780,1981,322500.0
3.0,2.5,2300,1.5,0,0,1510,790,1930,696000.0
4.0,1.0,1660,1.0,0,0,930,730,1933,550000.0
4.0,2.0,2360,2.0,0,0,2360,0,1904,640000.0
4.0,1.0,1220,1.0,0,0,890,330,1969,240000.0
4.0,2.5,2620,2.0,0,0,2620,0,1996,605000.0
4.0,2.5,2570,2.0,0,0,2570,0,2000,625000.0
4.0,2.25,4220,1.0,0,0,2600,1620,1984,775000.0
5.0,2.75,3595,2.0,0,0,3595,0,2014,861990.0
3.0,1.0,1570,2.0,0,0,1570,0,1922,685000.0
3.0,1.0,1280,1.0,0,0,920,360,1959,309000.0
3.0,2.5,3160,2.0,0,0,3160,0,2003,488000.0
3.0,1.0,990,1.0,0,0,990,0,1966,210490.0
4.0,2.5,2290,2.0,0,0,2290,0,1981,785000.0
3.0,1.75,1250,1.0,0,0,1250,0,1953,450000.0
3.0,2.5,2753,1.0,1,2,2165,588,1953,1350000.0
3.0,1.0,1190,1.0,0,0,1190,0,1955,228000.0
5.0,2.5,3150,1.0,0,0,1640,1510,1966,345000.0
3.0,1.75,1410,1.0,0,0,1000,410,1950,600000.0
2.0,1.75,1980,1.0,0,0,990,990,1981,585000.0
5.0,2.25,2730,1.5,0,0,2130,600,1927,920000.0
4.0,2.5,2830,2.0,0,0,2830,0,1995,885000.0
4.0,2.5,2250,2.0,0,0,2250,0,2008,292500.0
3.0,2.5,2420,2.0,0,0,2420,0,2003,301000.0
5.0,3.25,3250,2.0,0,4,3250,0,1968,951000.0
4.0,3.0,1850,2.0,0,0,1850,0,1991,430000.0
3.0,2.25,2150,1.0,0,3,1590,560,1959,650000.0
3.0,1.75,1260,1.0,0,0,1260,0,1954,289000.0
3.0,1.75,2519,2.0,0,0,2519,0,1973,505000.0
3.0,1.75,1540,3.0,0,0,1540,0,2014,549000.0
3.0,2.25,1660,1.0,0,0,1110,550,1979,425000.0
3.0,2.75,2770,1.5,0,0,1770,1000,1925,317625.0
4.0,2.5,2720,2.0,0,0,2720,0,1989,975000.0
4.0,2.5,2240,2.0,0,0,2240,0,2005,287000.0
3.0,1.0,1000,1.0,0,0,1000,0,1968,204000.0
5.0,2.25,3200,1.0,0,0,1600,1600,1965,1325000.0
5.0,3.25,4770,1.0,0,0,3070,1700,1973,1040000.0
3.0,2.0,1260,1.0,0,0,1260,0,1972,325000.0
4.0,2.0,2750,1.5,0,0,2250,500,1916,571000.0
4.0,2.5,2380,2.0,0,0,2380,0,2005,360000.0
3.0,1.75,1790,1.0,0,0,1090,700,1965,349000.0
4.0,4.0,3430,2.0,0,0,2390,1040,1986,832500.0
4.0,1.75,1760,1.0,0,0,880,880,1956,380000.0
3.0,1.0,1040,1.0,0,0,1040,0,1941,480000.0
3.0,1.0,1410,1.0,0,0,910,500,1956,410000.0
4.0,2.5,3450,2.0,0,0,3450,0,2002,720000.0
3.0,2.5,2350,2.0,0,0,2350,0,2003,390000.0
4.0,2.5,1900,2.0,0,0,1900,0,1992,360000.0
2.0,1.0,2020,1.0,0,0,1010,1010,1948,355000.0
3.0,1.5,1680,1.0,0,0,1680,0,1964,356000.0
3.0,1.0,960,1.0,0,0,960,0,1952,315000.0
3.0,1.5,2140,2.0,0,0,1900,240,1925,940000.0
5.0,2.25,2660,1.5,0,0,2660,0,1961,305000.0
3.0,3.25,2770,2.0,0,0,1980,790,2006,461000.0
2.0,2.25,1610,2.0,0,0,1610,0,1979,215000.0
2.0,1.75,1030,2.0,0,0,765,265,2006,335000.0
4.0,2.5,1980,2.0,0,0,1980,0,1988,243500.0
5.0,2.75,3520,2.0,0,0,3520,0,2001,1099880.0
3.0,1.0,1200,1.0,0,0,1200,0,1962,153000.0
3.0,1.5,1580,1.0,0,0,1290,290,1939,430000.0
3.0,1.5,1580,1.0,0,0,1290,290,1939,700000.0
4.0,2.5,3300,1.0,0,0,2390,910,1946,905000.0
3.0,1.75,1960,1.0,0,0,1960,0,1967,247500.0
4.0,1.5,1160,1.0,0,0,1160,0,1975,199000.0
3.0,1.75,1810,1.0,0,0,1210,600,1980,314000.0
3.0,2.5,2320,2.0,0,2,2320,0,1992,437500.0
3.0,2.5,2070,1.5,0,0,1270,800,1910,850830.0
3.0,2.0,1980,1.5,0,0,1440,540,1929,555000.0
3.0,2.25,2190,2.0,0,0,2190,0,1983,699950.0
3.0,2.5,2920,2.0,0,0,2920,0,1950,1088000.0
3.0,1.0,1210,1.0,0,0,1210,0,1954,290000.0
3.0,2.5,2340,1.0,0,0,1460,880,1978,375000.0
3.0,1.0,1670,1.5,0,0,1170,500,1939,460000.0
2.0,1.75,1240,1.0,0,0,1240,0,1985,188500.0
4.0,2.5,3140,2.0,0,0,3140,0,1991,680000.0
5.0,1.75,2030,2.0,0,0,2030,0,1942,470000.0
4.0,2.5,2310,2.0,0,0,2310,0,1984,597750.0
3.0,1.75,1260,1.0,0,0,700,560,1905,570000.0
3.0,1.75,1540,1.0,0,0,1160,380,1980,272500.0
3.0,1.75,2080,1.0,0,2,1080,1000,1971,329950.0
4.0,2.5,3230,2.0,0,3,2520,710,2001,480000.0
3.0,3.5,4380,2.0,0,0,2780,1600,1900,740500.0
3.0,3.5,1590,3.0,0,0,1590,0,2010,518500.0
2.0,1.0,880,1.0,0,0,880,0,1945,205425.0
4.0,2.0,1570,1.0,0,0,1570,0,1950,171800.0
4.0,1.0,1610,1.5,0,0,1610,0,1925,535000.0
3.0,2.5,2400,1.0,0,2,1560,840,1964,660000.0
3.0,2.0,1450,1.0,0,0,1450,0,1987,391500.0
2.0,1.0,770,1.0,0,0,770,0,1953,395000.0
4.0,1.75,2100,1.5,0,0,1720,380,1924,445000.0
3.0,2.25,2910,2.0,0,0,2910,0,1990,770000.0
4.0,2.75,2750,1.5,0,0,1980,770,1914,1450000.0
3.0,2.25,2100,1.0,0,2,1620,480,1967,445000.0
4.0,2.25,2160,1.0,0,0,1360,800,1978,260000.0
5.0,3.5,2320,2.0,0,0,1720,600,1926,822500.0
4.0,2.5,2070,2.0,0,0,2070,0,2004,430000.0
3.0,1.75,1060,1.0,0,0,1060,0,1986,212000.0
4.0,2.25,2010,1.0,0,0,1440,570,1986,660500.0
3.0,3.5,3950,1.5,0,0,2460,1490,1989,784000.0
3.0,2.5,2010,2.0,0,0,1390,620,2014,453246.0
4.0,3.5,2140,3.0,0,0,2140,0,2005,675000.0
3.0,1.75,1320,1.0,0,0,1320,0,1956,199000.0
4.0,1.75,2020,1.0,0,0,1010,1010,1968,220000.0
4.0,2.25,2590,1.0,0,0,1340,1250,1968,452000.0
2.0,1.0,1190,1.0,0,0,1190,0,1981,382500.0
3.0,2.25,1170,3.0,0,0,1170,0,2014,519950.0
2.0,1.0,1110,1.0,0,0,1110,0,1925,665000.0
5.0,2.5,2820,1.0,0,0,1550,1270,1968,527700.0
3.0,1.0,1610,1.0,0,0,1010,600,1962,205000.0
3.0,1.0,1060,1.0,0,0,940,120,1923,420000.0
4.0,2.25,2030,1.0,0,0,1380,650,1961,500000.0
4.0,2.5,3670,2.0,0,0,3670,0,1994,921500.0
4.0,1.0,2550,2.0,0,0,2370,180,1905,890000.0
2.0,2.5,2420,2.0,0,0,2420,0,2007,430000.0
5.0,2.0,2260,1.0,0,0,1130,1130,1960,258000.0
3.0,1.0,1430,1.0,0,0,980,450,1947,511000.0
3.0,2.0,1360,2.0,0,0,1360,0,1990,532170.0
3.0,1.0,1110,1.5,0,0,1110,0,1947,560000.0
3.0,1.0,1250,1.0,0,0,1250,0,1954,282950.0
4.0,3.25,5180,2.0,0,3,3540,1640,2006,2250000.0
1.0,1.0,700,1.0,0,0,700,0,1942,350000.0
3.0,1.0,1180,1.0,0,0,1180,0,1967,215000.0
5.0,3.5,3960,2.0,0,0,2500,1460,1996,650000.0
4.0,2.75,2640,1.0,0,0,1620,1020,1967,320000.0
3.0,2.0,1270,1.5,0,0,1270,0,1916,247000.0
4.0,1.75,1760,1.0,0,0,1760,0,1968,320000.0
5.0,2.25,2060,1.0,0,0,1030,1030,1962,255000.0
3.0,1.75,1780,1.0,0,0,1780,0,1962,438000.0
3.0,2.5,3400,2.0,0,0,3400,0,2000,900000.0
3.0,2.75,1910,1.0,0,0,1160,750,1979,441000.0
3.0,2.0,2020,1.0,0,0,1010,1010,1975,420000.0
3.0,1.75,1580,1.0,0,0,1180,400,1976,370000.0
2.0,1.75,1340,1.0,0,0,700,640,1949,269950.0
4.0,2.5,2680,2.0,0,0,2680,0,1999,807100.0
3.0,2.5,2680,1.0,0,0,1610,1070,1979,653000.0
3.0,2.0,1370,1.0,0,0,1370,0,1964,371500.0
3.0,1.75,1560,1.0,0,0,1560,0,1954,284000.0
3.0,1.75,2160,1.0,0,0,1670,490,1978,272000.0
3.0,1.5,1340,1.5,0,0,1340,0,1955,313000.0
4.0,2.5,3880,2.0,0,0,2570,1310,1984,917500.0
4.0,2.25,2590,2.0,0,0,2590,0,1980,673000.0
3.0,2.5,1120,2.0,0,0,820,300,2008,425000.0
5.0,2.75,1970,1.0,0,0,1320,650,1986,399950.0
3.0,1.0,1220,1.0,0,0,1220,0,1901,385000.0
3.0,1.5,1950,1.0,0,2,1320,630,1975,269950.0
2.0,1.0,1350,1.0,0,0,1060,290,1949,330000.0
3.0,2.5,1670,2.0,0,0,1670,0,1988,260000.0
4.0,3.0,2380,1.5,0,0,1680,700,1925,470000.0
4.0,3.0,2440,2.0,0,0,2440,0,1961,589000.0
2.0,1.5,1050,2.0,0,0,1050,0,1996,163500.0
4.0,2.75,3130,2.0,0,0,2140,990,1993,835000.0
5.0,3.0,4090,1.0,0,2,2090,2000,1986,1095000.0
4.0,1.75,1490,1.0,0,0,1100,390,1969,269000.0
3.0,2.5,1900,2.0,0,0,1900,0,1987,560000.0
4.0,1.0,1330,1.5,0,0,1330,0,1901,615000.0
3.0,2.25,2230,1.0,0,0,1430,800,1975,585188.0
3.0,1.75,1650,1.0,0,0,1220,430,1977,305000.0
3.0,1.0,1190,1.0,0,0,1190,0,1959,166950.0
3.0,2.5,2140,1.0,0,0,2140,0,1959,799000.0
3.0,2.5,2180,1.0,0,0,1420,760,1962,400000.0
3.0,1.0,1060,1.0,0,0,1060,0,1948,230000.0
3.0,2.5,1690,2.0,0,0,1690,0,2003,256883.0
4.0,2.0,1970,1.5,0,0,1130,840,1920,423000.0
3.0,2.5,2150,2.0,0,0,2150,0,2007,465000.0
3.0,2.5,1910,2.0,0,0,1910,0,1997,440000.0
3.0,1.75,1350,1.0,0,0,1350,0,1969,385000.0
3.0,1.0,860,1.0,0,0,860,0,1943,210000.0
3.0,2.5,1940,2.0,0,0,1940,0,1994,297000.0
3.0,1.0,1010,1.0,0,0,1010,0,1952,470000.0
3.0,1.5,1300,1.0,0,0,900,400,1976,226500.0
3.0,1.0,910,1.0,0,0,910,0,1962,274250.0
4.0,1.75,2480,1.0,0,0,1630,850,1966,840000.0
3.0,2.5,2440,2.0,0,0,2440,0,2010,677900.0
3.0,1.0,1010,1.0,0,0,1010,0,1915,425000.0
2.0,0.75,900,1.0,0,0,900,0,1941,180250.0
6.0,3.0,2300,2.0,0,0,1600,700,1920,464000.0
4.0,2.25,1550,2.0,0,0,1550,0,1993,320000.0
3.0,2.25,1270,2.0,0,0,1060,210,2014,625504.0
4.0,2.5,2240,1.0,0,0,2240,0,1983,592500.0
3.0,2.5,2714,2.0,0,0,2714,0,2005,465000.0
4.0,2.75,1720,2.0,0,0,1720,0,1978,477000.0
2.0,1.0,850,1.0,0,0,850,0,1923,280000.0
5.0,3.0,3300,1.0,0,3,1870,1430,1957,1505000.0
3.0,2.5,2250,2.0,0,0,2250,0,2000,445838.0
2.0,2.25,3900,1.0,0,3,1950,1950,1947,1072000.0
2.0,1.5,1320,1.0,0,0,1320,0,1947,467000.0
4.0,2.5,2760,2.0,0,0,2760,0,1999,686000.0
3.0,2.0,1750,1.0,0,0,1350,400,1961,279950.0
4.0,2.25,2330,2.0,0,0,2330,0,1987,527000.0
3.0,2.25,2220,1.0,0,0,1780,440,1966,325000.0
3.0,2.25,2020,2.0,0,0,2020,0,1994,328000.0
3.0,2.25,1250,1.0,0,0,1250,0,1942,390000.0
2.0,2.0,1510,1.0,0,0,1510,0,2005,479950.0
4.0,2.25,1720,1.0,0,0,1120,600,1978,264950.0
3.0,1.0,1430,1.0,0,0,980,450,1961,235000.0
3.0,2.5,1480,2.0,0,0,1480,0,2004,516500.0
2.0,1.75,1450,2.0,1,4,1230,220,1915,655000.0
4.0,2.75,2280,1.0,0,0,2280,0,1960,500000.0
6.0,2.75,2940,1.0,0,0,1780,1160,1978,315000.0
2.0,1.0,1000,1.0,0,0,1000,0,1961,213000.0
3.0,1.5,2480,1.5,0,0,1620,860,1947,475000.0
5.0,4.0,3760,2.0,0,0,3760,0,1983,1025000.0
3.0,2.0,2220,1.0,0,0,1640,580,1976,416000.0
4.0,1.0,1970,1.5,0,0,1670,300,1904,410000.0
3.0,3.5,3830,2.0,0,0,3530,300,1993,800000.0
6.0,2.5,4410,1.0,0,2,2350,2060,1965,472000.0
3.0,1.75,1430,1.0,0,0,1430,0,1968,225000.0
2.0,1.0,830,1.0,0,0,830,0,1940,210000.0
2.0,1.0,1430,1.5,0,0,1430,0,1925,455000.0
3.0,1.0,1300,1.0,0,0,1300,0,1954,225000.0
2.0,1.0,1030,1.0,0,2,790,240,1918,480000.0
3.0,2.5,2740,2.0,0,0,2740,0,1990,363000.0
4.0,2.5,3650,1.0,1,4,1830,1820,2000,2400000.0
2.0,1.5,720,1.0,0,0,720,0,1954,181000.0
4.0,2.0,2010,1.0,0,0,2010,0,1976,250000.0
3.0,1.75,1560,1.0,0,0,770,790,1918,481000.0
3.0,2.0,1810,1.0,0,0,1240,570,1978,260000.0
4.0,2.5,3360,2.0,0,0,3360,0,2001,455000.0
3.0,2.25,1510,2.0,0,0,1510,0,1991,415000.0
3.0,1.0,1400,1.0,0,0,800,600,1953,349500.0
3.0,2.5,1730,2.0,0,0,1730,0,1987,245000.0
2.0,2.0,1420,1.5,0,2,1420,0,1928,592500.0
4.0,1.75,2360,1.0,0,0,1180,1180,1955,385000.0
3.0,1.75,1580,1.0,0,0,1200,380,1974,315000.0
3.0,1.0,1230,1.0,0,0,1230,0,1979,255000.0
4.0,2.5,2460,2.0,0,0,2460,0,2006,693000.0
3.0,1.0,1660,1.5,0,0,1460,200,1911,780000.0
3.0,1.75,1270,1.0,0,0,1270,0,1960,237000.0
3.0,2.25,2100,2.0,0,0,1320,780,1979,525000.0
2.0,1.0,770,1.0,0,0,770,0,1930,425000.0
1.0,0.75,760,1.0,1,4,760,0,1936,369900.0
4.0,2.5,1700,2.0,0,0,1700,0,1988,290000.0
3.0,1.0,1120,1.0,0,0,1120,0,1954,285000.0
2.0,1.0,1070,1.0,0,0,1070,0,1937,415000.0
3.0,2.5,2070,1.0,0,0,1420,650,1979,272500.0
4.0,3.25,5050,1.5,0,2,4750,300,1982,2900000.0
4.0,4.75,5310,2.0,0,0,5310,0,1989,1365000.0
2.0,1.0,1040,1.0,0,0,1040,0,1939,436000.0
3.0,1.0,1700,1.0,0,0,1700,0,1967,210000.0
3.0,1.0,1300,1.0,0,0,1300,0,1961,236000.0
3.0,1.75,1080,1.0,0,0,580,500,1954,331000.0
3.0,2.5,2653,2.0,0,0,2653,0,2006,365000.0
3.0,2.0,2290,1.0,0,0,2290,0,1960,450000.0
4.0,2.75,3820,2.0,0,0,2850,970,2014,770000.0
4.0,2.5,2210,1.0,0,0,2210,0,1997,455000.0
3.0,1.75,2390,1.0,0,0,1240,1150,1908,405000.0
4.0,1.75,2600,1.0,0,0,1610,990,1969,304900.0
2.0,1.0,860,1.0,0,0,860,0,1931,170000.0
5.0,3.0,3830,2.0,0,1,2630,1200,1905,2050000.0
4.0,2.5,3500,2.0,0,0,3500,0,2005,780000.0
3.0,3.0,2420,1.0,0,0,1740,680,1988,330000.0
4.0,2.5,2720,2.0,0,0,2720,0,1992,370000.0
5.0,2.25,2500,1.0,0,0,1850,650,1979,467000.0
3.0,1.75,1670,1.0,0,0,1140,530,1980,405000.0
5.0,2.25,2900,1.0,0,0,1450,1450,1985,675000.0
2.0,1.0,1640,1.0,0,0,1140,500,1954,500000.0
4.0,2.5,1890,2.0,0,0,1890,0,1968,389999.0
4.0,1.75,2950,1.0,0,2,1780,1170,1975,630000.0
4.0,2.5,2160,2.0,0,0,2160,0,1992,360000.0
4.0,3.0,3280,2.0,0,0,2270,1010,1986,580000.0
3.0,2.0,1970,2.0,0,3,1270,700,1929,550000.0
4.0,2.5,3360,2.0,0,0,3360,0,1994,879000.0
3.0,2.0,1320,1.0,0,0,1320,0,1993,265000.0
3.0,2.5,2650,2.0,0,0,2650,0,1990,446500.0
3.0,1.5,2030,1.0,0,0,1330,700,1963,404000.0
3.0,1.75,1590,1.0,0,2,1090,500,1957,267500.0
4.0,5.0,4550,1.0,1,4,2600,1950,2002,3075000.0
3.0,2.5,2440,2.0,0,0,2440,0,1998,335000.0
3.0,2.5,1940,1.0,0,0,970,970,1948,576000.0
3.0,2.5,2040,2.0,0,0,2040,0,2006,208633.0
3.0,2.25,2200,1.0,0,0,1120,1080,1964,315000.0
3.0,1.75,1920,1.0,0,0,960,960,1913,725000.0
4.0,2.75,1800,1.0,0,0,1400,400,1965,550000.0
4.0,2.25,2180,2.0,0,0,2180,0,1984,610750.0
2.0,1.0,1010,1.5,0,0,1010,0,1908,550700.0
4.0,2.75,3320,2.0,0,0,2220,1100,1960,665000.0
4.0,2.5,2370,1.5,0,2,1980,390,1928,834000.0
5.0,1.75,1660,1.5,0,0,1660,0,1915,201000.0
5.0,2.5,3650,2.0,0,4,3370,280,1921,2384000.0
4.0,3.25,4290,1.0,0,3,2690,1600,1997,1384000.0
4.0,3.25,4290,1.0,0,3,2690,1600,1997,1400000.0
4.0,2.25,1950,1.0,0,0,1350,600,1979,305000.0
3.0,2.0,2590,1.0,0,0,1720,870,1948,487000.0
3.0,2.5,1930,1.0,0,0,1930,0,1988,390000.0
2.0,1.0,1470,1.0,0,0,1170,300,1916,548000.0
4.0,1.0,800,1.0,0,0,800,0,1943,268750.0
5.0,2.75,3150,2.0,0,0,3150,0,2013,819900.0
3.0,2.25,2030,2.0,0,0,2030,0,1984,520000.0
3.0,2.0,1450,1.0,0,0,1450,0,2003,230000.0
3.0,1.75,1510,1.0,0,0,1510,0,1969,240000.0
2.0,1.0,1240,1.0,0,0,960,280,1922,232000.0
2.0,1.0,1240,1.0,0,0,960,280,1922,240500.0
3.0,2.5,3030,2.0,0,0,3030,0,1987,274975.0
4.0,2.0,2050,1.5,0,0,2050,0,1922,740000.0
3.0,1.0,1000,1.0,0,0,1000,0,1952,186375.0
3.0,2.25,2370,1.0,0,0,1590,780,1977,790000.0
4.0,3.5,2800,2.0,0,0,1890,910,1951,880000.0
6.0,1.75,2240,2.0,0,0,2240,0,1955,279000.0
3.0,2.0,1810,1.0,0,2,1810,0,1991,295000.0
2.0,1.0,1070,1.0,0,0,1070,0,1924,640000.0
4.0,2.0,2490,2.0,0,0,2490,0,1968,940000.0
4.0,2.5,1960,2.0,0,0,1960,0,2003,260000.0
3.0,2.75,2930,1.0,0,0,1860,1070,2004,559900.0
4.0,2.0,1510,1.5,0,0,1510,0,1911,791500.0
3.0,1.75,1420,1.0,0,0,1420,0,1954,265000.0
3.0,1.75,1740,1.0,0,0,1740,0,1954,245000.0
4.0,1.75,2560,2.0,0,0,2560,0,1962,485000.0
4.0,3.5,3040,2.0,0,0,2420,620,2010,684000.0
3.0,1.75,2500,1.0,0,0,1300,1200,1957,425000.0
4.0,1.75,1275,1.0,0,0,1275,0,1991,309600.0
4.0,2.5,2580,2.0,0,0,2580,0,2002,552250.0
4.0,1.0,1000,1.0,0,0,1000,0,1943,165000.0
4.0,1.0,1000,1.0,0,0,1000,0,1943,239900.0
2.0,1.0,1070,1.0,0,0,1070,0,1930,320000.0
3.0,2.0,1390,1.0,0,0,1390,0,1987,206600.0
4.0,1.75,2500,1.0,0,0,1250,1250,1973,387000.0
1.0,0.75,560,1.0,0,0,560,0,1967,299000.0
4.0,2.75,2270,2.0,0,0,2270,0,1965,855000.0
3.0,1.0,1900,1.0,0,0,1300,600,1954,315000.0
2.0,1.0,990,1.0,0,2,790,200,1907,437500.0
4.0,1.5,1550,1.0,0,0,1050,500,1969,252000.0
4.0,1.75,2200,1.0,0,0,1100,1100,1955,375000.0
4.0,2.5,1910,2.0,0,0,1910,0,2005,300000.0
4.0,1.0,1750,1.5,0,0,1750,0,1954,420000.0
3.0,1.0,1330,1.0,0,0,1330,0,1928,900000.0
3.0,2.5,2440,2.0,0,2,1980,460,2000,679900.0
3.0,2.5,1640,2.0,0,0,1640,0,1992,463000.0
5.0,2.5,2760,2.0,0,0,2760,0,1978,380000.0
4.0,2.5,1820,2.0,0,0,1820,0,1994,329500.0
3.0,2.5,2110,1.0,0,0,1340,770,2013,604950.0
5.0,2.5,3040,1.0,0,2,1640,1400,1966,795000.0
3.0,2.0,1840,2.0,0,0,1840,0,1994,465000.0
4.0,2.5,2990,2.0,0,0,2990,0,2002,673000.0
4.0,2.5,3520,2.0,0,0,3520,0,1991,810000.0
4.0,2.75,2440,1.0,0,0,1910,530,1989,785000.0
4.0,3.0,2090,1.0,0,0,1370,720,1986,338000.0
3.0,2.25,1430,2.0,0,0,1430,0,1993,280000.0
4.0,2.25,2180,1.0,0,0,1100,1080,1954,315000.0
4.0,2.25,2180,1.0,0,0,1100,1080,1954,530000.0
5.0,3.0,3450,2.0,0,0,3450,0,2004,380000.0
3.0,2.25,1450,2.0,0,0,1450,0,1994,297000.0
4.0,2.5,3230,2.0,0,0,3230,0,2004,730000.0
3.0,1.75,1640,1.0,0,0,1110,530,1940,450000.0
3.0,3.0,1590,1.0,0,0,1060,530,1997,275000.0
4.0,2.0,2020,2.0,0,0,2020,0,1960,595000.0
3.0,1.5,1300,1.5,0,0,1300,0,1904,435000.0
2.0,1.5,1380,1.0,0,0,1380,0,1954,270000.0
3.0,3.0,4040,2.0,0,0,3030,1010,1986,950000.0
4.0,2.25,2130,2.0,0,0,2130,0,2001,389000.0
4.0,2.25,2550,1.0,0,0,1580,970,1968,560000.0
5.0,3.5,4800,2.0,0,2,3480,1320,1998,1350000.0
4.0,2.25,2510,2.0,0,0,2510,0,1969,799000.0
3.0,2.0,1410,1.0,0,0,1410,0,1983,365500.0
3.0,2.0,1650,1.0,0,0,1160,490,1979,252350.0
4.0,2.5,2120,2.0,0,0,2120,0,1993,403950.0
4.0,1.5,2040,1.0,0,0,1380,660,1954,385000.0
4.0,1.0,1550,1.5,0,0,1550,0,1957,345000.0
3.0,2.75,1980,2.0,0,0,1980,0,1979,490000.0
3.0,2.5,1600,2.0,0,0,1600,0,2005,330000.0
4.0,2.75,3300,2.0,0,0,3300,0,1953,927000.0
4.0,2.5,3840,2.0,0,1,3840,0,1983,1118000.0
2.0,1.0,1220,1.0,0,0,1220,0,1950,330000.0
5.0,2.25,2720,1.0,0,0,1500,1220,1958,530000.0
4.0,2.0,1940,1.0,0,0,1940,0,1962,365000.0
3.0,2.5,2160,1.5,0,0,1260,900,1909,378750.0
4.0,1.75,1530,1.5,0,0,1530,0,1968,269900.0
3.0,3.5,1710,2.0,0,0,1290,420,2008,557000.0
4.0,1.75,3730,1.0,0,0,2150,1580,1974,360000.0
2.0,1.0,940,1.0,0,0,940,0,1937,352000.0
3.0,2.5,1750,2.0,0,0,1750,0,1994,437000.0
4.0,2.5,1820,2.0,0,0,1820,0,1994,322500.0
3.0,3.25,1510,2.0,0,0,1330,180,2001,650000.0
3.0,2.0,1290,3.0,0,0,1290,0,2001,450000.0
3.0,2.0,1570,1.0,0,0,1570,0,1998,278500.0
4.0,2.5,1930,2.0,0,0,1930,0,1995,364950.0
4.0,3.5,2840,1.0,0,4,2840,0,1986,840000.0
3.0,2.5,1550,2.0,0,0,1550,0,1991,268000.0
2.0,1.0,833,1.0,0,0,833,0,2006,517534.0
3.0,2.5,2990,2.0,0,0,2990,0,1978,632925.0
3.0,2.5,2000,2.0,0,0,2000,0,1995,577500.0
4.0,1.5,2390,1.5,0,2,2390,0,1920,339000.0
3.0,1.75,2910,1.0,0,0,1530,1380,1967,570000.0
4.0,1.75,2085,1.0,0,0,1610,475,1964,563500.0
4.0,2.25,2200,1.0,0,0,1290,910,1962,423000.0
3.0,2.25,1860,2.0,0,0,1860,0,2012,355000.0
5.0,4.25,6070,2.0,0,0,6070,0,1999,1550000.0
2.0,1.0,950,1.0,0,0,950,0,1941,482000.0
3.0,1.75,1600,1.0,0,0,1600,0,1955,625000.0
3.0,2.5,2250,2.0,0,0,2250,0,1988,538000.0
3.0,2.5,2280,2.0,0,0,2280,0,1985,380000.0
2.0,1.0,940,1.0,0,0,940,0,1909,375000.0
3.0,2.5,1530,1.0,0,0,1030,500,1996,245000.0
5.0,1.75,2190,1.0,0,0,2190,0,1947,310000.0
3.0,2.0,2350,1.0,0,0,1770,580,1976,1300000.0
4.0,2.0,1440,1.0,0,0,1200,240,1971,397000.0
3.0,2.5,2200,2.0,0,0,2200,0,2005,365000.0
4.0,3.0,2290,2.0,0,0,2290,0,1990,328500.0
4.0,3.0,4040,2.0,0,0,4040,0,1987,988000.0
4.0,2.5,2610,1.5,0,0,1920,690,1922,1000000.0
3.0,2.5,1490,2.0,0,0,1490,0,2005,237000.0
4.0,2.5,2450,2.0,0,0,2450,0,2003,525000.0
4.0,2.5,1710,1.0,0,0,1440,270,1976,749000.0
5.0,2.5,4870,2.0,0,0,3470,1400,1983,722500.0
3.0,2.5,3130,2.0,0,0,3130,0,1991,843000.0
2.0,2.0,1270,3.0,0,0,1270,0,2000,438000.0
3.0,1.75,2120,1.0,0,2,1540,580,1977,578000.0
3.0,1.5,1670,1.0,0,0,1670,0,1954,227950.0
3.0,2.25,2070,2.0,0,0,2070,0,1974,196000.0
2.0,1.0,1420,1.0,0,0,1070,350,1953,641000.0
3.0,1.5,1250,1.0,0,0,1250,0,1980,350000.0
3.0,1.0,940,1.0,0,0,940,0,1960,205000.0
3.0,1.75,1920,1.0,0,0,1920,0,1968,400000.0
3.0,2.5,3545,1.0,0,0,2610,935,2005,1030000.0
3.0,2.0,1260,1.0,0,0,1260,0,1972,505000.0
5.0,2.5,2340,1.0,0,0,1300,1040,1975,475000.0
3.0,2.25,2590,1.0,0,0,1440,1150,1977,520000.0
3.0,4.5,3970,2.0,0,2,3260,710,1977,1450000.0
3.0,1.75,1220,1.0,0,0,1220,0,1965,333500.0
3.0,1.0,1400,1.0,0,0,1400,0,1976,232000.0
3.0,2.75,2360,1.0,0,0,1710,650,1983,691100.0
3.0,1.75,1870,1.0,0,0,1870,0,1960,811000.0
3.0,2.5,2830,2.0,0,0,2830,0,2001,551000.0
3.0,2.5,2260,2.0,0,0,2260,0,1994,496500.0
3.0,3.0,1970,2.0,1,3,1770,200,1980,705000.0
4.0,2.5,3140,1.0,0,2,1770,1370,1966,578000.0
3.0,1.75,1240,1.0,0,0,1240,0,1986,255000.0
4.0,3.5,3450,2.0,0,0,3450,0,2007,1050000.0
3.0,2.25,2570,2.0,0,0,2570,0,1989,348000.0
3.0,2.0,1510,2.0,0,0,1510,0,1985,230000.0
4.0,2.25,2390,2.0,0,0,2390,0,1988,359500.0
3.0,1.0,980,1.0,0,0,980,0,1953,330000.0
1.0,0.75,430,1.0,0,0,430,0,1912,80000.0
3.0,1.75,1480,1.0,0,0,1480,0,1954,465000.0
4.0,2.5,1850,2.0,0,0,1850,0,1997,325000.0
3.0,2.0,2270,1.0,0,0,1920,350,1947,340500.0
3.0,2.5,1810,2.0,0,0,1810,0,1993,342500.0
2.0,2.0,1610,2.0,0,0,1610,0,1930,290900.0
3.0,4.25,3840,2.0,0,0,3840,0,2000,868700.0
4.0,2.75,4110,2.0,0,1,3130,980,1928,1199000.0
4.0,3.25,4190,2.0,0,0,3150,1040,2000,1150000.0
4.0,2.75,3390,2.0,0,0,3390,0,2011,859900.0
4.0,2.25,1890,2.0,0,0,1890,0,2003,520000.0
3.0,2.5,1610,2.0,0,2,1080,530,2005,460000.0
3.0,1.5,1050,1.0,0,0,850,200,1949,438924.0
2.0,1.0,630,1.0,0,0,630,0,1918,315000.0
4.0,2.75,2910,1.0,0,2,1780,1130,1975,590000.0
4.0,1.75,1700,1.0,0,0,850,850,1955,378500.0
3.0,2.5,1950,2.0,0,0,1950,0,1990,328500.0
3.0,3.0,2990,2.0,0,0,2990,0,1973,849950.0
3.0,1.5,1350,1.0,0,2,900,450,1950,525000.0
4.0,3.25,4860,2.5,0,0,4860,0,1993,1385000.0
4.0,2.5,2160,1.0,0,0,1460,700,1978,295000.0
6.0,3.5,4860,2.0,0,0,3860,1000,1998,1067000.0
2.0,2.0,890,1.0,0,0,890,0,1917,207950.0
4.0,2.75,2810,2.0,0,0,2810,0,2002,699900.0
5.0,2.5,3400,2.0,0,1,3400,0,1977,1280000.0
4.0,1.5,1580,1.0,0,0,960,620,1963,452000.0
3.0,2.0,1680,1.0,0,1,1680,0,1987,370000.0
3.0,1.75,1300,1.0,0,0,1300,0,1968,232000.0
5.0,2.5,2820,2.0,0,0,2380,440,1960,669950.0
3.0,2.0,1510,1.0,0,0,1070,440,1972,397500.0
2.0,2.5,1230,2.0,0,0,870,360,2004,490000.0
4.0,2.0,2110,2.0,0,0,1710,400,1925,725000.0
3.0,2.75,3080,1.0,0,2,1610,1470,1958,299000.0
2.0,1.5,1490,1.5,0,0,1190,300,1900,625000.0
3.0,2.5,2120,2.0,0,0,2120,0,2000,437500.0
4.0,2.5,3180,2.0,0,0,3180,0,2003,650000.0
2.0,1.0,1490,1.0,0,0,860,630,1929,475000.0
3.0,2.0,1930,1.0,0,0,1930,0,1966,342000.0
4.0,2.5,2770,2.0,0,0,2770,0,1999,1197350.0
3.0,1.5,1670,1.0,0,0,1670,0,1963,280000.0
2.0,1.75,1330,1.0,0,0,1330,0,1993,240000.0
3.0,1.0,1210,1.5,0,0,1210,0,1924,529000.0
3.0,1.0,1190,1.0,0,0,1030,160,1941,442000.0
2.0,1.0,1540,1.0,0,0,820,720,1946,615000.0
4.0,3.75,4030,2.0,0,0,4030,0,2006,1485000.0
4.0,1.75,2430,1.0,0,0,1580,850,1981,585000.0
4.0,2.5,2600,2.0,0,0,2600,0,2005,480000.0
5.0,3.5,4410,2.0,0,0,4410,0,1990,1095000.0
4.0,1.0,1330,1.5,0,0,1330,0,1949,290000.0
3.0,1.75,1900,1.0,0,0,950,950,1951,615000.0
2.0,1.0,1100,1.0,0,0,1100,0,1950,300000.0
3.0,1.0,1980,1.5,0,0,1580,400,1932,308000.0
3.0,2.5,2400,2.0,0,0,2400,0,2001,750000.0
4.0,2.25,4760,2.5,0,0,3390,1370,1916,2250000.0
4.0,3.25,3180,2.0,0,0,3180,0,2005,890000.0
3.0,1.0,1190,1.0,0,0,1190,0,1958,288000.0
2.0,1.0,630,1.0,0,0,630,0,1943,190000.0
5.0,3.0,2530,1.0,0,0,1520,1010,2005,515000.0
4.0,1.5,1690,1.0,0,0,1690,0,1930,235000.0
2.0,1.0,940,1.0,0,0,940,0,1951,275000.0
2.0,2.0,1240,1.0,0,0,1240,0,1952,727500.0
4.0,2.5,3040,2.0,0,0,3040,0,2003,650000.0
6.0,5.0,6050,2.0,0,3,6050,0,2001,1600000.0
4.0,1.0,1590,1.5,0,0,1590,0,1944,365000.0
3.0,1.75,2500,1.0,0,0,2500,0,1984,662000.0
3.0,2.5,1780,1.0,0,0,1320,460,1978,270500.0
2.0,1.5,1360,2.0,0,0,1360,0,1978,200000.0
4.0,3.25,4740,2.0,0,0,4740,0,1987,970000.0
3.0,1.5,1010,1.0,0,0,1010,0,1962,160000.0
3.0,1.0,1040,1.0,0,0,1040,0,1971,204000.0
3.0,2.25,1610,2.0,0,0,1610,0,1985,358000.0
4.0,1.75,1570,1.0,0,0,1570,0,1979,452000.0
2.0,2.0,1510,1.0,0,0,1010,500,1900,595000.0
3.0,2.0,1360,1.0,0,0,1360,0,1994,249000.0
4.0,2.5,1970,2.0,0,0,1970,0,1999,346900.0
3.0,2.5,5403,2.0,1,4,5403,0,1976,2125000.0
4.0,2.5,1560,2.0,0,0,1560,0,2003,280000.0
4.0,1.75,2320,1.0,0,0,2270,50,1973,318888.0
3.0,2.25,2120,1.0,0,0,2120,0,1967,530000.0
3.0,2.25,2120,2.0,0,0,2120,0,1983,375000.0
4.0,2.5,3350,2.0,0,0,3350,0,1988,910000.0
4.0,2.5,2380,2.0,0,0,2380,0,1991,782000.0
2.0,2.0,1070,2.0,0,0,720,350,2008,259950.0
4.0,2.75,2300,1.0,0,0,1560,740,1979,315000.0
2.0,1.0,1320,1.0,0,0,1320,0,1943,215000.0
3.0,1.75,2180,1.0,0,2,1140,1040,1946,705000.0
3.0,3.0,4380,2.0,0,3,3580,800,1952,1450000.0
3.0,1.75,1790,2.0,0,0,1790,0,1949,451000.0
2.0,1.0,750,1.0,0,0,750,0,1943,261000.0
3.0,1.5,1300,1.0,0,0,1300,0,1956,396000.0
4.0,2.5,2990,2.0,0,3,2990,0,1999,725000.0
7.0,3.5,4640,2.0,0,1,2860,1780,1965,1950000.0
4.0,1.0,1400,1.5,0,0,1400,0,1959,238000.0
6.0,1.75,2750,2.0,0,0,2750,0,1973,750000.0
4.0,2.5,2050,2.0,0,0,2050,0,1998,331500.0
4.0,3.0,2230,1.0,0,0,1410,820,1978,460000.0
4.0,2.25,2340,1.0,0,0,2340,0,1982,404950.0
3.0,2.5,2870,2.0,0,0,2870,0,2014,880000.0
4.0,2.5,4120,2.0,0,0,4120,0,1997,863000.0
3.0,1.75,2080,1.0,0,0,1370,710,1960,638700.0
3.0,2.5,1840,2.0,0,0,1840,0,2008,435000.0
3.0,1.0,1180,1.5,0,0,1180,0,1959,260000.0
5.0,2.75,2160,1.5,0,0,1530,630,1927,671500.0
3.0,1.0,1180,1.5,0,0,1180,0,1907,610000.0
2.0,0.75,1160,1.0,0,0,870,290,1937,405000.0
4.0,2.5,1830,2.0,0,0,1830,0,2003,338900.0
4.0,4.0,3200,2.0,0,0,3200,0,2004,720000.0
5.0,3.0,2560,1.5,0,0,1760,800,1927,442000.0
5.0,2.75,2550,1.5,0,0,2550,0,1902,650000.0
3.0,1.75,1330,1.0,0,0,1040,290,1981,263500.0
2.0,1.0,1220,1.0,0,0,1220,0,1963,300000.0
3.0,2.5,1805,2.0,0,0,1805,0,2009,266000.0
4.0,4.0,6050,2.5,0,2,4150,1900,2009,930000.0
4.0,2.5,2320,2.0,0,0,2320,0,2004,530000.0
3.0,1.0,1384,1.0,0,0,1384,0,1965,180000.0
3.0,2.5,2720,2.0,0,0,2720,0,2005,619000.0
3.0,1.5,1820,1.0,0,0,1820,0,1962,264000.0
2.0,2.25,2130,1.5,0,4,1530,600,1941,730000.0
4.0,2.25,2060,2.0,0,0,2060,0,1975,439000.0
4.0,1.75,1420,1.0,0,0,1080,340,1981,268500.0
3.0,1.75,1510,1.0,0,0,1510,0,1985,330000.0
3.0,2.5,2160,1.5,0,0,1960,200,1903,640000.0
3.0,2.5,3180,2.0,0,0,3180,0,1978,900000.0
3.0,2.25,2110,2.0,0,0,2110,0,1985,370000.0
3.0,2.0,2060,1.5,0,0,1330,730,1931,685000.0
3.0,1.5,1830,1.0,0,0,1010,820,1981,505000.0
3.0,1.75,1820,1.0,0,0,1820,0,1966,265000.0
3.0,2.5,1610,2.0,0,0,1610,0,2006,290000.0
4.0,2.5,1780,2.0,0,0,1780,0,2006,296000.0
4.0,2.5,1840,2.0,0,0,1840,0,1996,360000.0
3.0,1.75,1460,1.0,0,0,990,470,1997,240500.0
2.0,2.5,1400,2.0,0,0,1400,0,2007,372500.0
3.0,2.5,3370,2.0,0,2,3370,0,2004,595000.0
4.0,3.0,3590,2.0,0,0,3590,0,1997,515000.0
4.0,2.25,3200,2.0,0,0,3200,0,1962,1220000.0
2.0,1.75,1670,1.0,0,0,1670,0,2004,507000.0
4.0,2.0,2420,1.0,0,0,2420,0,1984,399950.0
3.0,1.75,1430,2.0,0,0,1430,0,1994,185000.0
3.0,1.75,1440,1.0,0,0,1440,0,1980,460000.0
3.0,2.25,1450,2.0,0,0,1450,0,1985,435500.0
4.0,2.75,3550,1.0,0,0,2100,1450,1966,469000.0
2.0,3.0,1270,2.0,0,0,1110,160,2000,531000.0
2.0,1.0,940,1.0,0,0,940,0,1949,443500.0
3.0,2.0,1670,1.0,0,0,1300,370,1990,223000.0
4.0,3.5,3100,2.0,0,0,2400,700,1996,590000.0
2.0,2.5,1100,3.0,0,0,1100,0,1997,340000.0
3.0,2.0,1870,1.0,0,0,1230,640,1925,650000.0
3.0,2.5,1930,2.0,0,0,1930,0,1990,533600.0
3.0,2.75,2540,2.0,0,0,2540,0,2005,695000.0
3.0,1.75,1280,1.5,0,0,1280,0,1988,242000.0
3.0,2.25,1820,1.0,0,0,1280,540,1967,425000.0
3.0,2.25,1490,2.0,0,0,1490,0,1981,525000.0
3.0,2.5,1880,2.0,0,0,1880,0,1988,485000.0
3.0,1.0,1250,1.0,0,0,1250,0,1971,175000.0
3.0,2.0,1440,1.0,0,0,1440,0,1983,210000.0
3.0,2.5,1920,2.0,0,0,1920,0,1989,260000.0
3.0,2.5,2060,1.0,0,0,1330,730,1976,577000.0
3.0,1.5,1210,1.0,0,0,1210,0,1958,200000.0
2.0,1.75,1760,1.0,0,0,940,820,1927,605000.0
3.0,1.0,990,1.0,0,0,990,0,1947,325000.0
3.0,1.0,960,1.0,0,0,820,140,1944,289500.0
3.0,2.5,1660,3.0,0,0,1660,0,2014,559950.0
3.0,1.75,1900,1.0,0,1,1330,570,1941,1042500.0
3.0,2.25,1270,1.0,0,0,990,280,1970,543500.0
4.0,2.25,3250,2.0,0,0,3250,0,1983,480000.0
3.0,1.0,960,1.0,0,0,960,0,1982,218000.0
2.0,1.75,1330,1.0,0,0,960,370,1914,565000.0
3.0,1.75,2080,1.0,0,0,1600,480,1968,426700.0
3.0,2.5,2690,1.0,0,3,2130,560,1957,650000.0
2.0,1.0,890,1.0,0,0,770,120,1910,542000.0
3.0,1.75,1070,1.0,0,0,1070,0,1977,415000.0
3.0,1.0,1200,1.0,0,0,1200,0,1953,214000.0
3.0,1.5,1360,2.0,0,0,1360,0,1949,245000.0
3.0,2.0,2050,1.0,0,0,2050,0,1993,314500.0
3.0,1.5,3000,2.0,0,0,2000,1000,1924,1120000.0
2.0,2.0,1300,1.0,0,0,800,500,1963,378000.0
4.0,2.5,2250,1.0,0,0,1340,910,1982,305000.0
5.0,2.75,3740,1.0,0,0,1980,1760,1978,595000.0
3.0,2.5,1660,3.0,0,1,1530,130,2015,729500.0
3.0,2.5,2360,2.0,0,0,2360,0,2003,430000.0
3.0,1.75,1760,1.0,0,0,1150,610,1987,240000.0
3.0,1.75,1680,1.5,0,0,1680,0,1916,545000.0
3.0,1.75,1320,1.0,0,0,870,450,1918,530000.0
1.0,1.0,870,1.0,0,0,870,0,1939,157000.0
4.0,1.0,1260,1.5,0,0,1260,0,1925,425000.0
3.0,1.0,1000,1.0,0,0,1000,0,1944,220000.0
4.0,1.75,2020,1.0,0,0,1550,470,1976,521000.0
3.0,1.0,1920,1.0,0,2,1120,800,1952,325000.0
3.0,2.0,2150,1.5,0,0,1380,770,1911,597500.0
3.0,2.5,1470,2.0,0,0,1470,0,1999,337000.0
3.0,2.5,3180,2.0,0,2,3180,0,1991,1000000.0
3.0,2.5,3930,1.0,1,4,2330,1600,1957,3070000.0
3.0,1.0,990,1.0,0,0,990,0,1943,495000.0
4.0,3.5,2770,2.0,0,0,1970,800,2001,748000.0
3.0,1.5,1250,1.0,0,0,1250,0,1953,888000.0
3.0,1.75,1140,1.0,0,0,1140,0,1986,269900.0
4.0,2.5,2250,1.0,0,0,1550,700,1967,496500.0
3.0,2.5,1640,2.0,0,0,1640,0,1969,475000.0
3.0,1.5,1255,3.0,0,0,1255,0,2004,312000.0
3.0,1.0,1290,1.0,0,0,1290,0,1976,323000.0
3.0,1.75,1300,1.0,0,0,1300,0,1986,331000.0
3.0,1.5,1220,3.0,0,0,1220,0,2007,306000.0
4.0,2.5,2630,3.0,0,0,2630,0,2002,655000.0
3.0,1.5,1950,1.0,0,0,1950,0,1959,290000.0
4.0,3.25,3160,2.0,0,0,2360,800,1965,1250000.0
3.0,1.75,1550,1.0,0,0,860,690,1949,460000.0
4.0,2.5,1700,1.0,0,0,850,850,1940,435000.0
4.0,2.75,2510,1.0,0,0,1630,880,1978,664000.0
4.0,1.75,1800,2.0,0,3,1800,0,1921,865000.0
3.0,1.75,1800,1.0,0,0,1200,600,1968,385000.0
3.0,2.25,1870,1.0,0,0,1350,520,1975,497000.0
2.0,1.0,1010,1.0,0,0,1010,0,1925,280000.0
2.0,1.5,1120,1.0,0,0,1120,0,1924,188000.0
3.0,1.0,2090,1.0,0,2,1200,890,1969,478500.0
4.0,3.5,4370,2.0,0,0,4370,0,2001,1145000.0
3.0,2.0,1440,1.0,0,0,970,470,1981,222000.0
4.0,3.0,2580,2.0,0,0,2580,0,1984,799000.0
4.0,2.5,3190,2.0,0,0,3190,0,2006,609900.0
4.0,3.5,2380,2.0,0,0,1750,630,1995,413000.0
4.0,1.0,1420,1.5,0,0,1420,0,1930,400000.0
5.0,2.75,2990,2.0,0,0,2990,0,2014,802541.0
3.0,2.5,2680,2.0,0,0,2680,0,1990,320000.0
4.0,2.5,2730,2.0,0,0,2730,0,2006,507000.0
3.0,1.0,1220,1.0,0,0,1220,0,1946,387500.0
3.0,1.0,1500,1.0,0,0,1500,0,1967,396000.0
3.0,1.75,1830,1.0,0,1,1430,400,1958,373000.0
5.0,2.5,4570,2.0,0,0,4570,0,1965,1484900.0
4.0,2.25,2470,2.0,0,0,2470,0,1983,359900.0
2.0,1.0,800,1.0,0,0,670,130,1927,410000.0
4.0,2.5,2900,2.0,0,0,2900,0,1992,690000.0
3.0,2.0,1410,1.0,0,0,1410,0,1985,245000.0
5.0,2.5,2830,1.0,0,1,1610,1220,1979,700000.0
4.0,1.75,1680,1.0,0,0,1100,580,1977,268000.0
3.0,1.75,1760,1.0,0,0,920,840,1979,225000.0
4.0,2.25,2240,2.0,0,0,2240,0,1976,980000.0
2.0,1.0,1380,1.5,0,2,1380,0,1905,795000.0
2.0,1.0,820,1.0,0,0,820,0,1953,195000.0
4.0,2.0,2180,1.0,0,0,1730,450,1950,480000.0
4.0,2.0,1400,1.0,0,0,1100,300,1900,485000.0
2.0,1.0,880,1.0,0,0,880,0,1928,130000.0
2.0,1.0,1060,1.0,0,2,1060,0,1946,325000.0
3.0,1.75,1530,1.0,0,0,1530,0,1984,440000.0
4.0,1.75,2480,1.0,0,3,1460,1020,1958,550000.0
3.0,1.75,1490,1.0,0,0,1490,0,1967,310000.0
3.0,2.5,3660,2.0,0,2,3260,400,1989,530000.0
4.0,2.5,2340,2.0,0,0,2340,0,1993,390000.0
3.0,1.75,1450,1.0,0,0,1450,0,1981,243000.0
4.0,2.5,2210,2.0,0,0,2210,0,1990,639000.0
4.0,1.0,1130,1.0,0,0,1130,0,1969,215000.0
5.0,1.75,1550,1.0,0,0,1100,450,1961,405000.0
4.0,1.75,1710,1.0,0,0,1010,700,1968,250000.0
3.0,1.5,1010,1.0,0,0,1010,0,1954,405500.0
6.0,2.25,2660,2.0,0,0,2660,0,1937,452000.0
6.0,2.25,2660,2.0,0,0,2660,0,1937,730000.0
3.0,2.0,1300,1.0,0,0,1300,0,1994,267000.0
3.0,2.5,1670,2.0,0,0,1670,0,2002,289950.0
2.0,1.0,960,1.0,0,0,960,0,1911,565000.0
4.0,3.25,4670,2.0,0,0,4670,0,1988,1578000.0
3.0,2.5,2140,2.0,0,0,1770,370,2007,636000.0
5.0,3.0,2520,1.0,0,0,1550,970,2004,350000.0
3.0,1.5,1650,1.0,0,0,1130,520,1978,320000.0
2.0,1.75,1440,1.0,0,0,1440,0,1978,210000.0
2.0,1.0,1050,1.0,0,0,1050,0,1950,245000.0
3.0,1.75,1470,1.0,0,0,1130,340,1983,328000.0
4.0,2.25,4230,2.0,0,0,4230,0,1989,985000.0
3.0,1.75,1970,1.0,0,3,1370,600,1976,501000.0
3.0,2.25,1540,2.0,0,0,1540,0,1992,315000.0
3.0,2.75,2090,2.0,0,0,2090,0,2012,403000.0
3.0,2.0,2380,2.0,0,0,2110,270,1934,550000.0
4.0,2.5,2156,2.0,0,0,2156,0,2012,347500.0
4.0,2.25,2070,2.0,0,0,2070,0,1986,365000.0
3.0,1.0,1910,1.0,0,0,1270,640,1951,588000.0
3.0,1.75,1920,1.0,0,0,1260,660,1977,605000.0
3.0,3.25,3400,2.0,0,0,2290,1110,1937,1300000.0
3.0,2.0,1400,1.0,0,0,1400,0,1974,233000.0
4.0,2.5,2210,2.0,0,0,2210,0,1997,360000.0
2.0,1.75,1170,1.0,0,0,1020,150,1929,459000.0
3.0,2.0,2100,1.0,0,0,2100,0,1995,740000.0
3.0,1.0,1160,1.0,0,0,1160,0,1967,305000.0
3.0,1.0,1500,1.0,0,0,900,600,1925,395000.0
4.0,2.5,2940,2.0,0,0,2940,0,2000,560000.0
4.0,1.75,2010,1.0,0,1,1300,710,1963,650000.0
3.0,2.5,2170,2.0,0,0,2170,0,2003,449950.0
3.0,1.5,1430,1.0,0,3,1250,180,1940,517500.0
4.0,1.5,1510,1.0,0,0,1070,440,1970,435000.0
3.0,1.0,1150,1.0,0,0,800,350,1952,329999.0
3.0,1.75,2150,1.0,0,4,1140,1010,1960,950000.0
3.0,1.0,1370,1.0,0,0,1230,140,1944,447000.0
2.0,2.5,2380,1.0,0,0,2380,0,2010,699800.0
3.0,1.75,1370,1.0,0,0,770,600,1911,850000.0
3.0,1.75,1600,1.0,0,0,1070,530,1979,316500.0
5.0,3.5,3750,1.0,0,2,2030,1720,1981,942500.0
2.0,2.25,3950,2.0,0,4,2910,1040,1991,1310000.0
4.0,2.25,2400,1.0,0,0,2400,0,1964,856600.0
5.0,1.5,2830,2.5,0,0,2830,0,1918,405600.0
4.0,2.5,2440,2.0,0,0,2440,0,1996,565000.0
3.0,2.25,1190,2.0,0,0,1050,140,2008,400000.0
3.0,2.0,1400,1.0,0,0,1400,0,1997,330000.0
4.0,2.75,2730,2.0,0,0,2730,0,2005,374950.0
3.0,2.75,2390,1.0,0,0,1610,780,1983,405300.0
3.0,2.25,2060,2.0,0,0,2060,0,1984,560000.0
4.0,2.25,2490,1.0,0,0,1290,1200,1961,824000.0
3.0,1.75,1100,1.0,0,0,1100,0,1984,260000.0
4.0,2.5,2430,1.0,0,0,1470,960,1965,760000.0
3.0,2.5,3170,2.0,0,0,2360,810,1995,405000.0
4.0,2.5,2640,2.0,0,0,2640,0,1987,429900.0
3.0,1.5,1130,1.0,0,0,1130,0,1961,341500.0
5.0,2.0,1940,1.5,0,0,1940,0,1957,465250.0
2.0,2.0,1100,1.5,0,0,1100,0,1912,450000.0
3.0,1.0,1200,1.0,0,0,1200,0,1955,390000.0
3.0,2.25,2000,1.0,0,0,1000,1000,1963,420000.0
3.0,2.5,1890,2.0,0,0,1730,160,2002,269950.0
4.0,2.0,1910,1.0,0,0,1060,850,1910,493000.0
4.0,2.5,2710,2.0,0,0,2710,0,1998,370000.0
5.0,4.25,4860,1.5,0,1,3100,1760,1905,2250000.0
3.0,1.0,1250,1.0,0,0,1250,0,1967,305000.0
3.0,1.75,1590,1.5,0,0,970,620,1938,400000.0
3.0,1.5,1240,2.0,0,0,1050,190,2009,320000.0
4.0,1.0,2000,2.0,0,0,2000,0,1911,715000.0
6.0,2.75,3610,1.5,0,0,3610,0,1966,650000.0
5.0,1.75,1930,1.0,0,0,1930,0,1966,218000.0
2.0,1.0,1280,1.0,0,0,1280,0,1964,500000.0
4.0,2.0,2090,1.0,0,0,2090,0,1984,460000.0
3.0,1.5,1940,1.0,0,0,1140,800,1969,232500.0
3.0,2.5,1800,2.0,0,0,1800,0,1990,408200.0
3.0,1.75,1730,1.0,0,0,1400,330,1980,522000.0
4.0,2.5,2810,2.0,0,0,2810,0,1982,675000.0
4.0,3.5,3550,1.0,0,2,2260,1290,1999,1355000.0
4.0,1.0,1330,1.5,0,0,1330,0,1952,249950.0
2.0,1.0,750,1.0,0,0,750,0,1950,210000.0
4.0,1.0,1760,1.0,0,0,1090,670,1947,429950.0
4.0,2.5,3200,2.0,0,0,3200,0,1993,737500.0
4.0,2.0,1740,1.0,0,0,1740,0,1958,710000.0
3.0,2.5,2100,2.0,0,0,2100,0,1999,470000.0
4.0,3.5,4270,1.0,0,0,4270,0,1993,1100000.0
3.0,2.0,1340,1.5,0,0,1340,0,1913,650000.0
4.0,2.5,3190,1.0,0,3,1680,1510,1967,1216000.0
3.0,2.5,1630,2.0,0,0,1630,0,1987,422120.0
5.0,2.5,2990,2.0,0,0,2990,0,2007,625000.0
4.0,1.0,1550,1.5,0,0,1550,0,1954,385200.0
3.0,2.25,1690,2.0,0,0,1690,0,1989,500000.0
4.0,2.25,1960,2.0,0,0,1960,0,1989,308000.0
3.0,2.75,2390,1.0,0,0,1360,1030,1977,565000.0
3.0,2.5,2600,2.0,0,0,2600,0,2004,581000.0
3.0,2.0,1950,1.0,0,0,1950,0,1999,361000.0
3.0,1.0,1250,1.0,0,0,1250,0,1964,345000.0
2.0,2.25,1180,2.0,0,0,840,340,2008,419000.0
3.0,2.5,1680,2.0,0,0,1680,0,2004,347000.0
4.0,2.25,2220,2.0,0,0,2220,0,1989,625000.0
4.0,4.25,4890,2.0,0,2,3090,1800,1999,2400000.0
3.0,3.25,2660,2.5,0,0,2660,0,2014,379000.0
3.0,1.5,1150,2.0,0,0,1150,0,1988,310000.0
2.0,2.0,1130,1.0,0,0,1130,0,1941,250000.0
5.0,2.75,2760,2.0,0,0,2760,0,2005,682000.0
3.0,2.0,1430,1.0,0,0,1430,0,1992,246500.0
3.0,1.0,1490,1.5,0,0,1490,0,1932,325000.0
4.0,2.5,2030,2.0,0,0,2030,0,2004,310950.0
3.0,2.0,3010,2.0,0,2,1890,1120,1931,1100000.0
3.0,1.0,1810,1.0,0,0,1130,680,1954,287500.0
3.0,1.0,1810,1.0,0,0,1130,680,1954,431000.0
3.0,1.0,970,1.0,0,0,970,0,1968,226000.0
3.0,1.75,2010,1.5,0,0,1510,500,1926,825000.0
4.0,1.0,1300,1.5,0,0,1300,0,1947,175000.0
3.0,1.5,1260,1.0,0,0,1260,0,1959,465750.0
4.0,2.25,2610,2.0,0,0,2610,0,1983,659000.0
3.0,1.75,1910,1.0,0,3,1110,800,1941,595000.0
3.0,2.25,1780,2.0,0,0,1780,0,1987,350000.0
4.0,2.25,1900,1.0,0,0,1900,0,1975,270000.0
6.0,2.25,2450,1.0,0,2,1340,1110,1957,662500.0
3.0,1.75,1380,1.0,0,0,1380,0,1939,249900.0
3.0,1.75,1920,1.0,0,0,1230,690,1977,324500.0
2.0,1.75,1350,1.0,0,0,1350,0,2004,430000.0
2.0,1.75,1350,1.0,0,0,1350,0,2004,419950.0
4.0,1.75,2510,1.0,0,2,1290,1220,1962,285000.0
4.0,2.5,2470,2.0,0,0,2470,0,2002,332000.0
4.0,1.75,1660,1.0,0,0,960,700,1956,282000.0
3.0,1.0,1340,1.0,0,0,940,400,1987,320000.0
3.0,1.0,1620,1.5,0,0,1620,0,1911,428750.0
3.0,2.25,2300,2.0,0,0,2300,0,1977,330000.0
4.0,3.5,2000,3.0,0,0,2000,0,2008,456500.0
3.0,2.25,1640,1.0,0,0,1640,0,1972,352000.0
4.0,2.0,1530,1.5,0,0,1530,0,1912,664000.0
3.0,1.75,4000,1.0,0,0,2190,1810,1987,628000.0
3.0,1.75,1610,1.0,0,0,1080,530,1977,512000.0
3.0,2.0,2070,1.0,0,0,1450,620,1969,254000.0
4.0,2.5,1900,2.0,0,0,1900,0,1994,535800.0
3.0,1.0,1050,1.0,0,0,1050,0,1960,287653.0
3.0,2.5,1520,2.0,0,0,1180,340,2006,438000.0
4.0,1.75,2390,1.0,0,0,1750,640,1949,450000.0
5.0,2.75,2400,2.0,0,0,2400,0,1998,327000.0
4.0,2.5,1790,2.0,0,0,1790,0,2005,370500.0
3.0,2.5,1720,2.0,0,0,1720,0,1993,265000.0
4.0,2.75,2980,1.0,0,0,1800,1180,1979,450000.0
3.0,1.0,1520,1.5,0,3,1520,0,1988,425000.0
3.0,1.75,1150,1.0,0,0,1150,0,1977,166600.0
1.0,0.75,380,1.0,0,0,380,0,1963,245000.0
3.0,1.0,910,1.0,0,0,910,0,1951,565000.0
3.0,1.75,1650,1.0,0,0,1230,420,1976,539900.0
3.0,3.5,2480,2.0,0,0,2480,0,2010,910000.0
4.0,2.5,2050,2.0,0,0,2050,0,1990,280000.0
3.0,2.25,1420,2.0,0,0,1420,0,1989,275000.0
3.0,2.5,3460,2.0,0,0,3460,0,2001,467000.0
3.0,2.5,1500,2.0,0,0,1500,0,1996,457500.0
2.0,1.0,1320,1.0,0,0,1320,0,1908,381156.0
5.0,2.5,2180,1.0,0,0,1220,960,1977,289999.0
3.0,1.75,1830,1.0,0,0,1230,600,1919,642450.0
3.0,2.25,1620,1.0,0,0,1220,400,1962,469950.0
3.0,2.0,2920,1.0,0,2,1460,1460,1975,795000.0
4.0,2.5,3300,2.0,0,0,3300,0,1984,785000.0
3.0,2.25,3060,2.0,0,0,3060,0,1983,860000.0
,,3064,3.5,0,2,3064,0,1990,1095000.0
3.0,1.0,1530,1.0,0,0,1530,0,1959,147500.0
3.0,2.0,1910,1.0,0,0,1410,500,1978,390000.0
3.0,1.0,1020,1.0,0,0,1020,0,1954,229000.0
3.0,1.0,1150,1.0,0,0,1150,0,1932,185000.0
3.0,1.5,1260,1.0,0,0,870,390,1941,414900.0
4.0,2.0,1920,1.0,0,0,920,1000,1914,200000.0
4.0,2.25,1800,1.0,0,0,1800,0,1969,225000.0
3.0,1.75,2040,2.0,0,0,1360,680,1924,720000.0
4.0,2.5,2200,2.0,0,0,1430,770,1908,930000.0
5.0,2.5,3200,1.0,0,0,2160,1040,1952,1270000.0
5.0,3.25,2400,2.0,0,0,1780,620,1928,700000.0
2.0,1.5,1140,3.0,0,0,1140,0,2005,466000.0
3.0,1.5,1330,1.0,0,0,1330,0,1976,374000.0
3.0,2.5,1940,2.0,0,0,1940,0,1994,480000.0
3.0,2.5,3000,2.0,0,0,3000,0,1995,740000.0
4.0,1.0,1820,1.5,0,0,1820,0,1923,1010000.0
4.0,2.5,2910,2.0,0,0,2910,0,2002,395000.0
2.0,1.0,1090,1.0,0,0,1090,0,1954,340000.0
3.0,2.0,1230,2.0,0,0,1020,210,2003,209000.0
5.0,2.5,1710,1.5,0,0,1710,0,1962,431650.0
5.0,2.5,3160,1.0,0,0,1780,1380,1971,980000.0
3.0,2.5,2680,2.0,0,0,2680,0,1993,660000.0
4.0,2.25,2190,2.0,0,0,1840,350,1977,730000.0
3.0,1.75,1260,1.0,0,0,1260,0,1988,291500.0
4.0,3.5,2970,2.0,0,0,2340,630,1997,905000.0
4.0,2.5,2570,1.5,0,0,2570,0,1993,800000.0
4.0,3.5,3810,1.0,0,1,2560,1250,2013,839900.0
1.0,1.5,1010,2.0,0,0,950,60,2007,200000.0
3.0,2.0,1480,1.0,0,0,1080,400,1979,300000.0
3.0,1.75,1250,1.5,0,0,1250,0,1942,530000.0
3.0,2.25,1654,2.0,0,0,1654,0,1995,314950.0
3.0,1.75,1410,1.0,0,0,1410,0,1960,255000.0
5.0,2.75,2160,1.0,0,0,1500,660,1950,550000.0
3.0,1.0,1400,1.0,0,0,700,700,1917,435000.0
3.0,1.75,1420,1.0,0,0,1420,0,1966,234000.0
4.0,2.25,2500,1.0,0,0,1600,900,1975,615000.0
3.0,2.0,1410,1.0,0,0,1410,0,1985,205000.0
4.0,1.75,2100,1.0,0,0,1050,1050,1955,384000.0
3.0,2.5,1750,2.0,0,0,1750,0,1994,324000.0
3.0,1.75,2070,1.0,0,0,1130,940,1946,645000.0
3.0,3.25,1570,2.0,0,0,1260,310,2007,570000.0
3.0,2.5,1920,2.0,0,0,1920,0,1999,324000.0
2.0,1.0,1000,1.0,0,0,1000,0,1943,270000.0
5.0,1.5,2120,1.5,0,0,2120,0,1962,290000.0
3.0,2.0,1440,1.0,0,0,1440,0,1965,250000.0
3.0,1.75,1660,2.0,0,0,1660,0,1990,342000.0
3.0,1.5,1340,1.0,0,0,1340,0,1958,255000.0
3.0,2.25,2380,1.0,0,0,1450,930,1972,800000.0
3.0,1.75,1560,1.5,0,2,1000,560,1926,451000.0
4.0,2.5,2780,1.0,0,3,1390,1390,1967,990000.0
4.0,2.5,1860,1.0,0,0,1220,640,1983,288400.0
3.0,1.5,2390,2.0,0,0,1750,640,1920,420000.0
2.0,2.75,1370,2.0,0,0,1080,290,2009,359000.0
4.0,3.0,2570,1.0,0,0,1420,1150,1988,390000.0
3.0,2.5,1320,2.0,0,0,1320,0,2005,300000.0
5.0,2.5,2520,1.0,0,0,1500,1020,1981,545000.0
3.0,1.0,1250,1.0,0,0,1250,0,1972,288349.0
3.0,2.25,1560,1.0,0,0,1290,270,1985,299900.0
4.0,2.0,2330,1.5,0,0,1720,610,1925,891000.0
3.0,2.0,3660,1.0,0,3,1830,1830,1947,1200000.0
4.0,2.5,2790,2.0,0,0,2790,0,2004,378000.0
2.0,1.0,1060,1.0,0,0,1060,0,1951,299995.0
3.0,2.5,2020,1.0,0,0,1310,710,1994,253000.0
3.0,2.25,1580,1.0,0,0,1580,0,1979,350000.0
4.0,3.0,2020,1.5,0,0,2020,0,1900,565000.0
2.0,1.0,970,1.0,0,0,970,0,1908,315000.0
4.0,3.0,1490,1.5,0,1,1490,0,1915,570000.0
5.0,3.5,4390,2.0,0,0,3350,1040,2005,971000.0
5.0,2.5,2750,1.5,0,0,1840,910,1910,915000.0
4.0,1.5,2150,1.0,0,0,2150,0,1950,419000.0
4.0,1.75,1810,1.0,0,0,1230,580,1977,260000.0
3.0,3.0,2230,2.0,0,0,2230,0,1990,1321500.0
3.0,1.0,2430,1.0,0,0,2430,0,1977,369950.0
3.0,2.5,3680,2.0,0,0,3680,0,1994,1029900.0
5.0,1.0,1410,1.5,0,0,1410,0,1929,435000.0
3.0,1.75,1330,1.0,0,0,1330,0,1958,601000.0
3.0,1.0,1490,1.0,0,0,1150,340,1963,460500.0
3.0,2.5,2020,3.0,0,3,2020,0,2000,720000.0
4.0,2.5,3130,2.0,0,0,3130,0,1996,851000.0
4.0,3.0,2670,2.0,0,2,2670,0,1916,550000.0
4.0,1.0,1980,1.5,0,0,1980,0,1920,700000.0
3.0,1.75,2100,1.0,0,0,2100,0,1963,323000.0
3.0,1.0,1350,1.0,0,0,1350,0,1944,345500.0
4.0,1.5,2140,1.0,0,0,1190,950,1959,378000.0
4.0,2.0,2208,3.0,0,0,2208,0,1917,650000.0
3.0,2.0,1010,1.0,0,0,1010,0,1982,385000.0
2.0,1.0,970,1.0,0,0,970,0,1910,425000.0
4.0,2.0,1520,1.5,0,0,1520,0,1920,210000.0
4.0,2.5,2740,2.0,0,0,2740,0,1993,630000.0
3.0,1.75,1570,1.0,0,1,1300,270,1953,335000.0
3.0,1.0,1320,1.0,0,0,1320,0,1966,196500.0
4.0,2.75,2550,1.0,0,0,1440,1110,1986,582800.0
3.0,1.75,1560,1.0,0,0,1250,310,1983,440000.0
4.0,2.25,2360,2.0,0,0,2360,0,1974,752500.0
3.0,1.75,1330,2.0,0,0,1210,120,1909,532500.0
3.0,1.0,1070,1.0,0,0,1070,0,1950,265000.0
3.0,1.25,1510,1.0,0,3,810,700,1961,397500.0
3.0,2.5,1710,2.0,0,0,1710,0,1999,524250.0
4.0,2.75,2790,2.0,0,0,2790,0,1996,765000.0
4.0,2.5,2620,2.0,0,0,2620,0,2001,648000.0
5.0,2.5,2970,1.0,0,0,1670,1300,1969,469500.0
3.0,1.75,1050,1.0,0,0,1050,0,1975,237500.0
3.0,1.0,1280,1.0,0,0,1280,0,1956,216000.0
3.0,1.0,1030,1.0,0,0,1030,0,1963,427200.0
3.0,2.25,1900,1.0,0,0,1390,510,1977,280000.0
5.0,3.0,3070,1.0,0,0,1740,1330,1968,718000.0
2.0,2.75,1760,2.0,0,0,1760,0,2010,420000.0
2.0,1.0,930,1.0,0,0,930,0,1952,379000.0
2.0,1.0,880,1.0,0,0,880,0,1942,326100.0
3.0,2.5,1360,3.0,0,0,1310,50,2003,535000.0
4.0,2.75,2130,1.0,0,0,1560,570,1992,283000.0
3.0,1.0,1480,1.5,0,0,1120,360,1940,260000.0
4.0,1.0,1500,1.5,0,0,1500,0,1951,399000.0
3.0,2.25,1670,2.0,0,0,1670,0,1987,484950.0
4.0,1.75,2060,1.0,0,0,2060,0,1960,640000.0
4.0,2.5,2160,1.0,0,0,1660,500,1952,585000.0
4.0,2.0,2780,1.0,0,3,1190,1590,1955,645000.0
3.0,2.0,1490,1.0,0,0,1490,0,1988,253000.0
2.0,1.0,740,1.0,0,0,740,0,1953,178500.0
4.0,2.5,1860,2.0,0,0,1860,0,1991,291000.0
2.0,2.75,1590,1.5,0,0,1590,0,1920,199950.0
2.0,1.0,850,1.0,0,0,850,0,1922,553500.0
2.0,1.0,1030,1.0,0,0,1030,0,1981,189950.0
3.0,2.0,1850,1.0,0,0,1850,0,1988,289000.0
4.0,2.0,1830,2.0,0,0,1830,0,1908,700000.0
3.0,2.0,1560,1.0,0,0,1560,0,1967,270000.0
4.0,1.75,1730,1.0,0,0,1230,500,1977,258000.0
3.0,2.5,1930,2.0,0,0,1930,0,2005,530000.0
3.0,2.25,1422,2.0,0,0,1422,0,2012,245000.0
3.0,2.0,1380,1.5,0,0,1380,0,1917,563000.0
3.0,2.5,2430,2.0,0,0,2430,0,2001,515000.0
4.0,2.5,2610,2.0,0,0,2610,0,1987,325000.0
3.0,2.25,2000,2.0,0,0,2000,0,1996,540000.0
2.0,1.0,920,1.0,0,0,490,430,1949,280300.0
4.0,1.75,1750,1.5,0,0,1050,700,1926,460000.0
3.0,1.75,2020,1.0,0,0,1180,840,1981,475000.0
4.0,2.25,2460,1.0,0,0,2460,0,1957,900000.0
4.0,3.0,1780,1.0,0,0,1780,0,1964,538200.0
2.0,1.0,1080,1.0,0,0,1080,0,1922,429000.0
3.0,1.0,1250,1.0,0,0,1250,0,1980,164808.0
4.0,2.25,1870,2.0,0,0,1870,0,1977,520000.0
3.0,1.75,1700,1.0,0,0,1230,470,1977,475000.0
4.0,1.5,1480,1.0,0,0,1480,0,1942,283000.0
4.0,2.5,1930,2.0,0,0,1930,0,2000,321500.0
4.0,2.75,3130,2.0,0,0,3130,0,1993,840000.0
3.0,2.25,1370,2.0,0,0,1370,0,1992,287000.0
3.0,1.75,960,1.0,0,0,960,0,1962,375000.0
3.0,1.75,1260,1.0,0,0,1260,0,1969,349500.0
3.0,1.5,1480,1.0,0,0,1480,0,1960,446450.0
4.0,2.5,1930,2.0,0,0,1930,0,1992,315000.0
2.0,1.0,870,1.5,0,0,870,0,1906,271310.0
4.0,1.0,1300,1.5,0,0,1300,0,1953,315000.0
3.0,1.75,1490,1.0,0,0,1490,0,1990,245000.0
2.0,1.0,1380,1.0,0,0,1030,350,1947,543115.0
4.0,2.0,1190,1.5,0,0,1190,0,1945,900000.0
4.0,4.25,4250,2.0,0,3,2870,1380,2008,2450000.0
2.0,2.0,1920,1.0,0,0,1920,0,2003,554000.0
3.0,1.75,2080,1.0,0,0,2080,0,1950,249900.0
3.0,2.5,3220,2.0,0,2,2690,530,1981,768000.0
4.0,3.0,3680,1.0,0,3,2060,1620,1967,980000.0
5.0,2.5,2070,1.0,0,0,1270,800,1962,395000.0
3.0,1.75,1480,2.0,0,0,1480,0,1995,415000.0
4.0,2.5,2000,2.0,0,0,2000,0,2003,380000.0
3.0,2.5,1560,2.0,0,0,1560,0,1999,566000.0
2.0,1.0,1600,1.0,0,0,1390,210,1949,218500.0
4.0,2.5,1940,1.0,0,0,1140,800,1976,550000.0
3.0,1.75,1540,1.0,0,2,770,770,1920,512031.0
2.0,1.0,820,1.0,0,0,820,0,1950,197500.0
3.0,2.25,1780,1.0,0,0,1230,550,1977,470000.0
3.0,1.75,1560,1.0,0,0,1560,0,1981,590000.0
4.0,2.25,2210,1.0,0,0,1270,940,1977,465000.0
2.0,1.75,2040,1.0,0,0,2040,0,1968,499000.0
3.0,2.25,1920,1.0,0,0,1920,0,1972,515000.0
3.0,1.75,1930,1.0,0,0,1230,700,1936,716500.0
3.0,2.0,1700,1.0,0,0,890,810,1944,410000.0
4.0,3.25,3450,2.0,0,0,2450,1000,1994,850000.0
4.0,3.25,3440,2.0,0,0,3440,0,1983,1050000.0
4.0,2.5,2380,2.0,0,0,2380,0,1992,648000.0
4.0,2.25,2400,1.5,0,0,1460,940,1929,620000.0
4.0,4.5,5670,2.0,0,2,5670,0,2008,935000.0
3.0,1.0,1140,1.0,0,0,1140,0,1963,379000.0
3.0,1.75,1670,1.0,0,0,1270,400,1952,699000.0
4.0,2.25,1910,1.0,0,0,1280,630,1960,528000.0
3.0,1.75,1560,1.0,0,0,1560,0,1974,425000.0
2.0,1.75,1500,1.0,0,0,1500,0,1963,249500.0
5.0,3.25,4475,2.0,0,0,4475,0,2014,1035480.0
4.0,2.75,2840,1.0,0,3,1640,1200,1961,790000.0
3.0,1.0,1020,1.0,0,0,1020,0,1969,399950.0
3.0,1.5,1410,1.0,0,0,1410,0,1953,275000.0
3.0,1.0,1520,1.5,0,0,1520,0,1912,550000.0
1.0,1.0,730,1.0,0,0,730,0,1926,140000.0
3.0,1.0,1190,1.0,0,0,990,200,1954,250000.0
3.0,2.25,1410,2.0,0,2,1410,0,1988,318000.0
2.0,1.0,1240,1.0,0,0,1240,0,1962,505000.0
5.0,2.5,2500,1.0,0,0,1300,1200,1966,470500.0
3.0,1.0,1050,1.5,0,0,1050,0,1954,360000.0
4.0,2.75,2680,1.0,0,4,1480,1200,1962,1242500.0
3.0,2.5,2380,1.0,0,2,1340,1040,1964,986000.0
2.0,1.0,1060,1.0,0,0,860,200,1906,515000.0
3.0,1.75,2300,1.0,0,0,1310,990,1939,320000.0
4.0,3.0,2010,1.0,0,0,1090,920,1951,310000.0
2.0,1.0,1090,1.0,0,0,730,360,1942,356700.0
4.0,1.75,2320,1.0,0,0,1510,810,1956,775000.0
3.0,1.0,1040,1.0,0,0,1040,0,1951,325000.0
4.0,2.75,1810,1.5,0,0,1810,0,1962,208000.0
2.0,1.0,1150,1.0,1,4,1150,0,1908,825000.0
3.0,2.5,2360,1.0,0,2,2360,0,1990,515000.0
3.0,1.5,1970,1.5,0,0,1420,550,1929,490000.0
4.0,3.0,2690,1.0,0,0,2690,0,1954,675000.0
4.0,2.5,2080,1.0,0,0,1040,1040,1962,360000.0
4.0,2.5,2080,1.0,0,0,1040,1040,1962,550000.0
3.0,1.5,1370,1.0,0,0,1370,0,1962,225000.0
3.0,2.75,3410,1.5,0,0,3410,0,1967,500000.0
4.0,2.0,1850,1.0,0,0,1850,0,1969,385000.0
5.0,2.75,3010,2.0,0,0,3010,0,1994,837700.0
3.0,2.25,1530,2.0,0,0,1530,0,2003,448000.0
5.0,1.75,2690,1.0,0,0,1420,1270,1952,730000.0
4.0,1.5,2810,1.0,0,2,1490,1320,1954,575000.0
3.0,1.75,1810,1.0,0,0,1240,570,1976,430000.0
3.0,2.5,1560,2.0,0,0,1560,0,2002,435000.0
3.0,1.0,1010,1.0,0,0,1010,0,1973,241000.0
2.0,1.75,1000,1.0,0,0,600,400,1924,453500.0
2.0,1.5,990,3.0,0,0,990,0,2001,285000.0
2.0,1.0,720,1.0,0,0,720,0,1942,151000.0
5.0,4.5,6070,2.0,0,0,6070,0,2004,1570000.0
5.0,2.0,2270,2.0,0,0,2270,0,1905,631000.0
2.0,2.5,1380,2.0,0,0,1140,240,2011,285000.0
3.0,1.0,1260,1.0,0,0,840,420,1959,195000.0
4.0,2.5,2910,2.0,0,0,2910,0,1987,817500.0
3.0,2.0,1810,1.0,0,0,1810,0,1960,550000.0
4.0,2.5,3160,2.0,0,0,3160,0,1995,1127000.0
2.0,2.75,1910,3.0,0,0,1910,0,2002,609850.0
3.0,1.0,1230,1.0,0,0,1230,0,1947,200000.0
4.0,2.5,2960,2.0,0,0,2960,0,2006,367000.0
3.0,2.25,2200,2.0,0,0,2200,0,1988,285167.0
2.0,1.5,1270,1.0,0,0,1270,0,1947,275000.0
4.0,2.5,2540,2.0,0,0,2540,0,1992,350900.0
4.0,3.25,3030,2.0,0,0,3030,0,1988,660000.0
3.0,1.75,1520,1.0,0,0,1520,0,1957,525000.0
4.0,2.5,1560,2.0,0,0,1560,0,1997,262000.0
2.0,1.0,970,1.0,0,0,970,0,1907,690000.0
5.0,3.75,3570,2.0,0,0,3570,0,2005,624000.0
3.0,1.0,1350,1.0,0,0,860,490,1947,353000.0
4.0,3.5,3710,2.0,0,0,2290,1420,2002,552500.0
4.0,1.0,1430,1.5,0,0,1430,0,1983,224500.0
3.0,1.0,940,1.0,0,0,940,0,1950,239000.0
5.0,4.5,4300,2.0,0,0,4300,0,2004,975000.0
4.0,1.75,3990,2.0,0,0,3990,0,2006,1200000.0
3.0,1.0,1380,1.5,0,0,1380,0,1910,505000.0
4.0,1.75,2020,1.0,0,0,1010,1010,1963,302000.0
3.0,1.0,1480,1.0,0,0,780,700,1944,170000.0
2.0,1.0,1190,1.0,0,0,1190,0,1910,195000.0
5.0,1.5,2550,1.0,0,0,1560,990,1959,272000.0
5.0,1.5,2550,1.0,0,0,1560,990,1959,369000.0
3.0,1.5,1500,1.0,0,0,1500,0,1953,332500.0
3.0,2.5,3000,1.0,0,0,1760,1240,1963,515000.0
3.0,1.0,1690,1.0,0,0,1020,670,1967,269000.0
4.0,4.0,4390,1.0,0,0,2430,1960,1994,1278000.0
3.0,2.5,1560,2.0,0,0,1560,0,1985,303000.0
7.0,3.0,2940,1.0,0,0,1690,1250,1977,420000.0
3.0,1.0,1130,1.0,0,0,990,140,1941,400000.0
3.0,1.0,1020,1.0,0,0,1020,0,1987,225000.0
2.0,2.0,1310,2.0,0,0,1310,0,2004,219000.0
3.0,2.5,2570,2.0,0,3,2570,0,1989,605000.0
4.0,2.0,2020,1.0,0,0,1010,1010,1942,625000.0
5.0,2.0,1680,1.0,0,0,840,840,1906,380000.0
4.0,2.0,1770,1.5,0,0,1770,0,1962,620000.0
4.0,2.75,3190,2.0,0,0,3190,0,1994,687500.0
4.0,2.0,1440,1.0,0,0,1440,0,1962,225500.0
3.0,2.0,1150,1.0,0,0,1150,0,1956,252500.0
3.0,2.5,1860,2.0,0,0,1860,0,1994,510000.0
4.0,2.5,2430,2.0,0,0,2430,0,2003,510000.0
3.0,2.5,1940,1.5,0,0,1940,0,1906,725000.0
1.0,,670,1.0,0,0,670,0,1966,75000.0
2.0,1.0,880,1.0,0,0,880,0,1927,492000.0
4.0,2.5,1930,1.0,0,0,1330,600,1977,425000.0
4.0,2.75,3120,1.0,1,4,1560,1560,1963,1955000.0
3.0,2.5,1830,2.0,0,0,1830,0,1994,298900.0
4.0,2.5,3230,2.0,0,0,3230,0,1987,699000.0
2.0,1.0,700,1.0,0,0,700,0,1918,310000.0
3.0,1.75,1010,1.0,0,0,1010,0,1961,350000.0
4.0,1.75,2460,1.0,1,4,1410,1050,1961,790000.0
4.0,2.5,2230,2.0,0,0,2230,0,2003,305000.0
3.0,2.5,1570,2.0,0,0,1570,0,2003,315000.0
5.0,3.5,2390,2.0,0,0,2390,0,1977,267500.0
4.0,3.25,3460,2.0,0,1,3020,440,1950,1750000.0
6.0,3.5,2400,2.0,0,0,1640,760,1987,435000.0
6.0,4.5,2940,1.5,0,0,2940,0,1966,482500.0
5.0,5.25,8010,2.0,1,4,5990,2020,1999,5110800.0
3.0,1.75,1570,1.0,0,0,1570,0,1959,439995.0
3.0,3.0,1520,1.0,0,0,1180,340,1967,460000.0
3.0,1.0,1070,1.0,0,0,1070,0,1971,194000.0
2.0,0.75,440,1.0,1,3,440,0,1943,290000.0
4.0,2.0,2440,1.0,0,0,1220,1220,1963,274700.0
4.0,2.5,2660,2.0,0,0,1800,860,1910,900000.0
4.0,4.0,4460,2.0,0,0,4460,0,2001,1150000.0
3.0,2.5,2010,2.0,0,0,2010,0,2008,605000.0
3.0,2.5,1450,2.0,0,0,1450,0,2004,359000.0
3.0,1.75,1400,1.0,0,0,1400,0,1951,850000.0
3.0,2.0,1500,2.0,0,0,1500,0,2002,505000.0
3.0,2.5,2500,2.0,0,0,2500,0,1990,565000.0
2.0,1.75,1280,1.0,0,0,1000,280,1955,585000.0
4.0,3.25,3380,2.0,0,3,2420,960,1990,328000.0
4.0,2.75,2910,1.0,0,0,2210,700,1957,749950.0
4.0,2.5,3060,2.0,0,0,3060,0,2006,826000.0
3.0,1.0,1330,1.0,0,0,1330,0,1977,535000.0
4.0,2.5,3300,2.0,0,0,3300,0,1991,925000.0
3.0,3.5,3250,2.0,0,0,2500,750,2001,875000.0
4.0,2.25,2530,1.0,0,0,1570,960,1976,902000.0
3.0,1.0,1830,1.0,0,0,1830,0,1951,423000.0
3.0,1.0,1170,1.0,0,0,1170,0,1968,235000.0
2.0,2.0,2930,1.0,0,2,1680,1250,1980,545000.0
2.0,1.0,1230,1.0,0,0,1230,0,1961,343000.0
3.0,2.5,1620,2.0,0,0,1620,0,2002,334950.0
3.0,1.75,1760,1.0,0,0,1160,600,1956,405000.0
4.0,1.0,1440,1.0,0,0,1440,0,1959,220000.0
2.0,1.0,1740,1.0,0,0,1050,690,1947,173000.0
3.0,1.0,1270,1.5,0,0,1270,0,1906,655000.0
2.0,1.0,880,1.0,0,0,880,0,1924,406000.0
6.0,2.5,2560,1.0,0,0,1370,1190,1961,632000.0
5.0,2.75,1540,1.0,0,0,1140,400,1990,357000.0
3.0,1.75,1150,1.0,0,0,1150,0,1964,361000.0
2.0,1.0,770,1.0,0,0,770,0,1948,277000.0
4.0,3.75,4610,1.0,0,0,2500,2110,1980,630000.0
3.0,2.5,1850,2.0,0,0,1850,0,2003,254000.0
3.0,2.25,1840,1.0,0,0,1290,550,1961,472800.0
3.0,1.75,1490,1.0,0,0,700,790,1913,263000.0
3.0,1.75,1490,1.0,0,0,700,790,1913,510000.0
3.0,1.0,960,1.0,0,0,960,0,1952,179950.0
4.0,2.25,1580,1.0,0,0,1160,420,1973,525000.0
3.0,2.5,1260,3.0,0,0,1260,0,2008,479000.0
3.0,2.0,1940,1.0,0,2,970,970,1940,651000.0
4.0,1.75,2490,1.0,0,3,1240,1250,1958,949000.0
5.0,2.5,2520,1.5,0,0,1890,630,1942,392400.0
4.0,1.75,1760,1.0,0,0,920,840,1950,585000.0
4.0,2.5,4190,2.0,0,0,4190,0,2004,460000.0
3.0,1.0,1170,1.0,0,0,870,300,1951,470000.0
3.0,2.5,1600,2.0,0,0,1600,0,2003,245000.0
4.0,2.0,2760,2.0,0,0,1800,960,1978,500000.0
3.0,2.5,2090,2.0,0,0,2090,0,1989,455000.0
4.0,2.5,2320,2.0,0,0,2320,0,1999,485500.0
5.0,3.25,4110,2.0,0,3,3150,960,1921,1875000.0
2.0,1.0,770,1.0,0,0,770,0,1978,100000.0
3.0,1.75,1410,1.0,0,0,1410,0,1982,307000.0
4.0,3.5,3660,2.0,0,0,2660,1000,1994,475000.0
4.0,2.5,2180,1.0,0,0,1190,990,1972,330000.0
3.0,1.0,1110,1.0,0,0,1110,0,1960,130000.0
3.0,2.5,2280,2.0,0,0,2280,0,1998,320000.0
4.0,2.5,2820,2.0,0,0,2050,770,2013,735000.0
4.0,2.5,1570,1.0,0,0,800,770,1972,365000.0
3.0,1.5,1200,1.0,0,0,1200,0,1968,234000.0
4.0,2.0,1710,1.5,0,0,1710,0,1970,211000.0
6.0,3.5,3000,2.0,0,2,2400,600,1969,680000.0
4.0,3.0,2800,2.0,0,0,2800,0,2002,457000.0
3.0,2.25,1640,2.0,0,0,1640,0,1989,349000.0
3.0,2.75,2030,1.0,0,0,1210,820,1979,360000.0
4.0,2.5,2530,2.0,0,0,2530,0,1998,350000.0
3.0,1.0,990,1.0,0,0,990,0,1960,208000.0
2.0,1.0,790,1.0,0,0,790,0,1942,250275.0
2.0,1.0,790,1.0,0,0,790,0,1942,435000.0
3.0,1.75,1800,1.0,0,0,1470,330,1984,270000.0
3.0,1.75,1650,1.0,0,0,1650,0,1961,438000.0
4.0,2.0,1980,2.0,0,0,1980,0,1938,659000.0
4.0,2.75,2340,1.0,0,0,1310,1030,1974,645000.0
4.0,2.5,2790,2.0,0,0,2790,0,1999,685100.0
7.0,3.0,2800,1.0,0,2,1400,1400,1963,350000.0
2.0,1.0,1840,1.0,0,0,1840,0,1955,375000.0
3.0,1.5,1350,1.0,0,0,1350,0,1966,170000.0
4.0,2.5,3030,3.0,0,0,3030,0,2005,880000.0
4.0,2.5,1980,2.0,0,0,1980,0,2008,410500.0
4.0,2.5,3690,2.0,0,2,3690,0,1996,780000.0
5.0,4.5,3732,2.5,0,0,2932,800,2001,1225000.0
2.0,1.75,1510,1.0,0,0,1510,0,2005,449000.0
3.0,1.75,2000,1.0,0,0,1110,890,1921,546000.0
3.0,2.0,1760,1.0,0,0,1060,700,1977,317000.0
3.0,1.0,1270,1.0,0,0,1270,0,1958,276900.0
5.0,2.0,2620,1.0,0,0,1420,1200,1965,399000.0
5.0,2.75,2630,1.0,0,0,1690,940,1976,495000.0
3.0,1.75,2270,1.0,0,0,1330,940,1978,258000.0
2.0,2.5,2410,1.0,0,0,1940,470,1912,600000.0
3.0,2.75,1120,3.0,0,0,1120,0,1999,265000.0
5.0,2.75,3030,1.0,0,0,1540,1490,1978,321000.0
5.0,2.25,2120,1.5,0,0,1720,400,1910,682000.0
4.0,2.5,1720,2.0,0,0,1720,0,2000,295700.0
4.0,2.5,2150,2.0,0,0,2150,0,1985,609000.0
3.0,4.5,4380,2.0,1,3,3720,660,1968,995000.0
3.0,2.25,2010,2.0,0,0,2010,0,1986,530000.0
5.0,2.5,3150,2.0,0,0,1870,1280,1907,614000.0
3.0,2.5,2500,1.0,0,0,1770,730,1986,390000.0
3.0,2.5,1690,2.0,0,0,1690,0,2004,467000.0
6.0,2.5,3300,1.0,0,0,2060,1240,1980,484000.0
3.0,2.5,1240,3.0,0,0,1240,0,2003,340000.0
3.0,2.5,2200,2.0,0,0,2200,0,1994,302495.0
3.0,1.75,1620,1.0,0,0,980,640,1927,532500.0
3.0,2.5,2420,2.0,0,0,1780,640,1993,441500.0
4.0,2.5,2680,1.0,0,3,1530,1150,1967,470000.0
4.0,3.25,4250,2.0,0,0,4250,0,2004,2300000.0
3.0,2.5,2400,1.0,0,0,2400,0,1996,590000.0
3.0,1.75,2300,1.0,0,0,1770,530,1942,320000.0
2.0,2.0,920,2.0,0,0,800,120,2009,363000.0
4.0,2.25,2350,2.0,0,0,2350,0,1977,747500.0
2.0,2.5,2630,2.0,0,0,2630,0,2003,750000.0
4.0,3.0,2170,2.0,0,0,1610,560,1982,831000.0
3.0,2.5,1700,2.0,0,0,1700,0,2004,403000.0
3.0,2.5,2470,2.0,0,0,2470,0,2005,445000.0
3.0,1.0,1250,1.0,0,0,1250,0,1970,345000.0
3.0,3.5,3110,1.0,0,0,3110,0,2003,2260000.0
3.0,2.0,1530,1.0,0,0,1530,0,1977,371025.0
2.0,1.0,960,1.0,0,0,960,0,1916,355000.0
3.0,1.0,1240,1.0,0,0,1240,0,1972,270000.0
4.0,2.75,2440,2.0,0,1,2440,0,1957,425000.0
3.0,1.75,2320,1.0,0,0,1620,700,1967,364808.0
3.0,2.25,1580,1.0,0,0,1200,380,1981,320000.0
4.0,2.5,2963,2.0,0,0,2963,0,2006,325000.0
3.0,2.25,2470,2.0,0,0,2230,240,1984,350000.0
3.0,1.5,1370,1.0,0,0,1370,0,1947,170000.0
2.0,1.0,960,1.0,0,0,960,0,1984,255000.0
3.0,1.0,1130,1.0,0,0,880,250,1947,550000.0
4.0,4.25,4930,2.0,0,0,4930,0,2005,835000.0
3.0,1.0,1150,1.0,0,0,800,350,1946,420000.0
4.0,2.5,2190,2.5,0,0,2190,0,1958,925000.0
2.0,1.5,1490,1.0,0,0,930,560,1956,389250.0
3.0,2.5,2600,1.0,0,0,1300,1300,2004,748000.0
3.0,1.75,1530,1.0,0,0,1200,330,1988,284000.0
4.0,2.0,1680,1.0,0,0,980,700,1950,588000.0
3.0,1.75,1680,1.0,0,0,1680,0,1963,372500.0
4.0,3.0,1900,2.0,0,0,1900,0,1988,285000.0
3.0,1.0,1570,1.0,0,0,1570,0,1954,360000.0
3.0,1.0,1370,1.0,0,0,1150,220,1930,275000.0
2.0,2.0,1350,1.0,0,0,1350,0,2003,428000.0
6.0,2.5,3010,2.0,0,0,3010,0,1969,847000.0
3.0,1.0,1010,1.0,0,0,1010,0,1977,316000.0
3.0,2.5,2050,2.0,0,0,2050,0,2000,375000.0
3.0,1.0,1670,1.0,0,0,1170,500,1967,533000.0
5.0,2.5,3840,2.0,0,0,3840,0,1991,556000.0
4.0,2.0,2220,1.0,0,0,1200,1020,1966,225000.0
4.0,2.5,2590,1.0,0,0,1640,950,1978,537250.0
3.0,1.0,1180,1.0,0,0,1180,0,1967,255000.0
4.0,2.5,2950,2.0,0,0,2950,0,2006,530000.0
6.0,6.0,7390,2.0,1,4,5000,2390,1991,5300000.0
3.0,2.75,2150,2.0,0,0,2150,0,1996,595000.0
4.0,2.0,2100,1.0,0,0,2100,0,1958,548000.0
3.0,1.75,1650,1.0,0,0,1100,550,1980,234975.0
3.0,1.75,1620,2.5,0,0,1430,190,2005,600000.0
4.0,1.0,1750,1.0,0,0,1750,0,1967,432000.0
3.0,1.5,1380,2.0,0,0,1380,0,1986,455000.0
3.0,1.75,1510,1.0,0,0,1210,300,1965,279950.0
3.0,1.5,1600,1.0,0,0,1600,0,1963,267500.0
4.0,2.5,1840,2.0,0,0,1840,0,2000,620000.0
2.0,1.0,830,1.0,0,0,830,0,1943,110000.0
3.0,3.5,1810,2.0,0,0,1440,370,2009,625000.0
2.0,1.0,910,1.0,0,0,910,0,1952,389000.0
4.0,2.0,2120,2.0,0,0,2120,0,1905,1200000.0
4.0,2.25,2510,2.0,0,0,2510,0,1977,788500.0
5.0,2.25,2100,1.0,0,0,1600,500,1974,567000.0
2.0,2.25,2690,1.0,0,2,1870,820,1987,515000.0
4.0,2.5,2430,1.0,0,0,1590,840,1968,605000.0
4.0,3.75,2452,2.0,0,0,2452,0,1936,430000.0
2.0,1.75,1550,1.0,0,1,1550,0,1920,805000.0
3.0,2.5,2080,2.0,0,0,2080,0,1999,567500.0
3.0,1.75,1290,1.0,0,0,1290,0,1916,647500.0
2.0,1.75,1850,2.5,0,0,1850,0,1903,495000.0
4.0,2.5,3370,2.0,0,0,3370,0,2006,825000.0
4.0,2.25,2730,2.0,0,0,2730,0,1987,435000.0
3.0,1.75,1300,1.0,0,0,1300,0,1968,445950.0
5.0,2.75,3040,2.0,0,0,3040,0,1993,960000.0
4.0,3.0,2440,1.5,0,0,1480,960,1929,780000.0
3.0,2.25,1720,1.0,0,0,1320,400,1969,274500.0
5.0,3.0,3230,1.5,0,0,2000,1230,1909,729953.0
3.0,1.5,1200,2.0,0,0,1030,170,2008,464950.0
4.0,1.75,2350,1.0,0,2,2350,0,1959,620000.0
4.0,3.5,3100,2.0,0,0,3100,0,2005,735000.0
4.0,2.25,2040,1.0,0,0,1400,640,1959,450000.0
4.0,1.0,2000,1.5,0,0,1250,750,1916,450000.0
4.0,2.5,2160,2.5,0,0,2160,0,1902,842500.0
3.0,2.0,1970,1.0,0,0,1070,900,1979,360000.0
3.0,2.5,2270,2.0,0,0,2270,0,1998,585000.0
3.0,2.25,1850,1.0,0,0,1150,700,1977,461000.0
2.0,1.0,1350,1.0,0,0,920,430,1949,345000.0
3.0,2.5,3280,1.0,0,0,1680,1600,1970,1075000.0
4.0,2.5,2270,2.0,0,0,2270,0,1988,643000.0
4.0,2.5,2820,2.0,0,0,2820,0,1990,690000.0
4.0,1.0,1200,1.5,0,0,1200,0,1949,282000.0
3.0,1.75,2000,1.0,0,0,1120,880,1951,549000.0
3.0,2.0,2310,2.0,0,1,1560,750,1926,815000.0
5.0,4.25,4640,2.0,1,4,2860,1780,1952,2200000.0
3.0,2.25,2330,2.0,0,0,2330,0,1984,700000.0
3.0,2.5,3940,2.0,0,0,3110,830,1992,933399.0
3.0,1.0,1440,1.0,0,0,1440,0,1967,290000.0
4.0,1.75,1960,1.0,0,0,1340,620,1979,372000.0
2.0,1.75,1250,1.0,0,0,790,460,1920,450000.0
3.0,2.5,1981,2.0,0,0,1981,0,2010,303700.0
4.0,2.5,2440,2.0,0,0,2440,0,1989,672000.0
4.0,1.5,1150,1.5,0,0,1150,0,1970,334000.0
2.0,1.0,1120,1.0,0,0,1120,0,1944,260000.0
3.0,1.75,1800,1.0,0,0,1000,800,1941,749950.0
4.0,2.25,2380,2.0,0,0,2380,0,1984,330000.0
5.0,3.0,2920,2.0,0,0,2140,780,1960,830000.0
3.0,2.25,2790,1.0,0,3,2790,0,2006,1131000.0
3.0,1.0,1560,1.0,0,0,910,650,1948,320000.0
2.0,1.0,1550,1.5,0,0,1550,0,1920,260000.0
3.0,2.0,1700,1.0,0,0,970,730,1945,225000.0
1.0,1.0,640,1.0,0,0,640,0,1939,279200.0
4.0,3.5,2680,2.0,0,0,2040,640,1942,520000.0
3.0,2.5,1860,2.0,0,0,1860,0,1987,505000.0
3.0,1.75,1490,1.0,0,0,1010,480,1975,234000.0
4.0,2.5,2470,2.0,0,0,2470,0,2005,503000.0
4.0,2.25,2390,1.0,0,0,1740,650,1979,606000.0
3.0,1.0,1230,1.0,0,0,780,450,1937,433500.0
3.0,1.5,2840,1.0,0,0,1510,1330,1951,250000.0
3.0,2.5,2120,2.0,0,0,2120,0,1984,719000.0
3.0,2.0,1770,1.0,0,0,1770,0,1959,381000.0
3.0,2.5,2495,2.0,0,0,2495,0,2007,267000.0
1.0,0.75,1170,1.0,0,0,880,290,1962,275000.0
4.0,2.5,2740,2.0,0,0,2740,0,1993,651000.0
2.0,1.0,1050,1.0,0,0,850,200,1949,439000.0
2.0,1.0,1130,1.0,0,0,1130,0,1955,325000.0
2.0,1.0,880,1.0,0,0,880,0,1938,490000.0
4.0,2.5,2403,2.0,0,0,2403,0,1999,519900.0
4.0,2.75,3410,2.0,0,0,3410,0,1984,545000.0
4.0,4.0,5320,2.0,0,0,5320,0,2003,1062500.0
4.0,1.75,1900,1.0,0,0,950,950,1955,542000.0
4.0,1.75,1810,2.0,0,0,1810,0,1961,465000.0
2.0,2.0,1200,1.0,0,0,1200,0,2006,408000.0
4.0,2.5,2060,2.0,0,0,2060,0,2000,292000.0
3.0,1.75,1250,1.0,0,0,1250,0,1994,253000.0
2.0,1.0,910,1.0,0,0,910,0,1942,280000.0
3.0,2.25,2560,2.0,0,0,2560,0,1986,658588.0
4.0,2.25,1920,1.0,0,0,1200,720,1969,635000.0
4.0,2.25,2240,2.0,0,0,2240,0,1978,439000.0
3.0,2.5,1260,2.0,0,0,1260,0,1999,300000.0
3.0,1.5,1360,1.0,0,0,1360,0,1960,345000.0
4.0,2.25,2100,2.0,0,0,2100,0,1978,283500.0
2.0,1.0,2110,1.5,0,0,1460,650,1911,425000.0
3.0,1.75,2210,1.0,0,1,1560,650,1974,685000.0
3.0,2.5,2360,2.0,0,0,2360,0,1983,750000.0
4.0,1.5,1280,1.0,0,0,1280,0,1960,245000.0
6.0,3.75,2740,1.0,0,2,1640,1100,1962,585444.0
4.0,2.5,2740,2.0,0,0,2740,0,2009,706000.0
4.0,2.0,2630,1.5,0,0,1830,800,1944,445000.0
3.0,2.0,1650,1.0,0,0,1650,0,1990,241000.0
2.0,2.5,1770,2.0,1,4,1770,0,1957,1175000.0
3.0,1.0,1500,1.5,0,0,1050,450,1927,530000.0
3.0,1.5,1430,1.0,0,0,1130,300,1948,350000.0
4.0,3.75,3190,2.0,1,4,3190,0,1999,1700000.0
3.0,1.0,1280,1.0,0,0,1280,0,1968,389000.0
4.0,2.75,2390,2.0,0,0,2140,250,1945,799000.0
4.0,2.5,4040,1.0,0,3,2020,2020,1951,1400000.0
2.0,1.0,920,1.0,0,0,920,0,1947,340895.0
4.0,2.5,2730,2.0,0,2,2730,0,1996,780000.0
2.0,1.5,1320,1.0,0,0,1320,0,1993,350000.0
3.0,2.5,2620,2.0,0,0,2620,0,1999,470000.0
4.0,3.0,3180,2.0,0,0,3180,0,1985,914600.0
4.0,2.5,2900,2.0,0,0,2900,0,2005,354000.0
5.0,2.0,1900,1.5,0,0,1900,0,1920,470000.0
3.0,2.0,1760,1.0,0,0,1160,600,1927,715000.0
2.0,1.0,760,1.0,0,0,760,0,1950,265000.0
4.0,3.0,3710,2.0,0,2,2760,950,1936,2537000.0
3.0,1.0,1530,1.0,0,0,1530,0,1950,640000.0
4.0,1.75,1990,2.0,0,0,1870,120,1929,290000.0
5.0,4.75,3830,1.0,0,0,2130,1700,1976,480000.0
3.0,2.0,2040,1.0,0,1,1120,920,1954,535000.0
3.0,1.75,2170,1.0,0,0,2170,0,1965,907000.0
3.0,1.75,1620,1.0,0,0,1090,530,1974,459000.0
3.0,2.5,3600,1.0,0,3,2310,1290,1950,1355000.0
3.0,1.5,1470,1.0,0,0,1070,400,1967,264950.0
3.0,1.0,1760,1.5,0,0,1760,0,1900,352950.0
3.0,2.25,2230,1.0,0,0,1510,720,1974,491500.0
4.0,3.5,3770,2.0,0,0,2830,940,1989,1229000.0
3.0,1.0,1200,1.0,0,0,1200,0,1952,369500.0
3.0,2.5,2090,2.0,0,0,2090,0,2004,566000.0
3.0,2.25,1500,1.0,0,0,1210,290,1968,290000.0
5.0,5.0,8000,2.0,0,4,6720,1280,2009,5350000.0
3.0,1.0,870,1.0,0,0,870,0,1969,180000.0
2.0,1.0,1010,1.0,0,0,1010,0,1944,215000.0
2.0,1.0,1010,1.0,0,0,1010,0,1944,302000.0
3.0,1.75,1860,1.0,0,0,1160,700,1986,352500.0
4.0,2.0,1330,1.0,0,0,1330,0,1942,235867.0
3.0,2.25,1760,2.0,0,0,1760,0,1978,500000.0
3.0,2.25,1800,2.0,0,0,1800,0,1995,382000.0
5.0,2.5,1690,1.5,0,0,990,700,1930,515000.0
1.0,1.0,660,1.0,0,0,660,0,1919,250000.0
3.0,2.25,2400,1.5,0,0,1250,1150,1939,672500.0
3.0,2.25,3020,2.0,0,0,3020,0,1989,755000.0
3.0,1.0,1500,2.0,0,2,1500,0,1910,707500.0
4.0,2.0,1560,1.0,0,0,960,600,1924,459000.0
3.0,1.0,1090,1.5,0,0,1090,0,1959,140000.0
2.0,1.0,970,1.0,0,0,970,0,1905,495000.0
3.0,3.25,3190,2.0,0,0,3190,0,2007,757000.0
3.0,3.25,3190,2.0,0,0,3190,0,2007,765000.0
4.0,1.5,1890,1.0,0,0,1890,0,1955,359000.0
3.0,1.0,1050,1.0,0,0,1050,0,1900,440000.0
4.0,1.5,1390,1.0,0,0,1140,250,1965,400000.0
3.0,2.0,1700,1.0,0,0,850,850,1941,652000.0
3.0,1.75,1050,1.0,0,0,1050,0,1980,260000.0
5.0,3.0,3340,1.0,0,2,2120,1220,1964,1328000.0
4.0,2.0,1540,1.0,0,0,1540,0,1964,519500.0
3.0,1.0,1710,1.5,0,0,1560,150,1928,650000.0
4.0,2.25,2100,2.0,0,0,2100,0,1978,280000.0
4.0,1.75,1730,1.0,0,0,1730,0,1965,515000.0
3.0,2.25,1500,2.0,0,0,1500,0,1986,400000.0
3.0,2.5,2380,2.0,0,0,2380,0,2003,652100.0
6.0,3.0,2180,2.0,0,0,2180,0,1980,235000.0
4.0,1.5,1840,2.0,0,0,1840,0,1907,701000.0
4.0,2.5,2341,2.0,0,0,2341,0,1997,640000.0
3.0,2.5,1690,2.0,0,0,1690,0,2002,455800.0
3.0,2.5,2490,2.0,0,0,2490,0,1993,504750.0
3.0,3.0,2440,2.0,0,0,2440,0,1992,483000.0
3.0,0.75,920,1.0,1,2,920,0,1950,530000.0
2.0,1.0,1030,1.0,0,0,1030,0,1956,250000.0
5.0,2.75,2000,1.0,0,0,1260,740,1994,229950.0
4.0,3.5,4210,2.0,0,0,4210,0,2001,884744.0
3.0,1.5,1610,1.0,0,0,1080,530,1977,514000.0
3.0,2.25,1910,1.0,0,0,1430,480,1977,532000.0
4.0,2.5,2660,2.0,0,0,2660,0,2004,423000.0
2.0,1.0,820,1.0,0,2,820,0,1922,420000.0
3.0,1.75,1730,1.0,0,0,1730,0,1988,521000.0
4.0,2.25,2360,2.0,0,0,2360,0,1979,577000.0
3.0,1.0,970,1.0,0,0,970,0,1956,425000.0
4.0,2.5,2460,2.0,0,0,2460,0,2004,495000.0
3.0,2.5,2690,2.0,0,0,2690,0,1987,340000.0
3.0,3.5,1820,2.0,0,0,1430,390,2014,499950.0
4.0,3.0,3470,2.0,0,2,2370,1100,2014,1218000.0
4.0,2.75,3370,1.0,0,2,2110,1260,1977,720000.0
3.0,1.5,1700,1.0,0,0,1010,690,1970,249000.0
3.0,1.0,1340,1.0,0,0,1340,0,1978,206135.0
5.0,2.75,2000,2.0,0,0,2000,0,1968,300000.0
6.0,3.0,3840,1.5,0,3,2460,1380,1949,612000.0
5.0,2.5,3890,2.0,0,2,3890,0,1950,1102030.0
4.0,2.0,1220,1.5,0,0,1220,0,1970,230000.0
3.0,1.0,2280,1.0,0,2,1250,1030,1936,850000.0
4.0,2.5,2770,1.0,0,0,1940,830,1979,355000.0
4.0,2.5,2520,2.0,0,0,2520,0,1990,442000.0
4.0,3.0,3060,2.0,0,0,3060,0,2001,399000.0
4.0,2.5,2390,2.0,0,0,2390,0,1999,360000.0
3.0,1.75,1320,1.0,0,0,1320,0,1978,390000.0
5.0,2.5,2900,1.0,0,0,1650,1250,1977,413000.0
2.0,1.0,700,1.0,0,0,700,0,1951,190000.0
3.0,2.5,2210,2.0,0,0,2210,0,1998,432900.0
3.0,2.25,2180,2.0,0,0,2180,0,1986,621138.0
3.0,2.25,2080,1.5,0,0,1550,530,2003,270000.0
4.0,2.25,2090,1.0,0,0,1490,600,1980,610000.0
3.0,2.0,1720,1.0,0,2,960,760,1941,500000.0
4.0,2.25,2460,1.0,0,0,2460,0,1968,715000.0
3.0,1.5,1470,1.0,0,0,1470,0,1958,264000.0
3.0,1.75,1650,1.5,0,0,1650,0,1901,550000.0
3.0,2.0,1690,1.0,0,0,1690,0,1997,337000.0
3.0,1.0,970,1.0,0,0,970,0,1962,170000.0
4.0,2.5,2030,1.0,0,0,1130,900,1972,405000.0
4.0,2.5,2540,1.0,0,0,2540,0,1984,775000.0
3.0,2.25,1570,1.0,0,0,1200,370,1983,425000.0
5.0,2.75,2580,2.0,0,2,1720,860,1967,713000.0
5.0,2.5,2090,1.0,0,0,1420,670,1966,555000.0
4.0,2.5,3260,2.0,0,0,3260,0,2003,810000.0
4.0,3.75,3830,2.0,0,0,3830,0,1990,1250000.0
3.0,3.5,2130,2.0,0,2,1530,600,1908,819000.0
3.0,2.5,1690,2.0,0,0,1410,280,2013,409900.0
2.0,2.5,1780,2.0,0,0,1780,0,1974,935000.0
4.0,1.75,1620,1.0,0,3,1380,240,1947,657500.0
6.0,3.75,4210,2.0,0,0,3280,930,2008,900000.0
5.0,3.25,2980,2.5,0,0,2980,0,1998,932800.0
3.0,2.0,1490,1.0,0,0,1490,0,1977,391000.0
4.0,2.5,2110,2.0,0,0,2110,0,2000,420000.0
6.0,3.5,6563,2.0,0,0,5153,1410,2002,1300000.0
3.0,1.5,1510,1.0,0,0,1510,0,1956,415000.0
3.0,1.75,1830,1.0,0,0,1590,240,1946,350000.0
2.0,1.0,1230,2.0,0,0,830,400,1948,375000.0
3.0,1.75,2180,1.0,0,2,1300,880,1947,860000.0
4.0,2.25,2220,1.0,0,0,1110,1110,1961,495000.0
4.0,2.25,1730,1.0,0,0,1730,0,1962,250000.0
4.0,2.25,1990,1.0,0,0,1990,0,1968,365000.0
3.0,2.75,1540,1.0,0,0,1210,330,1980,503000.0
2.0,1.0,1100,1.0,0,0,1100,0,1944,150000.0
4.0,1.75,1640,1.0,0,0,820,820,1912,450000.0
4.0,3.0,2590,2.0,0,0,2590,0,2001,355000.0
3.0,2.0,1450,2.0,0,0,1450,0,1972,245000.0
3.0,2.0,1180,1.0,0,0,1180,0,1992,265900.0
4.0,2.5,1820,1.0,0,0,1220,600,1975,299000.0
4.0,2.25,2360,2.0,0,0,2360,0,1968,957500.0
3.0,1.0,1120,1.0,0,0,1120,0,1972,343000.0
3.0,2.25,1646,2.0,0,0,1646,0,1994,307500.0
5.0,3.75,4210,2.0,0,3,4210,0,2004,937500.0
3.0,3.0,2480,1.0,0,0,1620,860,1976,610000.0
3.0,1.5,1590,1.0,0,2,1310,280,1952,720000.0
4.0,2.0,2130,1.5,0,0,1650,480,1919,610000.0
3.0,1.75,1650,1.0,0,0,1650,0,1967,434500.0
2.0,2.5,3090,1.0,0,0,2250,840,1979,602500.0
4.0,2.5,2180,2.0,0,0,1700,480,2002,607010.0
3.0,1.0,1800,1.0,0,0,1040,760,1947,610000.0
4.0,2.5,3720,2.0,0,0,3720,0,1983,828500.0
3.0,1.0,1100,1.0,0,0,1100,0,1961,199990.0
3.0,1.75,1530,1.0,0,0,1530,0,1987,294000.0
4.0,2.5,3010,2.0,0,0,3010,0,2005,789500.0
3.0,3.5,3500,2.0,0,0,3500,0,2008,797000.0
5.0,3.0,3100,2.0,0,0,3100,0,2006,539950.0
4.0,1.5,2000,1.0,0,0,1170,830,1962,284950.0
4.0,1.5,2290,1.0,0,0,1510,780,1965,776500.0
4.0,2.5,2400,1.0,0,0,1510,890,1967,525000.0
3.0,2.5,1850,2.0,0,0,1850,0,1999,303000.0
3.0,3.25,3680,2.0,0,0,2340,1340,1988,722080.0
3.0,1.0,1060,1.0,0,0,1060,0,1959,140000.0
3.0,1.0,1060,1.0,0,0,1060,0,1959,235000.0
3.0,1.0,1610,1.5,0,0,1610,0,1903,440000.0
3.0,1.75,2330,1.5,0,0,1630,700,1940,605000.0
2.0,1.0,1210,1.0,0,0,1060,150,1950,380000.0
4.0,1.0,1530,1.0,0,0,980,550,1925,352000.0
4.0,2.25,2270,1.0,0,0,1360,910,1979,420000.0
4.0,2.0,2590,2.0,0,2,2590,0,1930,1175000.0
3.0,1.5,1850,1.0,0,0,1850,0,1953,1375000.0
3.0,1.5,1500,1.5,0,0,1500,0,1933,300000.0
4.0,3.25,4740,2.0,0,0,4740,0,1990,1150000.0
2.0,1.5,1710,1.0,0,1,1160,550,1951,453500.0
3.0,2.0,1920,1.0,0,0,1920,0,1972,443500.0
2.0,1.0,1150,1.0,0,0,1150,0,1954,332000.0
3.0,2.5,2320,2.0,0,0,2320,0,2004,655000.0
4.0,1.0,1420,1.5,0,0,1420,0,1950,475000.0
3.0,1.75,1550,1.0,0,0,1210,340,1988,372500.0
4.0,2.5,2920,1.0,0,3,1470,1450,1921,1050000.0
3.0,1.75,1620,1.0,0,0,830,790,1945,500000.0
6.0,2.75,2300,1.5,0,0,2300,0,1950,900000.0
3.0,1.0,1070,1.0,0,0,1070,0,1989,327500.0
3.0,1.75,1790,1.0,0,0,1790,0,1913,390000.0
2.0,1.5,1510,2.0,0,0,1510,0,1985,451101.0
4.0,1.0,1340,1.5,0,2,1340,0,1914,455000.0
4.0,2.5,3350,2.0,0,0,3350,0,2004,650000.0
3.0,2.5,2500,2.0,0,0,1910,590,1993,895000.0
4.0,2.25,2350,1.0,0,1,1510,840,1952,800000.0
4.0,2.25,2550,2.0,0,0,2550,0,1987,703770.0
3.0,1.75,1320,1.0,0,0,1320,0,1968,249950.0
2.0,2.0,1270,1.0,0,0,610,660,1926,512000.0
5.0,2.5,3480,1.0,0,0,1980,1500,1972,780000.0
3.0,2.25,2820,2.0,0,0,2820,0,1986,336000.0
3.0,2.0,2110,1.5,0,0,1220,890,1955,285000.0
3.0,1.75,1100,1.0,0,0,1100,0,1981,229900.0
4.0,3.0,1920,1.5,0,0,1540,380,1931,667500.0
4.0,2.5,1890,1.0,0,0,1230,660,1978,378000.0
3.0,2.5,2530,2.0,0,0,1530,1000,1991,454000.0
4.0,2.5,2550,2.0,0,0,2550,0,2005,537500.0
3.0,1.0,1550,1.5,0,0,1550,0,1926,425000.0
3.0,2.0,1760,1.0,0,0,1760,0,1998,290000.0
3.0,2.0,1270,1.0,0,0,1270,0,1963,349500.0
3.0,2.75,1250,2.0,0,0,830,420,2006,370000.0
3.0,1.75,1620,1.0,0,0,1620,0,1961,549500.0
2.0,1.0,710,1.0,0,0,710,0,1942,245000.0
3.0,1.75,1070,1.0,0,0,1070,0,1994,208000.0
4.0,2.25,2320,1.0,0,0,1160,1160,1966,248000.0
4.0,3.25,5450,1.5,0,0,5450,0,1984,610000.0
4.0,2.5,1670,2.0,0,0,1670,0,1999,550000.0
3.0,2.75,3010,2.0,0,2,3010,0,2001,750000.0
2.0,1.75,1340,1.0,0,0,1340,0,1940,192000.0
2.0,1.0,790,1.0,0,2,790,0,1908,169317.0
4.0,3.5,3400,2.5,0,0,2790,610,2008,1198000.0
2.0,1.0,1530,1.5,0,0,1530,0,1923,880000.0
1.0,1.0,930,1.0,0,0,930,0,1948,210000.0
3.0,1.5,1540,1.0,0,0,1010,530,1973,180500.0
4.0,2.0,1990,2.0,0,0,1990,0,1984,540000.0
3.0,1.75,2300,1.0,0,0,2300,0,1984,520000.0
3.0,1.5,1220,1.0,0,0,1220,0,1968,177500.0
3.0,1.75,2380,1.0,0,2,1190,1190,1956,415000.0
4.0,2.5,2020,1.0,0,0,1010,1010,1968,495000.0
3.0,2.25,1890,1.0,0,0,1890,0,1966,325000.0
2.0,1.75,1330,1.0,0,0,1330,0,1985,440000.0
3.0,1.75,1490,1.0,0,0,1190,300,1959,411000.0
5.0,3.5,3550,2.0,0,0,2550,1000,1998,810000.0
5.0,1.75,2040,1.0,0,2,1020,1020,1962,561750.0
4.0,2.5,2380,1.0,0,0,2380,0,1963,835100.0
3.0,2.25,1780,1.0,0,0,1450,330,1985,450000.0
3.0,2.5,1650,2.0,0,0,1650,0,2004,238000.0
3.0,1.0,1510,1.0,0,0,1510,0,1974,299000.0
2.0,1.0,1100,1.0,0,0,1100,0,1941,570000.0
3.0,1.75,2190,2.0,0,0,2190,0,1978,340000.0
2.0,1.75,1760,1.5,0,0,1040,720,1912,450000.0
4.0,1.5,1800,1.0,0,0,1330,470,1966,272750.0
4.0,2.0,2000,2.0,0,0,1860,140,1949,520000.0
3.0,1.0,990,1.0,0,0,990,0,1960,284950.0
2.0,1.5,1480,1.0,0,0,1480,0,1949,255000.0
2.0,1.0,1200,1.0,0,0,1200,0,1941,231500.0
1.0,2.0,3000,2.5,0,2,3000,0,1979,415000.0
4.0,2.5,3504,2.0,0,0,3504,0,2006,330000.0
3.0,1.5,1300,1.0,0,0,1300,0,1963,365000.0
4.0,2.0,1330,1.5,0,0,1330,0,1928,425000.0
4.0,1.75,1850,1.0,0,0,1120,730,1958,400000.0
4.0,2.5,2240,2.0,0,0,2240,0,1989,335000.0
3.0,3.0,1260,2.0,0,0,1040,220,2003,342000.0
8.0,5.0,2800,2.0,0,0,1880,920,1997,490000.0
4.0,1.75,1820,1.0,0,0,1820,0,1969,331500.0
3.0,2.5,1730,3.0,1,4,1730,0,1996,960000.0
4.0,2.5,3350,2.0,0,0,3350,0,1985,720500.0
3.0,2.5,3370,2.0,0,2,2840,530,1912,830000.0
3.0,1.75,1240,1.5,0,0,1240,0,1926,662990.0
4.0,2.0,2340,1.5,0,0,2340,0,1959,220000.0
5.0,2.0,1880,1.0,0,0,940,940,1952,349950.0
3.0,2.0,1810,1.0,0,0,1010,800,1922,550000.0
3.0,1.75,2340,1.0,0,0,1200,1140,1941,396000.0
4.0,1.5,2820,2.0,0,0,2820,0,1911,635000.0
3.0,1.0,1020,1.0,0,0,1020,0,1940,293000.0
3.0,2.25,2090,1.0,0,0,1290,800,1979,339000.0
4.0,2.25,1830,2.0,0,0,1830,0,1991,285000.0
6.0,2.75,2980,1.5,0,0,2480,500,1916,775000.0
4.0,1.5,1600,1.0,0,0,1600,0,1959,224000.0
4.0,3.5,4440,2.0,0,3,3140,1300,1922,2250000.0
3.0,1.0,1200,1.0,0,0,1200,0,1959,165050.0
3.0,1.25,1230,1.5,0,0,1230,0,1913,275000.0
5.0,3.0,2930,1.0,0,0,1750,1180,1951,445000.0
3.0,2.25,2370,1.0,0,0,1930,440,1978,510000.0
4.0,2.5,3040,2.0,0,0,3040,0,2001,1230000.0
3.0,1.5,1610,1.0,0,0,1060,550,1970,390000.0
3.0,2.25,2350,1.0,0,0,1390,960,1977,460000.0
3.0,1.75,2000,1.0,0,0,2000,0,1958,700000.0
4.0,3.5,3530,2.0,0,1,2570,960,1987,874150.0
3.0,2.25,2220,2.0,0,0,2220,0,1987,470000.0
3.0,1.75,2000,1.0,0,0,2000,0,1961,374000.0
2.0,1.75,1210,1.5,0,0,1210,0,1950,510000.0
2.0,2.5,1140,3.0,0,0,1140,0,2007,467000.0
4.0,2.5,2440,2.0,0,0,2440,0,2002,576000.0
3.0,2.0,1560,1.0,0,0,1560,0,1992,196440.0
4.0,2.5,3210,2.0,0,0,3210,0,1993,825000.0
2.0,1.0,930,1.0,0,0,930,0,1981,281000.0
3.0,2.5,1782,3.0,0,0,1782,0,2000,326000.0
3.0,1.75,1740,1.0,0,0,1740,0,1980,340000.0
5.0,1.75,3690,1.0,0,0,1890,1800,1985,440000.0
4.0,2.5,2930,2.0,0,0,2930,0,1998,749000.0
4.0,1.0,1230,1.5,0,0,1230,0,1963,340000.0
3.0,2.0,2000,2.0,0,0,2000,0,1916,561000.0
3.0,2.25,1520,1.0,0,0,1160,360,1988,270000.0
2.0,1.0,1040,1.0,0,0,1040,0,1919,600000.0
4.0,1.5,1120,1.0,0,0,1120,0,1969,219900.0
3.0,1.75,3020,2.0,0,0,3020,0,1992,617000.0
3.0,2.25,1820,2.0,0,0,1820,0,1978,469000.0
3.0,1.0,1370,1.0,0,0,1370,0,1942,229000.0
4.0,3.0,3130,2.5,0,0,2290,840,1906,1265000.0
3.0,1.5,1640,1.0,0,0,1290,350,1958,365000.0
4.0,2.5,2650,2.0,0,0,2650,0,2001,429000.0
4.0,2.5,2850,2.0,0,0,2850,0,2003,550000.0
3.0,2.5,1820,1.0,0,0,1220,600,1955,453000.0
3.0,1.5,1180,1.0,0,0,1180,0,1977,187500.0
6.0,2.5,1880,1.0,0,0,1640,240,1955,520500.0
3.0,1.75,1280,1.0,0,0,1280,0,1977,300000.0
4.0,3.25,3120,2.0,0,0,2370,750,2005,799000.0
3.0,2.5,2470,2.0,0,0,2470,0,2003,338000.0
3.0,1.0,1700,1.5,0,0,1700,0,1906,800000.0
2.0,2.0,1180,1.0,0,1,590,590,1945,360000.0
6.0,2.5,2800,1.0,0,0,1400,1400,1968,442500.0
4.0,1.0,1300,1.0,0,3,1300,0,1920,700000.0
5.0,3.0,3040,1.0,0,0,1970,1070,1968,830000.0
3.0,2.5,1630,2.0,0,0,1630,0,1987,360400.0
3.0,1.0,1340,1.0,0,0,1340,0,1960,345000.0
3.0,1.75,1830,1.0,0,0,1430,400,1966,300000.0
3.0,1.0,1240,1.0,0,0,1240,0,1959,350000.0
4.0,2.0,2500,1.0,0,0,1540,960,1972,368000.0
3.0,1.75,1760,1.0,0,0,1760,0,1966,264000.0
3.0,2.0,2660,1.0,0,0,2210,450,1990,435000.0
3.0,1.5,2060,1.5,0,0,2060,0,1903,200000.0
5.0,2.5,2540,2.0,0,0,1760,780,1929,620000.0
5.0,4.25,4830,2.0,0,0,3720,1110,2014,1679000.0
3.0,1.75,1400,1.0,0,0,700,700,1919,337000.0
4.0,3.25,4280,2.0,0,0,4280,0,1984,1928000.0
4.0,2.5,2230,1.0,0,0,1450,780,1974,544500.0
1.0,1.0,680,1.0,0,4,680,0,1910,252000.0
4.0,2.5,2340,2.0,0,0,2340,0,2008,445000.0
3.0,2.25,2070,2.0,0,0,2070,0,1989,379500.0
4.0,2.0,1910,1.0,0,0,910,1000,1919,189950.0
3.0,1.0,950,1.5,0,0,950,0,1948,469000.0
5.0,2.75,2910,1.0,0,0,1510,1400,1979,600000.0
3.0,2.5,2930,2.0,0,2,2930,0,2000,785000.0
4.0,2.75,2610,2.0,0,0,2610,0,1990,372000.0
5.0,3.0,3880,2.0,0,0,3880,0,2004,445000.0
4.0,2.25,3320,2.0,0,0,2000,1320,1986,508000.0
5.0,1.5,1940,2.0,0,0,1940,0,1905,780000.0
4.0,2.25,2510,2.0,0,0,2510,0,1978,541100.0
4.0,2.5,2660,2.0,0,0,2660,0,2003,729000.0
3.0,2.0,1710,1.0,0,2,1710,0,1952,397000.0
2.0,1.0,1320,1.0,0,1,1320,0,1912,451555.0
2.0,1.0,960,1.0,0,0,960,0,1947,300000.0
3.0,2.5,1790,1.0,0,0,1190,600,1969,416000.0
2.0,1.0,950,1.0,0,0,810,140,1925,490000.0
6.0,3.75,2940,2.0,0,0,2940,0,1942,480000.0
2.0,2.0,930,1.0,0,0,670,260,2002,368000.0
3.0,2.5,4570,2.0,0,0,4570,0,1991,1038000.0
3.0,2.5,2370,1.0,0,3,1570,800,1952,545000.0
5.0,2.75,3430,2.0,0,0,3430,0,1998,850000.0
4.0,3.5,3540,2.0,0,0,3540,0,2003,550000.0
3.0,2.25,2240,2.0,0,0,2240,0,1984,600000.0
4.0,2.5,2710,1.0,0,0,1700,1010,1968,535000.0
3.0,2.5,2660,2.0,0,0,2660,0,2014,599950.0
5.0,2.75,2540,1.0,0,0,1540,1000,1955,531000.0
4.0,2.25,2210,2.0,0,0,2210,0,1968,530000.0
4.0,4.0,3570,2.0,0,0,2860,710,2015,597326.0
4.0,2.5,3450,2.0,0,0,3450,0,1997,805000.0
4.0,1.75,2330,1.0,0,0,2330,0,1968,390000.0
4.0,2.0,1690,1.5,0,0,1550,140,1901,487250.0
3.0,1.5,1030,1.0,0,0,1030,0,1967,301000.0
5.0,2.75,2560,1.5,0,2,2220,340,1923,1175000.0
4.0,2.5,1950,2.0,0,0,1950,0,2002,299000.0
4.0,2.25,4370,2.5,0,3,3670,700,1907,2350000.0
4.0,2.5,2350,2.5,0,0,2350,0,1999,400000.0
4.0,2.5,3160,1.0,0,0,1880,1280,1969,467500.0
4.0,2.5,2430,2.0,0,0,2430,0,1990,305000.0
3.0,1.0,1340,1.0,0,0,1340,0,1953,210000.0
3.0,1.0,1010,1.0,0,0,1010,0,1979,300000.0
3.0,2.25,1770,1.0,0,0,1330,440,1981,327500.0
3.0,2.0,1210,1.0,0,0,1210,0,2003,269000.0
4.0,3.25,3330,1.0,0,2,1750,1580,1969,975000.0
3.0,1.0,1240,1.0,0,0,1060,180,1940,355000.0
3.0,1.0,1250,1.5,0,0,1150,100,1900,712000.0
4.0,2.5,2960,2.0,0,0,2960,0,1985,883000.0
2.0,1.0,840,1.0,0,0,840,0,1994,190000.0
3.0,1.75,1530,1.0,0,0,1200,330,1967,443000.0
4.0,3.0,3750,2.0,0,0,3750,0,1976,920000.0
4.0,2.25,2150,1.0,0,0,1240,910,1978,285000.0
4.0,3.25,1560,1.0,0,0,1560,0,1916,901000.0
3.0,1.75,2040,1.0,0,0,1410,630,1958,552500.0
2.0,1.0,860,1.0,0,0,860,0,1915,256000.0
3.0,1.5,1720,1.5,0,0,1720,0,1952,341000.0
4.0,2.25,2090,2.0,0,0,2090,0,1975,279000.0
4.0,2.25,2130,2.0,0,0,2130,0,1977,686000.0
2.0,1.0,1300,1.5,0,0,1300,0,1975,225000.0
2.0,1.75,1220,1.0,0,0,1220,0,1972,215500.0
4.0,3.0,2420,1.5,0,0,1520,900,1919,950000.0
4.0,2.5,2940,2.0,0,2,1870,1070,1996,503000.0
3.0,2.5,2610,2.0,0,0,2610,0,1997,780000.0
4.0,2.0,1880,1.0,0,0,980,900,1946,212000.0
4.0,2.75,2330,1.5,0,0,1710,620,1983,580000.0
4.0,2.5,2200,2.0,0,0,2060,140,1994,465000.0
4.0,2.0,1720,1.0,0,0,1720,0,1959,206000.0
3.0,2.5,2250,2.0,0,0,2250,0,1987,615000.0
4.0,1.0,1640,1.5,0,0,1640,0,1907,519000.0
4.0,3.25,4130,2.0,0,0,4130,0,2001,1135000.0
5.0,2.5,2600,2.0,0,0,2600,0,2005,330000.0
4.0,1.5,1920,1.0,0,0,1920,0,1955,240000.0
3.0,2.0,2060,1.0,0,0,2060,0,1988,574000.0
4.0,4.25,5710,2.0,0,0,5710,0,2007,930000.0
4.0,3.0,2720,2.0,0,0,2720,0,1975,850000.0
3.0,1.5,1490,1.0,0,0,1090,400,1974,415000.0
3.0,2.5,2360,1.0,0,0,1340,1020,1929,480000.0
5.0,1.0,1940,1.0,0,0,1940,0,1957,300000.0
4.0,2.25,2570,2.0,0,0,2570,0,1980,439000.0
3.0,1.0,1160,1.0,0,0,1160,0,1938,450000.0
3.0,2.5,2660,1.0,0,0,2660,0,1989,589000.0
3.0,2.25,1260,2.0,0,0,1260,0,2003,477000.0
4.0,2.25,1780,1.0,0,0,1310,470,1951,587500.0
4.0,2.25,3180,2.0,0,0,3180,0,1905,1315000.0
4.0,2.5,3380,2.0,0,0,3380,0,1966,1430000.0
4.0,2.25,2690,2.0,0,0,1890,800,1978,700000.0
2.0,1.0,1180,1.0,0,0,1180,0,1949,275000.0
3.0,1.0,1660,1.0,0,0,1160,500,1978,367500.0
4.0,2.5,2260,2.0,0,0,2260,0,2001,453250.0
5.0,1.75,1910,1.0,0,0,1390,520,1954,607000.0
4.0,2.0,2430,1.0,0,0,1430,1000,1960,255000.0
2.0,2.0,1300,1.0,0,0,770,530,1926,501000.0
3.0,1.0,1060,1.0,0,0,910,150,1950,450000.0
3.0,2.25,2200,2.0,0,0,2200,0,1981,360000.0
4.0,1.75,1720,1.5,0,0,1040,680,1929,460000.0
3.0,1.75,2360,1.0,0,0,1180,1180,1950,753000.0
2.0,1.0,820,1.0,0,1,820,0,1951,389950.0
2.0,1.0,1030,1.0,0,0,1030,0,1924,469000.0
4.0,1.75,2030,2.0,0,4,1730,300,1939,550000.0
5.0,3.5,2700,1.5,0,2,1950,750,1948,565000.0
2.0,1.75,1100,1.0,0,0,1100,0,1980,189650.0
4.0,3.25,3620,2.0,0,3,2350,1270,1927,1525000.0
3.0,1.75,1340,1.0,0,0,1340,0,1980,260000.0
3.0,1.75,1790,1.0,0,0,1040,750,1960,243000.0
4.0,2.5,3830,1.0,0,4,2030,1800,1969,1100000.0
3.0,1.5,1580,1.0,0,0,1080,500,1976,249000.0
2.0,1.0,2020,1.0,0,3,1700,320,1947,720000.0
4.0,2.5,3330,2.0,0,0,3330,0,1995,905000.0
4.0,2.5,2610,1.5,0,0,1610,1000,1927,824500.0
4.0,2.75,2610,1.0,0,0,1760,850,1978,762500.0
3.0,2.5,1740,3.0,0,2,1740,0,2008,580000.0
3.0,2.0,1840,1.0,0,0,1840,0,1990,380000.0
3.0,1.75,1080,1.0,0,0,880,200,1926,805000.0
4.0,1.75,1240,1.5,0,0,1240,0,1944,520000.0
5.0,4.5,5620,3.0,0,3,4700,920,1999,1569500.0
2.0,1.0,1170,1.0,0,2,1170,0,1911,175000.0
4.0,2.25,1760,2.0,0,0,1760,0,1987,353500.0
4.0,2.5,2230,1.0,0,1,1400,830,1962,500000.0
3.0,1.75,1520,1.0,0,0,1140,380,1972,386500.0
2.0,1.0,1450,1.0,0,0,850,600,1950,210000.0
3.0,2.5,1600,1.0,0,0,940,660,1983,439500.0
5.0,2.5,3220,2.0,0,0,3220,0,2002,315000.0
4.0,2.5,1830,2.0,0,0,1830,0,2003,339000.0
4.0,2.25,2200,1.0,0,0,1430,770,1971,655000.0
2.0,2.5,2170,1.0,0,0,2170,0,2008,740000.0
5.0,2.5,1900,2.0,0,0,1900,0,1966,685000.0
5.0,2.5,2960,1.0,0,0,1480,1480,1960,550000.0
2.0,1.75,1710,2.0,0,0,1330,380,1920,405000.0
4.0,2.25,2620,1.0,0,3,1430,1190,1984,765000.0
3.0,2.0,2140,2.0,0,0,1680,460,1911,625000.0
4.0,2.5,2100,1.5,0,0,2100,0,1914,207000.0
4.0,2.5,2100,1.5,0,0,2100,0,1914,370000.0
3.0,2.5,1460,1.0,0,0,1150,310,1988,475000.0
2.0,1.0,990,1.0,0,0,990,0,1955,365000.0
4.0,2.25,2190,1.0,0,0,1340,850,1969,411800.0
5.0,3.5,3990,2.0,0,0,2710,1280,2002,668000.0
3.0,2.5,2340,2.0,0,0,2340,0,1998,618000.0
4.0,2.0,2460,1.0,0,0,1230,1230,1948,247500.0
5.0,3.0,2080,1.0,0,0,1040,1040,1950,345000.0
3.0,2.0,1700,2.0,0,2,1700,0,1927,616300.0
3.0,1.5,1330,1.0,0,0,1330,0,1952,348000.0
3.0,2.5,1630,1.0,0,0,1630,0,1994,425000.0
5.0,2.75,2920,1.0,0,0,1660,1260,1968,850000.0
5.0,2.75,2830,2.0,0,0,2830,0,2010,820000.0
4.0,2.25,3190,2.0,0,0,3190,0,1980,832000.0
3.0,1.75,1490,2.0,0,0,1490,0,1984,835000.0
3.0,2.5,1630,2.0,0,0,1630,0,1999,350000.0
4.0,2.5,2280,2.0,0,0,2280,0,2003,349000.0
6.0,3.75,3010,2.0,0,0,2000,1010,2014,1125000.0
3.0,2.5,1590,2.0,0,0,1590,0,2004,320000.0
3.0,1.0,1250,1.0,0,0,1250,0,1968,150000.0
3.0,1.0,1710,1.0,0,0,1310,400,1949,340000.0
4.0,4.0,3280,2.0,0,0,3280,0,2007,785500.0
4.0,2.5,3362,2.0,0,0,3362,0,2004,410500.0
3.0,2.5,2200,2.0,0,2,2200,0,1978,580000.0
2.0,1.5,830,2.0,0,0,830,0,2005,345000.0
3.0,2.25,2160,1.5,0,0,1760,400,1933,550000.0
4.0,3.0,2580,2.0,0,0,2580,0,1998,449500.0
3.0,1.0,2150,1.0,0,0,2150,0,1954,300000.0
4.0,2.5,3510,2.0,0,0,3510,0,1988,915000.0
4.0,3.75,3810,2.0,0,0,3810,0,1989,1575000.0
4.0,2.75,2020,1.0,0,0,1010,1010,1917,599000.0
4.0,2.5,2120,1.0,0,0,1620,500,1960,755000.0
3.0,1.0,1250,1.0,0,0,1250,0,1944,400000.0
3.0,1.0,980,1.0,0,0,980,0,1968,133000.0
4.0,1.5,1250,1.0,0,0,960,290,1951,330000.0
4.0,1.0,1100,1.5,0,0,1100,0,1904,330000.0
3.0,1.75,1330,1.0,0,0,710,620,1936,375000.0
4.0,2.75,2560,1.0,0,0,1500,1060,1968,485000.0
4.0,2.5,1850,1.5,0,0,1210,640,1981,470000.0
4.0,3.0,2790,2.0,0,0,1880,910,1905,1045000.0
4.0,1.0,1660,1.5,0,0,1260,400,1930,548800.0
2.0,1.0,1080,1.0,0,0,720,360,1919,315000.0
3.0,2.0,3030,1.0,0,1,2100,930,1959,590000.0
4.0,2.5,2380,2.0,0,0,2380,0,2002,439950.0
3.0,1.75,2250,1.0,0,0,2250,0,1980,325000.0
2.0,1.0,880,1.0,0,0,880,0,1931,400000.0
4.0,2.5,2770,2.0,0,0,2770,0,1987,685000.0
3.0,2.0,1340,1.5,0,0,1340,0,1953,339950.0
3.0,1.75,1660,1.0,0,0,1660,0,1951,315000.0
3.0,2.5,1710,2.0,0,0,1710,0,2009,411753.0
2.0,1.75,1620,1.0,0,0,1040,580,1924,577000.0
3.0,1.75,1530,1.0,0,0,1530,0,1972,500000.0
3.0,2.0,1440,1.0,0,0,1440,0,1963,210000.0
4.0,1.75,2020,1.0,0,0,2020,0,1969,640000.0
4.0,1.75,1870,1.0,0,0,1870,0,1949,460000.0
2.0,1.0,620,1.0,0,0,620,0,1941,265000.0
5.0,5.0,5774,1.0,0,2,4490,1284,1984,740000.0
3.0,1.0,1240,1.0,0,0,1240,0,1948,230000.0
3.0,1.75,1890,1.0,0,0,1460,430,1978,315000.0
3.0,1.75,2410,1.0,0,0,1410,1000,1981,432000.0
3.0,2.5,1530,2.0,0,0,1530,0,1995,467000.0
5.0,3.75,2800,1.0,0,0,2800,0,1964,255000.0
3.0,1.75,1460,1.0,0,2,1010,450,1979,316500.0
4.0,2.0,1580,1.0,0,0,860,720,1977,190000.0
3.0,2.0,1450,1.5,0,0,1450,0,1900,490000.0
4.0,1.75,1990,1.0,0,0,1990,0,1976,378000.0
6.0,4.0,4470,3.0,0,3,3230,1240,2013,598800.0
5.0,3.0,1980,1.0,0,0,1220,760,1990,333800.0
4.0,2.5,2920,2.0,0,0,2920,0,1990,690000.0
4.0,1.75,1660,1.0,0,0,830,830,1948,320000.0
4.0,3.5,3190,1.5,0,3,2410,780,1912,1249000.0
3.0,1.5,1560,1.0,0,0,1560,0,1961,335000.0
3.0,2.5,3050,1.0,0,0,3050,0,2004,840000.0
4.0,2.75,3030,2.0,0,0,3030,0,1986,608250.0
3.0,2.5,2260,2.0,0,0,2260,0,2005,550000.0
3.0,1.0,1260,1.0,0,0,1260,0,1966,240000.0
3.0,2.25,3370,2.0,0,2,3370,0,1980,998000.0
3.0,1.75,1490,1.0,0,0,1490,0,1978,275000.0
3.0,2.5,1570,1.0,0,0,1110,460,1977,284200.0
4.0,3.75,4490,2.0,0,0,3090,1400,1941,1715000.0
4.0,3.75,4090,2.0,0,0,3400,690,1926,2400000.0
5.0,2.5,4150,2.0,0,0,4150,0,1988,930800.0
4.0,3.0,2900,1.0,0,3,1530,1370,1959,930000.0
4.0,1.5,1430,1.0,0,0,1030,400,1979,215000.0
2.0,1.5,1008,1.0,1,4,1008,0,1943,480000.0
2.0,1.75,1480,1.0,0,0,840,640,1951,483945.0
3.0,1.75,1240,1.0,0,0,1240,0,1978,347000.0
3.0,2.0,1370,1.0,0,0,1110,260,1979,232500.0
4.0,2.25,1770,1.0,0,0,1190,580,1965,390000.0
3.0,2.25,2160,1.0,0,0,1410,750,1965,550000.0
4.0,2.5,2340,2.0,0,0,2340,0,1987,590000.0
1.0,1.0,960,1.0,0,0,960,0,1945,420850.0
4.0,2.5,2280,1.0,0,3,1390,890,1983,345000.0
3.0,2.0,1970,1.0,0,0,1970,0,1986,429800.0
4.0,1.75,1530,1.5,0,0,1530,0,1968,302000.0
4.0,1.5,1790,1.5,0,0,1790,0,1932,800000.0
3.0,2.5,1700,2.0,0,0,1700,0,1997,250000.0
3.0,2.0,2660,1.0,0,0,1330,1330,1922,605000.0
3.0,1.75,1950,1.0,0,0,1950,0,1985,412000.0
3.0,2.0,1340,2.0,0,0,1340,0,1994,252000.0
3.0,1.0,1130,1.5,0,0,1130,0,1954,375000.0
2.0,1.75,1950,1.0,0,0,1010,940,1919,725000.0
5.0,3.5,3790,1.0,0,1,2120,1670,2001,471750.0
4.0,2.25,2020,2.0,0,0,2020,0,1995,490000.0
2.0,1.0,800,1.0,0,0,800,0,1945,439000.0
4.0,2.0,1770,1.0,0,0,1770,0,1949,355000.0
1.0,0.75,940,1.0,0,0,940,0,1944,250000.0
4.0,2.25,2260,1.0,0,0,2260,0,1984,780000.0
2.0,1.0,890,1.0,0,0,890,0,1918,409000.0
2.0,1.0,860,1.0,0,0,860,0,1916,420000.0
1.0,0.75,680,1.0,0,0,680,0,1947,200000.0
2.0,1.5,2130,1.0,0,0,2130,0,1963,830000.0
3.0,2.5,2390,2.0,0,0,2390,0,2006,695000.0
4.0,2.75,3488,2.0,0,0,3488,0,1998,815000.0
3.0,1.75,1260,1.0,0,0,820,440,1983,210000.0
3.0,1.75,2940,1.0,0,2,1590,1350,1957,635000.0
4.0,2.5,2440,2.0,0,0,2440,0,1991,562500.0
4.0,2.5,2600,2.0,0,0,2600,0,1988,402500.0
3.0,2.0,2080,1.0,0,0,1040,1040,1951,555000.0
3.0,1.0,1990,1.0,0,0,1990,0,1972,310000.0
4.0,2.5,2840,2.0,0,0,2840,0,1994,500000.0
6.0,3.0,2630,1.0,0,0,1610,1020,1959,430000.0
3.0,4.25,2820,2.0,0,0,2460,360,1930,1600000.0
4.0,1.0,1560,1.5,0,0,1560,0,1923,627500.0
4.0,2.5,2330,2.0,0,0,2330,0,1998,335000.0
4.0,2.25,3320,1.0,0,0,1810,1510,1981,962000.0
3.0,1.75,1730,1.0,0,0,1730,0,1959,299000.0
4.0,2.5,3110,2.0,0,0,3110,0,2001,399950.0
3.0,1.0,1230,1.0,0,0,1230,0,1968,322000.0
2.0,1.5,950,1.0,0,0,950,0,1949,430000.0
3.0,1.75,1890,1.0,0,0,1890,0,1966,307000.0
3.0,1.5,1010,1.0,0,0,1010,0,1943,194000.0
3.0,1.0,1010,1.0,0,0,1010,0,1920,180000.0
4.0,2.25,2340,1.0,0,0,1170,1170,1983,465000.0
4.0,2.5,2460,2.0,0,0,2460,0,1978,722500.0
2.0,1.0,1010,1.0,0,0,1010,0,1921,470450.0
3.0,2.5,1650,2.0,0,0,1650,0,1990,280000.0
4.0,2.0,1440,1.0,0,0,1440,0,1966,176250.0
5.0,1.0,1710,1.5,0,0,1320,390,1926,560000.0
3.0,2.5,2760,2.0,0,3,2000,760,1991,830000.0
2.0,1.0,1350,1.0,0,2,1350,0,1952,276900.0
3.0,1.75,1660,2.0,0,0,1660,0,1906,625000.0
4.0,2.5,2960,2.0,0,0,2160,800,1900,1015000.0
1.0,1.0,1090,1.0,0,0,1090,0,1924,463500.0
3.0,2.5,3110,2.0,0,0,3110,0,1990,485000.0
3.0,2.0,1380,1.0,0,0,1380,0,1989,272000.0
2.0,1.0,1290,2.0,0,0,1290,0,2008,305000.0
3.0,2.5,1980,1.0,0,0,1980,0,1959,760000.0
2.0,1.0,870,1.0,0,0,870,0,1938,387500.0
4.0,2.5,2470,2.0,0,0,2470,0,2004,352000.0
3.0,1.75,2140,1.0,0,0,1490,650,1950,507000.0
3.0,1.0,770,1.0,0,0,770,0,1941,156000.0
3.0,3.25,1490,3.0,0,0,1220,270,2001,580000.0
4.0,2.5,2510,1.0,0,0,1610,900,1977,630000.0
5.0,1.5,1950,1.0,0,0,1130,820,1964,275000.0
5.0,4.0,3600,1.0,0,2,1800,1800,1960,835000.0
4.0,2.5,2380,2.0,0,0,2380,0,1995,340000.0
2.0,1.0,720,1.0,0,0,720,0,1942,329350.0
3.0,3.5,4070,2.0,0,0,4070,0,1991,1480000.0
3.0,1.0,1250,1.0,0,0,1250,0,1975,475000.0
3.0,2.25,2190,3.0,0,0,2190,0,2014,719950.0
1.0,1.0,810,1.0,0,0,810,0,1941,235000.0
3.0,1.5,2440,1.0,0,0,1320,1120,1939,875000.0
4.0,1.75,1740,1.0,0,0,1740,0,1974,380000.0
3.0,2.25,1480,1.5,0,0,1480,0,1984,325000.0
4.0,2.5,2120,2.0,0,0,2120,0,1989,475000.0
1.0,1.0,900,1.0,0,0,900,0,1915,152900.0
2.0,2.0,1190,1.0,0,0,1190,0,1939,210000.0
4.0,1.0,1010,1.0,0,0,750,260,1925,350000.0
3.0,2.5,2100,2.0,0,0,2100,0,1985,505000.0
4.0,2.25,2020,1.0,0,0,1380,640,1979,464900.0
3.0,2.0,2520,1.0,0,0,1790,730,1957,650000.0
2.0,2.75,1370,2.0,0,0,1080,290,2009,369950.0
3.0,2.5,1530,2.0,0,0,1530,0,2001,250000.0
3.0,2.5,1530,2.0,0,0,1530,0,2001,320000.0
4.0,4.25,5040,1.0,0,3,3420,1620,1950,2532000.0
4.0,2.25,2530,2.0,0,0,2530,0,1974,340000.0
2.0,1.5,1010,1.5,0,0,1010,0,1906,440000.0
3.0,1.0,1200,1.0,0,0,1200,0,1959,219950.0
4.0,3.0,2720,1.0,0,0,2720,0,1957,940000.0
4.0,1.5,1850,1.5,0,0,1110,740,1945,399950.0
3.0,2.75,2340,1.0,0,0,2340,0,1954,1568000.0
4.0,1.75,1860,1.0,0,0,1460,400,1969,528000.0
4.0,1.75,1940,1.0,0,0,1560,380,1956,545000.0
2.0,2.0,1680,1.0,0,0,1680,0,2004,575000.0
4.0,2.75,1770,1.0,0,0,1250,520,1979,235000.0
3.0,2.5,1790,2.0,0,0,1790,0,1998,272000.0
4.0,1.75,1720,1.0,0,0,1720,0,1969,380000.0
3.0,1.0,1280,1.5,0,0,1280,0,1949,195000.0
3.0,2.5,1690,2.0,0,0,1690,0,2002,297000.0
4.0,2.5,2190,2.0,0,0,2190,0,2003,349000.0
2.0,1.0,710,1.0,0,2,710,0,1942,320000.0
4.0,1.5,1890,1.0,0,0,1890,0,1962,319990.0
2.0,2.0,1410,1.5,0,0,1410,0,1909,439900.0
3.0,3.25,2210,2.0,0,0,1820,390,1995,429000.0
3.0,2.0,1540,1.0,0,0,1540,0,1998,272500.0
4.0,2.0,1350,1.0,0,0,1350,0,1959,400000.0
5.0,2.0,1380,1.5,0,0,1380,0,1916,462000.0
2.0,1.0,890,1.0,0,0,890,0,1947,510000.0
3.0,2.5,1900,2.0,0,0,1900,0,1988,550000.0
3.0,1.0,1240,1.0,0,0,1240,0,1969,150000.0
3.0,2.5,1730,1.0,0,0,1210,520,1969,460000.0
4.0,2.5,2090,2.0,0,0,2090,0,1986,632500.0
3.0,1.75,1650,1.0,0,0,1650,0,1969,361000.0
3.0,2.25,1130,2.0,0,0,1030,100,2004,437000.0
6.0,2.75,3240,1.0,0,0,2160,1080,1950,370000.0
4.0,2.5,3840,2.0,0,0,3840,0,1998,884250.0
3.0,1.0,1200,1.0,0,0,1200,0,1969,225000.0
2.0,1.0,870,1.0,0,0,870,0,1949,235000.0
6.0,3.5,2410,2.0,0,4,2220,190,1916,767500.0
3.0,1.75,1560,1.5,1,4,1560,0,1928,1200000.0
3.0,2.5,2410,2.0,0,0,2410,0,1989,715000.0
4.0,2.25,2300,1.0,0,0,1380,920,1959,417000.0
3.0,1.0,1390,1.0,0,0,1390,0,1964,199000.0
5.0,2.5,2920,2.0,0,0,2320,600,1906,875000.0
4.0,1.5,1370,1.5,0,0,1370,0,1926,545000.0
2.0,1.0,950,1.0,0,0,950,0,1926,192500.0
3.0,2.5,3090,2.0,0,0,3090,0,1999,822500.0
4.0,2.5,2390,1.0,0,0,1590,800,1975,800000.0
3.0,2.5,2070,2.0,0,0,2070,0,1930,1250000.0
4.0,4.25,5770,2.0,1,4,5770,0,1980,3850000.0
3.0,2.5,1460,2.0,0,0,1460,0,1995,295000.0
2.0,1.75,1510,1.0,0,0,1510,0,2006,419000.0
5.0,3.25,5180,1.0,0,0,2610,2570,1993,1195000.0
4.0,2.75,3430,2.0,0,0,3430,0,1995,750000.0
4.0,1.5,1700,1.0,0,0,1700,0,1953,502000.0
3.0,1.75,2640,1.0,0,3,1320,1320,1960,1025000.0
3.0,1.0,1200,1.5,0,0,1200,0,1945,398500.0
2.0,1.5,1850,1.5,0,2,1850,0,1907,700000.0
5.0,1.5,1510,1.0,0,0,1510,0,1959,248000.0
4.0,2.0,2130,1.0,0,0,1070,1060,1922,800000.0
4.0,2.5,2640,2.0,0,0,2640,0,2004,383000.0
4.0,3.0,3000,1.5,0,3,1970,1030,1913,688000.0
3.0,2.0,1870,1.0,0,0,1060,810,1926,521000.0
2.0,1.0,990,1.0,0,0,990,0,1949,365000.0
3.0,2.0,2005,1.0,0,0,1605,400,1980,491000.0
3.0,2.75,2030,1.0,0,0,1400,630,1965,643000.0
3.0,2.5,1500,1.0,0,0,1060,440,1979,279000.0
4.0,1.0,1530,1.5,0,0,1530,0,1908,583500.0
3.0,2.5,1990,2.0,0,0,1990,0,2004,310000.0
3.0,1.75,1420,1.0,0,0,1100,320,1984,310000.0
3.0,1.0,1400,1.0,0,0,1400,0,1956,280000.0
4.0,2.5,1870,2.0,0,0,1870,0,2004,272000.0
4.0,3.0,3040,1.5,0,0,2680,360,1923,870000.0
3.0,2.0,1790,1.0,0,0,1390,400,1980,307000.0
2.0,1.5,1590,1.0,0,0,920,670,1946,490000.0
3.0,2.0,2050,1.0,0,0,1170,880,1960,399950.0
5.0,3.5,4220,1.0,0,0,2110,2110,1958,1635000.0
5.0,4.5,4030,2.0,0,0,4030,0,2000,989000.0
4.0,1.75,1770,1.0,0,0,1050,720,1983,264950.0
4.0,2.75,2100,1.0,0,0,1400,700,1979,491500.0
3.0,2.25,2120,2.0,0,0,2120,0,1984,345000.0
4.0,1.75,2600,1.0,0,0,2020,580,1969,339900.0
3.0,3.0,2400,2.0,0,0,1860,540,1905,852000.0
5.0,3.5,3180,1.0,0,3,1690,1490,1968,585000.0
4.0,2.0,2790,1.0,0,0,1640,1150,1977,723000.0
3.0,2.25,2080,2.0,0,0,2080,0,1990,594000.0
2.0,1.5,1370,2.0,0,0,1370,0,1987,405000.0
4.0,2.5,2790,2.0,0,0,2790,0,1997,725500.0
2.0,1.0,1740,1.0,0,0,1740,0,1955,800000.0
3.0,3.75,6400,1.0,0,2,3810,2590,1966,1325000.0
3.0,2.5,1800,2.0,0,0,1800,0,1996,180500.0
3.0,2.5,1800,2.0,0,0,1800,0,1996,325000.0
3.0,1.75,1190,1.0,0,0,1190,0,1968,235000.0
2.0,1.0,860,1.0,0,0,860,0,1948,330000.0
3.0,2.0,2460,1.0,0,2,1370,1090,1952,678500.0
4.0,2.5,1980,2.0,0,0,1980,0,1974,463000.0
2.0,1.0,670,1.0,0,0,670,0,1943,250000.0
3.0,2.0,1410,1.5,0,0,1410,0,1927,655000.0
4.0,2.25,1860,1.0,0,0,1120,740,1979,239900.0
3.0,1.0,980,1.0,0,0,980,0,1955,185000.0
4.0,2.25,3040,2.0,0,3,2080,960,1926,1735000.0
3.0,2.25,1810,1.0,0,0,1240,570,1977,251700.0
4.0,2.0,1560,1.0,0,0,1320,240,1964,400000.0
4.0,1.75,2100,1.0,0,0,1340,760,1955,735000.0
5.0,2.0,2500,2.0,1,4,2500,0,1942,1700000.0
2.0,1.0,520,1.0,0,0,520,0,1951,82500.0
4.0,4.0,3010,2.0,0,0,3010,0,2004,765000.0
4.0,1.75,2140,1.0,0,0,1420,720,1968,292500.0
3.0,2.25,2390,1.0,0,0,1990,400,1970,270000.0
2.0,1.0,1510,1.0,0,0,1090,420,1939,415000.0
4.0,1.75,2210,1.0,0,0,1460,750,1952,950000.0
3.0,2.75,2170,2.0,0,0,2170,0,1995,353000.0
3.0,2.5,1790,3.0,0,0,1790,0,2007,670950.0
3.0,1.75,1390,1.0,0,3,840,550,1912,280950.0
3.0,1.75,1850,1.0,0,0,1850,0,1983,585000.0
2.0,1.5,1480,1.0,0,0,1480,0,1974,525000.0
3.0,1.75,1850,1.0,0,0,1370,480,1973,605000.0
4.0,3.5,3350,2.0,0,0,2550,800,2007,1010000.0
3.0,1.0,1040,1.0,0,0,1040,0,1942,245990.0
4.0,2.25,2810,2.0,0,0,2810,0,1985,535000.0
1.0,1.5,1010,1.0,0,0,1010,0,1911,410000.0
3.0,2.5,2250,2.0,0,0,2250,0,1988,550000.0
3.0,1.75,1800,1.0,0,0,1800,0,1972,665000.0
3.0,1.0,2400,1.0,0,0,1890,510,1940,455000.0
4.0,1.0,1780,1.5,0,0,1780,0,1922,440000.0
3.0,2.25,2120,1.0,0,0,1720,400,1979,332000.0
3.0,2.5,1860,2.0,0,0,1860,0,1989,280000.0
3.0,3.5,1460,2.0,0,0,1150,310,2006,570000.0
3.0,1.0,1230,1.0,0,0,1230,0,1957,250000.0
2.0,1.0,1088,1.0,0,0,1088,0,1952,238000.0
3.0,1.0,800,1.0,0,0,700,100,1949,265000.0
3.0,1.0,1190,1.0,0,0,1190,0,1959,306000.0
5.0,2.75,1940,1.0,0,0,1240,700,2002,345000.0
4.0,2.5,3300,1.0,0,0,1720,1580,1971,765000.0
4.0,2.5,2590,2.0,0,0,2590,0,1998,346300.0
3.0,2.0,2080,1.0,0,0,2080,0,2002,342500.0
4.0,2.25,2680,2.0,0,0,2680,0,2000,501000.0
3.0,2.5,1670,1.0,0,0,1300,370,1990,270000.0
3.0,1.0,1830,1.5,0,0,1720,110,1930,638000.0
3.0,1.75,1400,1.0,0,0,700,700,1908,460000.0
4.0,1.75,2770,1.0,0,0,1470,1300,1953,760000.0
3.0,2.5,3630,1.0,0,0,2150,1480,1972,1085000.0
3.0,1.0,1040,1.0,0,0,1040,0,1983,234000.0
3.0,2.75,2690,2.0,1,4,2690,0,1975,1650000.0
5.0,2.0,2020,1.5,0,0,2020,0,1938,488000.0
5.0,2.5,2450,2.0,0,0,2450,0,1963,1550000.0
4.0,3.0,2030,2.0,0,0,2030,0,1982,499000.0
3.0,1.0,1450,1.0,0,0,1450,0,1952,150000.0
4.0,2.5,2400,2.0,0,0,2400,0,1993,333000.0
4.0,2.75,2870,1.0,0,1,1860,1010,1959,700000.0
4.0,1.0,1340,1.5,0,0,1340,0,1926,275000.0
3.0,2.5,1680,1.0,0,0,1080,600,1959,330000.0
4.0,2.0,1850,1.0,0,0,1850,0,1969,360000.0
3.0,1.0,1220,1.5,0,0,1220,0,1965,467000.0
3.0,2.5,2320,1.0,0,0,1790,530,1979,568000.0
5.0,2.25,3220,2.0,0,0,3220,0,1972,605000.0
4.0,2.75,3190,2.0,0,0,3190,0,2005,750000.0
3.0,2.75,3530,2.0,0,0,3530,0,1994,760000.0
3.0,1.75,2050,1.0,0,0,1240,810,1979,265000.0
3.0,1.75,1720,1.0,0,0,1720,0,1956,490000.0
4.0,2.5,2850,2.0,0,0,2850,0,2004,360000.0
4.0,2.25,2270,1.0,0,0,1290,980,1976,311750.0
3.0,2.25,1880,1.0,0,0,1420,460,1958,399000.0
4.0,2.5,2770,2.0,0,0,2770,0,1989,347000.0
4.0,3.75,4490,2.0,0,0,4490,0,1998,1680000.0
4.0,2.5,3110,2.0,0,0,3110,0,2005,585000.0
4.0,2.5,2360,2.0,0,0,2360,0,1992,340000.0
3.0,2.5,2180,2.0,0,0,2180,0,1994,612000.0
2.0,1.75,1910,2.0,0,0,1910,0,1980,230000.0
4.0,2.5,2260,2.0,0,0,2260,0,1989,604000.0
3.0,1.75,1770,1.0,0,0,1770,0,1959,250000.0
3.0,2.0,1460,1.0,0,0,1460,0,1989,258500.0
4.0,2.75,2080,1.0,0,0,1470,610,1940,783000.0
5.0,2.25,2960,1.0,0,2,1550,1410,1958,1050000.0
4.0,2.5,3220,2.0,0,0,3220,0,2002,760000.0
3.0,1.0,1140,1.0,0,0,1140,0,1960,276000.0
4.0,2.0,1660,1.0,0,0,1660,0,1966,550000.0
4.0,1.0,1430,1.5,0,0,1430,0,1953,398000.0
3.0,3.0,1820,1.5,0,0,1620,200,1914,775000.0
4.0,3.0,3540,2.0,0,0,2720,820,1988,1027500.0
4.0,1.0,1620,1.5,0,0,1620,0,1905,327000.0
4.0,2.75,3100,2.0,0,0,3100,0,1995,564500.0
4.0,1.75,1500,1.5,0,0,1500,0,1905,782000.0
4.0,2.5,2820,2.0,0,0,2820,0,2005,398000.0
3.0,1.75,1850,1.5,0,0,1850,0,1915,257000.0
4.0,2.0,1570,2.0,0,0,1570,0,1984,235000.0
4.0,2.75,2300,1.0,0,3,1550,750,1979,453000.0
2.0,1.0,920,1.0,0,0,920,0,1954,535000.0
3.0,2.5,1600,2.0,0,0,1600,0,1993,275000.0
3.0,2.5,2630,2.0,0,0,2630,0,1996,665000.0
4.0,2.75,3020,1.0,0,0,1540,1480,1977,670000.0
3.0,1.75,1490,1.0,0,0,1060,430,1966,465000.0
3.0,1.5,1160,1.0,0,0,1160,0,1970,210000.0
4.0,2.5,2040,2.0,0,0,2040,0,2001,265000.0
2.0,2.5,1550,2.0,0,0,1550,0,1987,426000.0
4.0,2.25,1990,1.0,0,0,1290,700,1966,529219.0
3.0,2.25,1900,1.5,0,0,1440,460,1969,600000.0
5.0,3.5,3840,2.0,0,0,3840,0,2001,875000.0
4.0,3.0,2400,1.0,0,0,1200,1200,1956,608000.0
3.0,1.0,1660,1.0,0,0,1660,0,1973,220000.0
4.0,5.0,6055,1.0,0,3,3555,2500,1996,1760000.0
3.0,2.0,2030,1.0,0,2,1890,140,1966,295450.0
2.0,1.0,840,1.0,0,0,840,0,1925,315000.0
4.0,2.0,1450,1.0,0,0,1450,0,1967,205000.0
3.0,1.5,1460,1.0,0,0,1460,0,1952,310000.0
5.0,1.0,2010,1.5,0,0,1890,120,1927,1000000.0
4.0,2.5,2910,2.0,0,2,2910,0,2006,525000.0
4.0,1.75,1880,1.0,0,0,1130,750,1960,284000.0
3.0,1.75,2170,1.0,0,0,1450,720,1986,510000.0
2.0,1.0,1260,1.0,0,0,1260,0,1947,405000.0
3.0,2.5,1970,2.0,0,0,1970,0,2007,509950.0
4.0,2.25,2090,2.0,0,0,2090,0,1987,600000.0
4.0,3.75,3450,2.0,0,0,2570,880,2006,990000.0
3.0,1.5,1130,1.0,0,0,1130,0,1954,280005.0
3.0,1.75,2600,1.0,0,0,1300,1300,1968,700000.0
3.0,1.0,1030,1.0,0,0,1030,0,1953,330000.0
2.0,1.0,1700,1.0,0,2,1230,470,1956,340000.0
2.0,2.5,1480,2.0,0,0,1390,90,2007,468000.0
4.0,2.5,4250,2.0,0,2,3260,990,1972,1339000.0
3.0,1.75,1600,1.0,0,0,1600,0,1955,515000.0
4.0,2.0,1870,1.0,0,2,1870,0,1977,245000.0
3.0,2.5,1440,1.0,0,0,1000,440,1983,265000.0
3.0,2.5,2720,2.0,0,0,2720,0,1990,372400.0
3.0,1.5,1240,1.0,0,0,1240,0,1948,390000.0
3.0,1.0,1020,1.0,0,0,1020,0,1967,208000.0
2.0,0.5,1180,1.0,0,0,590,590,1945,273000.0
5.0,3.5,3080,2.0,0,0,2310,770,2003,455000.0
4.0,2.5,1750,2.0,0,0,1750,0,1988,270000.0
4.0,2.25,2530,1.0,0,0,1210,1320,1958,618000.0
3.0,2.5,1580,2.0,0,0,1580,0,1990,213550.0
5.0,1.75,2340,2.0,0,0,2340,0,1957,210000.0
5.0,4.0,6300,2.0,0,1,4360,1940,2004,2750000.0
4.0,2.75,2400,1.0,0,0,1200,1200,1974,403500.0
3.0,1.5,1300,1.0,0,0,1300,0,1963,235000.0
3.0,2.0,1760,1.0,0,0,880,880,1936,287500.0
4.0,1.5,1520,1.0,0,0,1020,500,1946,546800.0
3.0,1.75,1070,1.0,0,0,1070,0,1957,183000.0
3.0,2.0,2560,1.0,0,0,2560,0,1986,560000.0
3.0,1.0,1280,1.0,0,0,1280,0,1958,299500.0
4.0,2.25,1660,1.0,0,0,1660,0,1965,610000.0
3.0,1.5,1860,1.0,0,0,1200,660,1963,288350.0
2.0,1.0,950,1.0,0,2,850,100,1926,500000.0
4.0,2.75,2140,1.0,0,0,1190,950,1951,625000.0
2.0,1.5,1480,2.0,0,0,1240,240,2007,418000.0
3.0,3.0,2260,2.0,0,0,1660,600,2002,660000.0
4.0,2.5,2300,2.0,0,0,2300,0,1999,775000.0
3.0,2.75,1650,1.0,0,0,1230,420,1972,429500.0
3.0,2.0,1990,1.5,0,0,1230,760,1908,569000.0
4.0,2.0,1960,1.0,0,0,1160,800,1978,250000.0
3.0,1.5,1310,1.0,0,0,1310,0,1969,225000.0
4.0,2.75,2450,1.0,0,0,2450,0,1974,530000.0
3.0,1.0,910,1.0,0,0,910,0,1955,306000.0
3.0,1.75,1580,1.0,0,0,1580,0,1962,517100.0
3.0,1.75,1780,1.0,0,0,1130,650,1976,354950.0
3.0,1.5,1040,1.0,0,0,1040,0,1925,348000.0
4.0,2.5,2340,1.0,0,0,1640,700,1977,522250.0
3.0,2.5,1720,1.0,0,0,1000,720,1983,275000.0
3.0,1.5,1600,1.0,0,0,1600,0,1954,390000.0
3.0,1.5,1320,1.0,0,0,1320,0,1954,260000.0
5.0,2.75,2350,1.5,0,0,1520,830,1922,585000.0
5.0,2.75,2740,1.5,0,0,1670,1070,1925,605000.0
4.0,2.5,2300,2.0,0,0,2300,0,2001,342000.0
5.0,3.0,4350,2.0,0,0,2950,1400,1972,900000.0
3.0,1.75,1430,1.0,0,0,980,450,1981,252000.0
3.0,1.75,2400,1.0,0,0,2400,0,1971,357000.0
3.0,1.0,940,1.0,0,0,940,0,1959,370000.0
3.0,1.0,1020,1.0,0,0,1020,0,1959,322500.0
2.0,2.0,1680,2.0,0,0,1680,0,1910,210000.0
2.0,1.0,1340,1.0,0,0,1340,0,1949,290000.0
4.0,3.25,3960,2.0,0,0,3960,0,2005,860000.0
6.0,2.0,2650,1.5,0,0,2650,0,1911,302000.0
4.0,2.25,2120,2.0,0,2,2120,0,1965,369160.0
4.0,2.75,2850,2.5,0,0,2530,320,2003,1185000.0
4.0,2.0,2850,2.0,0,0,2490,360,1954,993000.0
6.0,2.0,1870,1.0,0,0,1870,0,1968,380000.0
4.0,2.0,2660,1.0,0,0,1380,1280,1949,635000.0
3.0,1.0,1190,1.0,0,0,1190,0,1947,260000.0
2.0,1.0,1770,1.5,0,0,960,810,1943,243000.0
4.0,2.5,2770,2.0,0,0,2770,0,2001,1400000.0
4.0,2.5,2080,1.0,0,2,1220,860,1952,665000.0
5.0,2.25,2700,2.0,0,0,2700,0,1987,898000.0
4.0,2.75,2200,1.0,0,0,1100,1100,1955,583000.0
4.0,1.75,2160,2.0,0,0,2160,0,1977,429000.0
3.0,2.5,2010,2.0,0,0,2010,0,1998,471000.0
3.0,3.5,3780,2.0,0,0,2430,1350,1951,1810000.0
3.0,3.25,4460,2.0,0,0,4460,0,2005,739500.0
3.0,1.5,1770,1.0,0,0,1160,610,1959,450000.0
3.0,1.0,1430,1.0,0,0,1430,0,1949,552500.0
4.0,1.75,1700,1.0,0,0,850,850,1954,437000.0
4.0,2.0,1830,1.5,0,0,1830,0,1951,270000.0
3.0,1.5,1410,1.0,0,0,1410,0,1965,226740.0
4.0,2.5,3060,1.0,0,0,1810,1250,1974,446500.0
3.0,2.0,1820,2.0,0,2,1520,300,1920,283000.0
4.0,1.75,2430,1.5,0,0,2430,0,1909,445000.0
2.0,1.0,740,1.0,0,0,740,0,1942,250000.0
3.0,1.0,770,1.0,0,0,670,100,1942,307000.0
4.0,2.75,2200,1.0,0,0,1860,340,1991,315000.0
3.0,3.0,2920,1.5,0,2,1540,1380,1908,555000.0
4.0,2.5,2040,1.0,0,0,1250,790,1979,264900.0
3.0,2.0,1600,1.0,0,0,990,610,1978,510000.0
4.0,2.5,1990,2.0,0,0,1990,0,2002,328000.0
4.0,2.5,1830,2.0,0,0,1830,0,2002,358000.0
3.0,2.5,2540,2.0,0,0,2540,0,2005,325000.0
2.0,3.25,2700,3.0,1,3,2700,0,1990,1365000.0
4.0,2.0,1440,1.0,0,0,1440,0,1967,230000.0
3.0,2.0,1550,1.0,0,0,940,610,1955,545000.0
3.0,2.5,2490,2.0,0,0,2490,0,2003,705380.0
5.0,2.5,2650,1.0,0,0,1350,1300,1979,459000.0
4.0,2.25,2000,2.0,0,0,2000,0,2001,815000.0
6.0,5.0,3440,2.0,0,0,3280,160,2007,495000.0
3.0,2.5,2280,2.5,0,3,2280,0,1987,520000.0
2.0,1.5,1320,3.0,0,0,1320,0,2001,430000.0
4.0,2.5,2070,2.0,0,0,2070,0,1989,255000.0
3.0,2.0,1860,2.0,0,0,1860,0,1908,588000.0
3.0,1.0,940,1.0,0,0,940,0,1959,350000.0
4.0,2.75,2290,1.0,0,2,2290,0,1963,625000.0
2.0,2.0,1510,1.0,0,0,1250,260,1958,172500.0
3.0,2.0,1830,1.5,0,0,1290,540,1909,554000.0
4.0,2.5,3090,2.0,0,0,3090,0,2001,775000.0
4.0,3.5,4340,2.0,0,0,4340,0,2003,1187500.0
3.0,2.75,3200,2.0,0,1,3200,0,1977,618000.0
4.0,1.0,1560,1.5,0,0,1560,0,1954,305000.0
3.0,2.0,1280,1.0,0,0,1280,0,1994,232000.0
4.0,2.5,2020,2.0,0,0,2020,0,2002,262000.0
3.0,1.0,1040,1.0,0,0,1040,0,1971,234000.0
4.0,2.75,2260,1.0,0,3,1330,930,2002,500000.0
3.0,1.0,860,1.0,0,0,860,0,1920,278000.0
5.0,1.0,1920,1.0,0,0,1160,760,1961,230000.0
4.0,1.75,2290,1.0,0,0,1270,1020,1969,500000.0
4.0,2.75,2070,1.0,0,0,1120,950,1945,366500.0
6.0,3.0,4250,2.5,0,0,3020,1230,1902,665000.0
3.0,1.5,2220,2.0,0,3,1790,430,1928,1101000.0
2.0,1.75,1840,1.0,0,0,1140,700,1957,575000.0
4.0,2.5,2590,2.0,0,0,2590,0,1993,674750.0
5.0,2.0,3110,1.0,0,0,1560,1550,1940,719000.0
3.0,1.75,2600,1.0,0,0,1300,1300,1980,482000.0
2.0,1.0,1060,1.0,0,0,1060,0,1952,254000.0
3.0,1.75,1250,1.0,0,0,750,500,1944,443725.0
4.0,2.5,2520,2.0,0,0,2520,0,1980,575000.0
3.0,2.25,2070,1.0,0,0,1440,630,1977,469000.0
2.0,1.0,1300,1.0,0,0,1300,0,1958,175000.0
5.0,2.0,2190,1.0,0,0,1390,800,1961,437000.0
4.0,3.0,2760,1.0,0,0,1760,1000,1974,550000.0
3.0,2.25,1710,1.0,0,0,1130,580,1979,172040.0
3.0,2.0,1750,1.0,0,0,1750,0,1993,363000.0
3.0,2.25,1552,2.0,0,0,1552,0,2012,282000.0
6.0,2.0,2350,2.0,0,1,2000,350,1905,400000.0
5.0,3.5,5110,2.0,0,0,3850,1260,2003,650000.0
3.0,2.5,1720,2.0,0,0,1720,0,1990,365000.0
4.0,2.5,1960,2.0,0,0,1960,0,2002,269950.0
2.0,1.0,1270,1.0,0,0,1270,0,1977,260000.0
3.0,1.5,1180,1.0,0,0,1180,0,1977,193000.0
4.0,2.25,2230,2.0,0,0,2230,0,2005,340000.0
4.0,3.25,4700,2.0,0,0,3420,1280,1978,900000.0
3.0,2.5,2150,2.0,0,0,2150,0,1991,371000.0
3.0,2.5,2400,2.0,0,0,2400,0,1985,592000.0
3.0,2.5,1830,2.0,0,0,1830,0,1991,300000.0
4.0,3.0,2800,2.0,0,0,2800,0,2003,449950.0
3.0,2.5,2090,2.0,0,0,2090,0,1989,299500.0
4.0,2.25,2340,1.0,0,0,2340,0,1963,995000.0
4.0,1.75,1670,1.0,0,0,1100,570,1960,335000.0
4.0,2.25,1990,1.0,0,0,1180,810,1978,280000.0
4.0,2.25,2270,1.0,0,0,1290,980,1977,446000.0
4.0,2.75,4910,1.0,0,0,2560,2350,1964,1544500.0
3.0,1.0,950,1.0,0,0,950,0,1943,325000.0
3.0,1.75,1610,1.0,0,0,1610,0,1955,450000.0
4.0,2.5,1940,2.0,0,0,1940,0,2000,322500.0
3.0,1.0,1210,1.0,0,0,1210,0,1955,453000.0
4.0,2.5,2570,2.0,0,0,2570,0,2001,655000.0
3.0,2.25,1700,2.0,0,0,1150,550,1926,603000.0
4.0,1.0,1610,1.5,0,0,1610,0,1947,235000.0
4.0,3.5,4120,2.0,0,0,3070,1050,2006,968933.0
3.0,3.5,2880,1.0,0,0,1690,1190,1980,1015000.0
4.0,2.25,1990,2.0,0,0,1990,0,1973,435000.0
3.0,2.0,1260,1.0,0,0,1260,0,1986,242000.0
6.0,3.25,4750,2.0,0,0,4750,0,1947,487000.0
4.0,2.75,3010,2.0,0,0,3010,0,1996,810000.0
3.0,2.5,2410,1.0,0,0,1820,590,1976,625000.0
3.0,1.5,1280,1.0,0,0,1280,0,1973,165000.0
3.0,1.0,2320,1.0,0,0,1160,1160,1960,335000.0
3.0,1.0,1220,1.0,0,0,1220,0,1958,286700.0
2.0,1.5,1400,1.0,0,0,1400,0,1954,699000.0
3.0,1.75,1590,1.0,0,0,1140,450,1974,280000.0
4.0,2.5,2220,2.0,0,0,2220,0,1988,580000.0
2.0,2.5,2770,2.0,0,0,2770,0,2006,754800.0
4.0,2.5,2303,2.0,0,0,2303,0,1995,525000.0
3.0,1.75,1600,1.0,0,2,1600,0,1962,562000.0
4.0,1.75,1280,1.0,0,0,860,420,1926,575000.0
5.0,2.5,2900,2.0,0,0,2900,0,2006,808900.0
3.0,2.25,2950,1.0,0,0,2070,880,1966,992000.0
3.0,2.5,1700,2.0,0,0,1700,0,1997,335000.0
3.0,2.75,1050,1.0,0,0,1050,0,1985,473000.0
4.0,2.75,2990,1.0,0,1,1880,1110,1977,350000.0
5.0,2.5,3100,2.5,0,0,3100,0,1906,1600000.0
3.0,1.0,1240,1.0,0,0,1240,0,1950,305500.0
2.0,1.0,780,1.0,0,0,780,0,1946,306000.0
2.0,2.25,850,2.0,0,0,850,0,2001,233000.0
3.0,1.75,1540,1.0,0,0,1540,0,1971,490000.0
4.0,2.5,2280,2.0,0,0,2280,0,1994,445000.0
3.0,2.25,2550,1.0,0,0,1850,700,1959,355000.0
2.0,2.0,1770,1.0,0,0,1770,0,1987,360000.0
3.0,1.75,2320,2.0,0,0,2320,0,1935,737500.0
3.0,3.5,2600,2.0,0,0,2600,0,1969,985000.0
2.0,3.25,1570,2.0,0,0,1310,260,2006,349950.0
4.0,2.5,3060,2.0,0,0,2860,200,2005,520000.0
4.0,2.5,1960,1.0,0,0,1220,740,1955,355950.0
5.0,2.5,3270,2.0,0,0,3270,0,2004,485000.0
3.0,1.0,1090,1.0,0,0,1090,0,1969,143000.0
2.0,1.75,6840,2.5,1,4,4350,2490,2001,3278000.0
3.0,1.0,940,1.0,0,0,940,0,1967,355000.0
5.0,3.5,3880,2.0,0,3,2540,1340,1979,1126000.0
5.0,1.75,1770,1.0,0,0,1770,0,1959,200000.0
4.0,2.5,3640,2.0,0,0,3640,0,1999,913000.0
3.0,2.5,3160,1.0,0,2,1820,1340,1966,1600000.0
2.0,2.5,1590,2.0,0,0,1590,0,1997,409900.0
4.0,1.0,1290,1.0,0,0,1050,240,1950,265000.0
5.0,3.0,3655,1.0,0,0,2174,1481,1955,740000.0
4.0,2.5,2490,2.0,0,0,2490,0,2001,306000.0
3.0,2.5,1470,2.0,0,0,1470,0,2003,381000.0
3.0,3.25,3960,2.0,0,3,2600,1360,1933,1220000.0
3.0,3.5,3190,1.0,0,3,2630,560,1941,1050000.0
2.0,1.0,810,1.0,0,0,810,0,1948,408000.0
5.0,2.5,2980,2.0,0,0,2980,0,2006,739900.0
4.0,2.5,2780,1.0,0,0,2780,0,1985,674250.0
2.0,1.0,1340,1.0,0,0,1340,0,1953,438400.0
5.0,5.0,4930,2.0,0,3,4160,770,2000,1700000.0
3.0,2.0,1360,1.5,0,0,1360,0,1945,703000.0
3.0,1.75,1320,1.0,0,0,1320,0,1989,262000.0
3.0,2.0,1210,1.0,0,0,1210,0,1984,353000.0
4.0,2.5,1940,2.0,0,0,1940,0,1995,500000.0
4.0,2.5,3160,1.5,0,4,2020,1140,1917,1280000.0
4.0,2.5,1980,2.0,0,0,1980,0,2004,332000.0
4.0,2.5,2320,1.0,0,0,1620,700,1974,824000.0
4.0,2.0,1660,1.0,0,0,1660,0,1968,290000.0
3.0,2.5,1660,2.0,0,2,1400,260,2002,700000.0
2.0,1.0,1080,1.0,0,0,780,300,1922,550000.0
2.0,1.0,1510,1.5,0,0,1510,0,1921,549000.0
4.0,2.5,2950,1.0,0,2,2550,400,1951,1865000.0
4.0,2.25,3070,2.0,0,0,3070,0,1978,858000.0
2.0,1.0,970,1.0,0,0,970,0,1947,345000.0
4.0,1.75,2140,2.5,0,0,2140,0,1930,340000.0
4.0,2.25,2570,2.5,0,0,2570,0,1962,1215000.0
3.0,2.25,1260,3.0,0,0,1260,0,2009,275000.0
3.0,1.0,1220,1.0,0,0,1220,0,1963,405000.0
3.0,2.0,1720,2.0,0,0,1720,0,1949,432500.0
4.0,1.0,2140,1.5,0,0,1320,820,1925,236500.0
4.0,1.5,1420,1.5,0,0,1420,0,1928,679000.0
4.0,2.5,2060,2.0,0,0,2060,0,1995,543000.0
3.0,1.0,1320,1.0,0,0,990,330,1953,294000.0
3.0,1.75,1810,1.0,0,0,1810,0,1969,340500.0
4.0,2.5,2980,2.0,0,0,2980,0,1989,1012000.0
2.0,2.0,1350,1.0,0,0,1350,0,1976,335000.0
3.0,2.0,1540,1.0,0,0,1540,0,1988,425000.0
3.0,2.5,2510,2.0,0,0,2510,0,2001,353000.0
3.0,2.5,1670,2.0,0,0,1670,0,1991,540000.0
5.0,3.5,3690,2.0,0,0,2540,1150,2006,640000.0
3.0,1.0,1320,1.0,0,0,1320,0,1959,339950.0
3.0,1.75,1510,1.0,0,0,980,530,1979,195000.0
3.0,1.75,1510,1.0,0,0,980,530,1979,322000.0
4.0,1.75,1870,1.0,0,0,1620,250,1978,660000.0
6.0,3.0,2400,2.0,0,0,2400,0,1991,280000.0
6.0,3.0,2400,2.0,0,0,2400,0,1991,300000.0
3.0,1.0,1170,1.0,0,0,1170,0,1966,207500.0
3.0,1.5,1190,1.0,0,0,1190,0,1956,195000.0
3.0,2.0,2080,1.0,0,0,1160,920,1954,700000.0
4.0,1.75,2150,1.0,0,2,1460,690,1982,560000.0
3.0,1.75,1580,1.0,0,0,1580,0,1911,260000.0
3.0,1.75,1580,1.0,0,0,1580,0,1911,575000.0
3.0,2.5,2370,2.0,0,0,1950,420,2006,475000.0
3.0,1.75,1840,1.0,0,0,920,920,1905,285000.0
4.0,2.5,2660,2.0,0,2,2660,0,2003,753888.0
3.0,2.5,2190,2.0,0,0,2190,0,2003,650000.0
3.0,2.25,1660,1.5,0,0,1100,560,1929,620000.0
3.0,1.75,1780,1.0,0,0,1300,480,1977,526000.0
2.0,1.0,700,1.0,0,0,700,0,1952,155000.0
4.0,2.0,1570,1.0,0,0,1120,450,1959,342000.0
3.0,1.75,1220,1.0,0,0,1220,0,1981,390000.0
3.0,2.75,3150,2.0,0,0,3000,150,1990,685000.0
4.0,2.5,2690,2.0,0,0,2690,0,2001,608000.0
2.0,1.0,680,1.0,0,0,680,0,1943,179900.0
6.0,3.25,3750,2.0,0,2,2750,1000,1936,1245000.0
3.0,1.0,1010,1.0,0,0,1010,0,1957,166000.0
3.0,1.5,1710,1.5,0,0,1410,300,1928,462000.0
4.0,2.5,2090,2.0,0,0,2090,0,1990,545000.0
3.0,1.0,1560,1.5,0,0,1560,0,1903,415000.0
3.0,2.5,1560,2.0,0,0,1560,0,2003,269000.0
4.0,2.5,2570,2.0,0,0,2570,0,2008,356500.0
3.0,1.0,1010,1.0,0,0,1010,0,1961,225000.0
2.0,1.0,1020,1.0,0,0,1020,0,1948,175000.0
5.0,2.5,1710,2.0,0,0,1710,0,1974,549000.0
3.0,2.75,2300,2.0,0,0,2300,0,1989,535000.0
4.0,2.25,1990,1.0,0,0,1210,780,1973,627000.0
3.0,2.0,2730,2.5,0,3,2730,0,1976,565000.0
4.0,2.0,2195,1.0,0,0,1060,1135,1912,392450.0
2.0,2.0,1560,1.0,0,0,1560,0,2006,509000.0
3.0,2.5,1400,1.0,0,0,1200,200,1921,340000.0
3.0,2.5,1400,1.0,0,0,1200,200,1921,537000.0
4.0,3.0,3690,2.0,0,0,3690,0,1998,865000.0
2.0,1.0,1140,1.0,0,0,1140,0,1948,358000.0
4.0,2.25,1920,1.5,0,0,1300,620,1923,595000.0
4.0,2.5,2496,2.0,0,0,2496,0,1998,661000.0
3.0,2.25,2280,1.0,0,0,1680,600,1977,419950.0
4.0,3.5,3200,2.0,0,0,3200,0,2006,490000.0
2.0,1.0,880,1.0,0,0,880,0,1940,525000.0
3.0,2.0,1320,3.0,0,0,1320,0,1995,350000.0
3.0,2.5,2450,2.0,0,0,2450,0,2008,552500.0
3.0,1.0,1040,1.0,0,0,1040,0,1961,210000.0
3.0,2.5,2480,2.0,0,0,2480,0,1990,390000.0
5.0,1.75,1830,1.5,0,0,1610,220,1958,336800.0
3.0,2.5,1440,2.0,0,0,1440,0,2003,465000.0
4.0,2.5,1580,2.0,0,0,1580,0,2011,299900.0
3.0,3.25,3230,2.0,0,0,3230,0,2006,715000.0
4.0,2.5,1810,1.0,0,0,1230,580,1970,235000.0
3.0,2.5,2495,2.0,0,0,2495,0,2007,276000.0
4.0,1.5,1740,1.0,0,0,1180,560,1964,265000.0
3.0,1.75,1680,1.0,0,2,840,840,1900,425000.0
4.0,2.5,2460,2.0,0,0,2460,0,1993,313000.0
3.0,2.5,3050,1.0,0,3,1720,1330,1984,715000.0
3.0,2.25,1630,2.0,0,0,1630,0,1991,265000.0
3.0,2.75,2460,2.0,0,0,2460,0,2004,646000.0
3.0,1.0,1030,1.0,0,0,1030,0,1954,175000.0
3.0,2.5,3410,1.0,0,3,2450,960,1973,649000.0
3.0,2.75,2310,1.0,0,0,1520,790,1940,785000.0
4.0,2.75,2610,1.0,0,0,1260,1350,1920,890000.0
3.0,3.0,2330,1.0,0,0,2330,0,1998,612000.0
4.0,2.5,2980,2.0,0,0,2980,0,2003,330000.0
3.0,2.25,1790,1.0,0,0,1790,0,1978,493000.0
4.0,2.25,2940,1.0,0,0,1470,1470,1957,1600000.0
4.0,3.0,3900,1.0,0,4,2520,1380,1972,1620000.0
4.0,3.0,3900,1.0,0,4,2520,1380,1972,1650000.0
3.0,2.5,1750,2.5,0,0,1230,520,1900,499000.0
6.0,2.75,2660,1.0,0,0,1550,1110,1962,603500.0
2.0,1.5,1580,1.0,0,2,1280,300,1941,530000.0
5.0,2.5,2350,1.0,0,0,1220,1130,1962,895000.0
4.0,2.25,2510,1.0,0,0,1610,900,1972,267345.0
3.0,2.5,1480,2.0,0,0,1480,0,1987,275000.0
3.0,1.75,1720,1.0,0,0,1240,480,1950,439950.0
3.0,2.25,1470,2.0,0,0,1470,0,1985,455000.0
3.0,1.75,1540,1.0,0,0,1250,290,1944,630000.0
3.0,2.5,2820,2.0,0,0,2820,0,2004,690000.0
4.0,1.75,1250,1.0,0,0,1250,0,1971,212000.0
4.0,2.25,2080,1.0,0,0,1280,800,1985,231500.0
4.0,3.25,5180,2.0,0,0,5180,0,1991,1237500.0
3.0,2.5,2860,2.0,0,0,2860,0,1990,378500.0
4.0,2.5,2710,2.0,0,0,2710,0,1989,482000.0
2.0,1.0,1140,1.0,0,0,1140,0,1924,695000.0
4.0,2.5,4070,2.0,0,0,4070,0,1989,965000.0
3.0,1.75,1710,1.0,0,0,1120,590,1941,675000.0
3.0,1.5,1340,1.0,0,0,1340,0,1972,387000.0
4.0,2.75,2290,2.0,0,0,2290,0,1977,347500.0
3.0,2.0,1860,1.0,0,0,930,930,1922,385000.0
3.0,1.0,1080,1.0,0,0,1080,0,1950,265000.0
3.0,1.0,960,1.0,0,0,960,0,1953,406000.0
2.0,1.5,980,2.0,0,0,980,0,1922,134000.0
3.0,1.0,1500,2.0,0,0,1300,200,1926,415000.0
3.0,1.75,1440,1.0,0,0,1440,0,1973,375000.0
4.0,2.5,2580,2.0,0,0,2580,0,1993,620000.0
5.0,2.5,2070,2.0,0,0,2070,0,1999,337500.0
3.0,2.5,1880,1.0,0,0,1260,620,1967,565000.0
3.0,1.75,2420,2.0,0,0,2420,0,1911,399500.0
2.0,1.75,1890,2.0,0,0,1890,0,1987,1065000.0
3.0,2.0,1920,1.0,0,0,1920,0,1992,352500.0
3.0,2.0,1870,1.0,0,0,1270,600,1986,259000.0
2.0,1.0,900,1.0,0,0,900,0,1971,320000.0
3.0,2.5,2160,2.0,0,0,2160,0,1989,733000.0
2.0,1.0,900,1.0,0,0,900,0,1924,381500.0
2.0,1.0,1180,1.0,0,0,940,240,1957,343000.0
2.0,1.0,900,1.0,0,0,900,0,1938,205500.0
3.0,2.0,1600,1.0,0,0,1600,0,1967,525000.0
3.0,1.75,1500,1.0,0,2,750,750,1943,300000.0
2.0,1.0,1070,1.0,0,0,1070,0,1942,299000.0
4.0,2.5,2570,2.0,0,0,2570,0,1990,561000.0
3.0,1.0,1210,1.5,0,0,1090,120,1928,450000.0
4.0,2.5,1850,2.0,0,0,1850,0,1985,540000.0
3.0,2.5,1740,2.0,0,0,1740,0,1992,379000.0
3.0,1.0,1300,1.0,0,0,1300,0,1958,230000.0
3.0,2.5,2000,2.0,0,0,2000,0,1989,399950.0
5.0,2.5,3220,2.0,0,0,3220,0,2002,355000.0
4.0,2.25,2160,1.0,0,0,2160,0,1969,580000.0
3.0,2.0,2130,1.5,0,0,1680,450,1922,700000.0
3.0,1.75,1580,1.0,0,1,1100,480,1962,279900.0
3.0,1.0,1200,1.0,0,0,1200,0,1905,210000.0
3.0,3.0,3790,2.0,0,0,2810,980,1989,1165000.0
2.0,1.0,860,1.0,0,0,860,0,1931,290300.0
5.0,4.5,5130,2.0,0,0,5130,0,1996,1599950.0
3.0,1.0,1600,1.5,0,0,1400,200,1939,490000.0
4.0,2.5,2110,2.0,0,0,2110,0,1987,606000.0
3.0,1.0,1400,1.0,0,0,950,450,1943,359950.0
3.0,2.0,2110,1.0,0,0,2110,0,1993,677100.0
3.0,2.0,1430,1.0,0,0,1430,0,1984,465000.0
5.0,5.5,6640,2.0,1,4,6350,290,2004,4500000.0
3.0,2.0,3040,1.0,0,0,1520,1520,1978,500000.0
2.0,1.0,980,1.0,0,0,980,0,1950,455000.0
6.0,2.0,2570,1.5,0,0,1970,600,1911,705000.0
3.0,2.5,2060,1.0,0,0,1460,600,1967,420000.0
3.0,1.0,1300,1.0,0,0,1300,0,1968,169575.0
3.0,1.0,1300,1.0,0,0,1300,0,1968,250000.0
3.0,2.25,1680,1.0,0,0,1180,500,1973,530000.0
5.0,3.25,4020,1.0,0,0,2170,1850,1970,590000.0
3.0,1.75,1530,1.0,0,0,1070,460,1979,257500.0
3.0,1.0,1170,1.0,0,0,1170,0,1957,415000.0
3.0,1.75,1580,1.5,0,0,1280,300,1945,536000.0
3.0,1.5,1270,1.0,0,0,1270,0,1964,246500.0
3.0,1.75,1480,1.0,0,0,1480,0,1975,395000.0
3.0,2.25,2220,1.0,0,0,1700,520,1974,739000.0
4.0,2.75,3200,2.0,0,0,3200,0,1984,1272000.0
3.0,1.0,910,1.0,0,0,910,0,1968,190000.0
3.0,1.5,1480,1.0,0,0,1480,0,1962,305000.0
4.0,4.25,3770,2.0,0,0,3770,0,1983,925000.0
4.0,3.0,3500,2.0,0,0,2360,1140,1977,895000.0
3.0,1.75,1480,1.5,0,0,1480,0,1943,656000.0
4.0,1.0,1660,1.5,0,0,1260,400,1945,560000.0
5.0,2.25,2520,2.0,0,0,2520,0,1977,610000.0
4.0,2.5,2850,2.0,0,0,2850,0,1987,645000.0
3.0,2.5,2153,2.0,0,0,2153,0,2007,259000.0
4.0,2.5,3780,2.0,0,0,3780,0,1990,980000.0
4.0,4.0,3770,1.0,0,0,1940,1830,1967,872000.0
6.0,2.75,3600,1.0,0,2,1940,1660,1977,1000000.0
3.0,2.75,2980,1.5,0,0,1590,1390,1941,900000.0
4.0,1.5,2320,1.5,0,0,1540,780,1915,475000.0
5.0,2.75,2980,1.0,0,0,1730,1250,1975,350000.0
4.0,1.75,2930,1.0,0,3,1670,1260,1947,840000.0
4.0,2.5,2040,1.0,0,0,1420,620,1963,500000.0
3.0,1.5,1510,1.0,0,0,1110,400,1954,202500.0
4.0,2.5,2660,2.0,0,0,2660,0,1988,523000.0
3.0,2.5,1740,2.0,0,0,1740,0,1989,225000.0
3.0,2.25,2240,1.0,0,1,1190,1050,1980,418200.0
4.0,1.75,1570,1.0,0,0,1170,400,1959,356500.0
4.0,3.0,2500,1.5,0,0,1460,1040,1926,670000.0
3.0,2.25,1750,1.0,0,0,1150,600,1962,456150.0
4.0,2.5,3030,2.0,0,0,2020,1010,1998,471000.0
3.0,2.5,1680,3.0,0,0,1680,0,2008,558000.0
6.0,4.5,5740,2.0,0,2,3610,2130,2000,1380000.0
3.0,1.0,1220,1.0,0,0,1220,0,1961,161500.0
3.0,1.0,1310,1.5,0,0,1310,0,1962,311000.0
6.0,1.75,2490,1.5,0,0,2490,0,1966,470000.0
3.0,3.25,2220,1.5,0,0,1770,450,1929,569000.0
4.0,2.5,2240,2.0,0,0,2240,0,1989,689000.0
3.0,1.75,1890,1.0,0,0,1230,660,1979,271900.0
4.0,2.5,1850,2.0,0,0,1850,0,1991,278000.0
2.0,2.5,2210,2.0,0,0,1440,770,1931,820000.0
3.0,1.75,1410,1.0,0,0,1410,0,1967,399500.0
3.0,2.75,1890,2.0,0,0,1890,0,1979,462000.0
3.0,1.0,1830,1.0,0,0,1550,280,1977,347500.0
2.0,0.75,1440,1.0,0,0,1200,240,1914,562100.0
2.0,1.0,950,1.0,0,0,950,0,1958,230000.0
4.0,2.5,2370,2.0,0,0,2370,0,1966,687000.0
4.0,2.5,3070,2.0,0,0,3070,0,2000,725786.0
3.0,1.0,1300,1.0,0,0,1300,0,1969,315500.0
4.0,2.0,1300,1.0,0,0,1300,0,1950,312000.0
3.0,3.25,1210,2.0,0,0,1000,210,2002,343000.0
1.0,1.0,710,1.5,0,0,710,0,2015,385195.0
4.0,2.25,2240,1.0,0,0,1730,510,1981,415000.0
3.0,1.75,3600,2.0,0,0,2400,1200,1948,461000.0
4.0,2.5,1960,2.0,0,0,1960,0,2002,369990.0
4.0,2.5,1820,2.0,0,0,1820,0,1999,349950.0
3.0,2.25,1960,1.0,0,0,1400,560,1966,285750.0
4.0,2.25,1750,1.0,0,0,1320,430,1972,542500.0
5.0,3.5,3700,2.0,0,0,2890,810,2011,830000.0
4.0,2.5,2910,2.0,0,0,2350,560,1976,705000.0
2.0,1.0,1270,1.0,0,0,1090,180,1949,615000.0
2.0,1.0,720,1.0,0,0,720,0,1940,184500.0
2.0,1.0,1040,1.0,0,0,1040,0,1901,412000.0
3.0,1.5,2210,1.5,0,0,2210,0,1934,250000.0
5.0,2.0,2060,2.0,0,0,2060,0,1903,580000.0
2.0,1.0,780,1.0,0,0,780,0,1923,220000.0
4.0,2.75,2240,1.0,0,0,1460,780,1976,675000.0
2.0,1.0,800,1.0,0,0,800,0,1918,373500.0
2.0,1.5,2440,2.0,0,0,1590,850,1910,662700.0
5.0,1.0,1460,2.0,0,0,1460,0,1941,239950.0
3.0,1.0,1150,1.0,0,0,1150,0,1957,383000.0
3.0,2.75,2650,1.0,0,0,1470,1180,1975,485000.0
4.0,2.75,2600,1.0,0,0,1580,1020,1976,610000.0
6.0,1.75,1820,1.0,0,0,1130,690,1954,545000.0
2.0,2.5,2560,2.0,0,0,1690,870,1901,780000.0
3.0,2.5,1714,2.0,0,0,1714,0,2005,305000.0
3.0,1.0,1330,1.0,0,0,900,430,1984,405000.0
5.0,3.5,7350,2.0,0,4,4750,2600,2001,1110000.0
3.0,1.75,2050,2.0,0,0,2050,0,1959,273000.0
3.0,1.0,1810,2.0,0,0,1810,0,1970,326500.0
3.0,1.75,1380,1.0,0,0,880,500,1981,365000.0
3.0,2.75,3070,2.0,0,0,2440,630,1987,1000750.0
2.0,1.0,800,1.0,0,0,800,0,1940,422500.0
4.0,2.75,2140,2.0,0,0,2140,0,1993,354450.0
3.0,1.0,1330,1.0,0,0,1330,0,1971,320000.0
3.0,1.0,1030,1.0,0,0,1030,0,1961,223000.0
3.0,2.5,1740,2.0,0,0,1740,0,2008,410000.0
3.0,1.0,1200,1.5,0,0,1200,0,1923,438000.0
3.0,3.0,1490,2.0,0,0,960,530,1993,390000.0
4.0,2.5,1890,2.0,0,0,1890,0,2004,298500.0
5.0,2.25,3060,2.0,0,0,3060,0,1989,749999.0
6.0,2.5,3250,1.0,0,1,1800,1450,1966,779000.0
3.0,2.75,2730,2.0,0,2,1530,1200,1978,570000.0
3.0,1.0,810,1.0,0,0,810,0,1918,385000.0
4.0,2.0,2240,1.0,0,0,1120,1120,1961,649000.0
3.0,1.0,1740,1.0,0,0,1270,470,1947,283000.0
4.0,2.25,2380,1.0,0,0,1540,840,1961,699900.0
4.0,1.0,1540,1.0,0,0,770,770,1971,278500.0
4.0,1.75,2340,1.0,0,0,1610,730,1975,700000.0
4.0,2.75,2710,2.0,0,0,2710,0,1995,535000.0
3.0,1.75,1310,1.0,0,0,870,440,1954,234500.0
3.0,1.75,1390,1.0,0,0,1390,0,1973,374150.0
4.0,2.5,2201,2.0,0,0,2201,0,2006,397000.0
3.0,2.25,1960,1.0,0,0,1960,0,1988,613000.0
3.0,2.5,2850,1.0,0,0,1730,1120,1954,1150000.0
4.0,1.75,1880,1.0,0,0,940,940,1924,595000.0
5.0,2.75,2440,2.0,0,0,2440,0,2003,340000.0
4.0,2.5,2560,2.0,0,0,2560,0,2005,388000.0
3.0,1.75,1410,1.0,0,0,1410,0,1950,404000.0
3.0,2.0,2870,1.5,0,1,1790,1080,1946,810000.0
4.0,2.5,2620,2.0,0,0,2620,0,1987,405000.0
5.0,3.0,2970,2.0,0,0,2970,0,2000,726000.0
3.0,2.5,1780,1.0,0,0,1400,380,1986,266000.0
5.0,2.25,3700,1.0,0,1,1850,1850,1970,722500.0
4.0,2.5,1252,1.0,0,0,992,260,1996,352000.0
4.0,1.5,1240,1.0,0,0,1110,130,1961,265000.0
3.0,2.5,2160,2.0,0,0,2160,0,2014,856000.0
3.0,2.5,2040,2.0,0,0,2040,0,2006,346950.0
5.0,3.5,3130,2.0,0,0,2570,560,2014,866059.0
3.0,2.5,2350,2.0,0,0,2350,0,2004,410000.0
3.0,1.75,1570,2.0,0,0,1570,0,1982,370000.0
3.0,1.0,1530,1.5,0,0,1530,0,1919,230000.0
2.0,2.0,1520,1.0,0,0,1520,0,1999,400000.0
3.0,1.0,1350,1.0,0,0,820,530,1959,172000.0
3.0,1.75,1950,1.0,0,0,1250,700,1962,615000.0
4.0,3.5,3950,2.0,0,0,3950,0,1998,860000.0
3.0,1.75,2040,1.0,0,0,1120,920,1958,555000.0
3.0,2.5,1990,1.5,0,0,1390,600,1926,579000.0
3.0,1.75,1300,1.0,0,0,1300,0,1968,385000.0
4.0,2.25,2030,2.0,0,0,2030,0,1977,420000.0
3.0,1.75,2340,1.5,0,0,1620,720,1914,645000.0
3.0,2.5,2160,2.0,0,0,2160,0,1996,549950.0
3.0,2.75,2770,1.0,0,1,1640,1130,1962,678000.0
4.0,2.0,2030,2.0,0,0,2030,0,1950,199000.0
3.0,1.0,1440,1.0,0,0,1440,0,1957,604000.0
5.0,1.75,1730,1.0,0,0,1010,720,1963,268000.0
5.0,3.5,4510,2.0,0,0,2820,1690,2003,960000.0
3.0,2.5,2100,1.0,0,0,1450,650,1980,509250.0
3.0,2.5,1800,2.0,0,0,1800,0,1987,416000.0
3.0,1.0,1090,1.0,0,0,1090,0,1967,190000.0
3.0,1.5,1010,1.0,0,0,1010,0,1973,212000.0
3.0,2.5,2040,2.0,0,0,2040,0,1985,325900.0
3.0,3.5,2270,2.0,0,0,1880,390,1996,560000.0
3.0,2.5,1730,2.0,0,0,1730,0,1987,275000.0
4.0,2.5,2480,2.0,0,2,2480,0,1994,665000.0
4.0,3.5,3480,2.0,0,0,2580,900,1926,1505000.0
4.0,2.0,1720,1.0,0,0,970,750,1930,375000.0
3.0,1.75,1570,1.0,0,0,1040,530,1979,359950.0
4.0,2.75,3527,2.0,0,0,3527,0,2005,340000.0
2.0,1.0,840,1.0,0,0,840,0,1948,401000.0
2.0,1.75,1950,1.0,0,3,1160,790,1952,669000.0
4.0,2.5,1980,2.0,0,0,1980,0,2004,638500.0
2.0,1.5,1620,2.0,0,0,1170,450,1924,545000.0
4.0,1.0,1980,1.0,0,0,1260,720,1973,524000.0
5.0,3.75,3530,2.0,0,0,3530,0,2013,1610000.0
2.0,1.0,1260,1.0,0,0,1100,160,1947,280000.0
4.0,2.5,2120,1.0,0,0,1500,620,1979,828000.0
3.0,1.75,1360,1.0,0,0,1360,0,1984,223000.0
4.0,3.5,3100,2.0,0,2,2250,850,1981,1289000.0
2.0,2.0,2370,1.0,0,0,2370,0,1970,750000.0
2.0,1.0,1460,1.0,0,0,1210,250,1947,430000.0
4.0,1.75,1980,1.0,0,0,990,990,1948,711000.0
4.0,2.5,1930,2.0,0,0,1930,0,1994,310000.0
5.0,1.75,3700,1.0,0,0,1850,1850,1957,415000.0
4.0,2.5,1970,2.0,0,0,1970,0,1987,274900.0
3.0,3.0,2470,2.0,0,0,2470,0,1980,525000.0
3.0,1.0,1180,1.0,0,0,1180,0,1952,179500.0
3.0,1.0,1280,1.5,0,0,1280,0,1910,478000.0
3.0,1.75,1380,1.0,0,0,990,390,1981,195000.0
4.0,3.0,2740,1.0,0,0,1670,1070,1980,385000.0
3.0,2.75,2020,1.0,0,0,1260,760,1969,401000.0
4.0,2.5,2835,2.0,0,0,2835,0,2002,522000.0
4.0,1.75,1520,1.0,0,0,1520,0,1968,330000.0
3.0,2.5,2190,2.0,0,0,2190,0,1999,503000.0
5.0,1.75,1680,1.0,0,0,1680,0,1979,175000.0
4.0,3.5,3915,2.0,0,0,3915,0,2014,963990.0
5.0,2.0,1720,1.0,0,0,1720,0,1951,845000.0
2.0,1.0,670,1.0,0,0,670,0,1905,157500.0
2.0,3.0,1790,2.0,0,0,1400,390,2001,450000.0
4.0,1.75,2440,1.0,0,4,1420,1020,1950,925000.0
2.0,1.0,920,1.0,0,0,920,0,1938,600000.0
4.0,1.0,1680,1.5,0,0,1680,0,1911,709000.0
5.0,3.75,3290,2.0,0,0,2190,1100,1938,1385000.0
3.0,2.5,2120,1.0,0,0,1220,900,1984,248000.0
3.0,1.0,910,1.0,0,0,910,0,1912,245000.0
2.0,1.0,1000,1.0,0,0,1000,0,1942,332000.0
3.0,2.5,2340,2.0,0,0,2340,0,2002,459950.0
3.0,2.0,1180,2.0,0,2,1180,0,1994,425000.0
3.0,2.25,2080,1.0,0,0,1590,490,1979,460000.0
6.0,2.5,3760,1.0,0,0,2360,1400,1967,838300.0
3.0,2.5,1480,2.0,0,0,1480,0,1995,256000.0
3.0,2.75,3060,2.0,0,0,3060,0,1984,864000.0
4.0,3.5,3070,2.0,0,0,2030,1040,1922,900000.0
3.0,1.0,1170,1.0,0,0,1170,0,1958,145600.0
5.0,3.0,2900,1.0,0,0,1830,1070,1977,865000.0
3.0,2.25,2210,2.0,0,0,2210,0,1969,250250.0
4.0,2.0,1440,1.0,0,0,1440,0,1943,162000.0
4.0,1.75,1980,1.0,0,0,1430,550,1973,450000.0
4.0,2.75,2060,1.0,0,0,1460,600,1978,675500.0
3.0,2.25,2420,1.5,0,0,1640,780,1947,697000.0
3.0,3.25,3440,2.0,0,0,2560,880,2005,1324050.0
3.0,1.75,1600,1.0,0,0,1600,0,1984,490000.0
3.0,2.25,2210,1.0,0,0,1460,750,1951,590000.0
4.0,1.75,2250,1.0,0,0,1450,800,1957,280000.0
2.0,1.0,1680,1.0,0,0,1140,540,1941,515000.0
3.0,1.0,1140,1.0,0,0,1010,130,1909,576000.0
3.0,1.75,1430,2.0,0,0,1430,0,1981,375000.0
3.0,1.0,1440,1.0,0,0,1000,440,1980,478000.0
3.0,1.0,1670,1.0,0,0,1030,640,1977,282000.0
4.0,4.5,3080,2.0,0,3,1940,1140,1976,1400000.0
5.0,3.25,4300,2.0,0,0,3220,1080,1972,593500.0
4.0,3.5,3010,2.0,0,0,3010,0,2004,724950.0
3.0,1.75,1560,1.0,0,0,1560,0,1966,306000.0
4.0,1.75,1920,1.0,0,0,1500,420,1975,341000.0
3.0,2.5,1400,1.0,0,0,1400,0,1930,399950.0
5.0,2.0,2280,2.0,0,0,2280,0,1992,534000.0
6.0,2.5,3880,2.0,0,0,3880,0,2003,635000.0
2.0,1.0,1350,1.0,0,0,950,400,1927,350000.0
3.0,1.5,1480,1.5,0,0,1480,0,1928,856000.0
4.0,3.0,1670,3.0,0,0,1427,243,2000,582000.0
4.0,2.5,3400,2.0,0,0,3400,0,2004,799000.0
3.0,2.5,2070,2.0,0,0,2070,0,1999,423700.0
4.0,3.5,4870,2.0,0,0,4870,0,1995,1835000.0
3.0,2.0,1760,1.0,0,0,1160,600,1988,322000.0
4.0,3.25,4030,2.0,0,0,4030,0,2002,929000.0
2.0,1.0,1130,1.0,0,0,880,250,1939,443000.0
3.0,1.75,1510,1.0,0,0,1510,0,1968,441500.0
4.0,3.5,3110,2.0,0,2,3110,0,1979,875000.0
3.0,3.25,5020,2.0,1,4,3420,1600,1941,3600000.0
2.0,1.0,740,1.0,0,0,740,0,1947,450000.0
3.0,2.25,1630,1.0,0,0,1100,530,1974,425000.0
4.0,1.75,2780,2.0,0,0,2780,0,1978,660000.0
3.0,1.75,1990,1.0,0,0,1100,890,1939,763101.0
4.0,2.75,2250,2.0,0,0,2250,0,1992,499000.0
3.0,1.75,1720,1.0,0,0,1350,370,1974,521000.0
2.0,1.0,900,1.0,0,2,900,0,1925,302000.0
4.0,2.25,2360,2.0,0,0,2360,0,1998,293000.0
3.0,2.25,1530,2.0,0,0,1530,0,2011,335000.0
2.0,1.0,1450,2.0,0,0,1450,0,1919,499000.0
3.0,1.75,2040,1.5,0,0,1780,260,1924,600000.0
4.0,1.75,2620,1.5,0,0,2620,0,1962,720000.0
2.0,2.0,1180,2.0,0,0,1180,0,2005,195000.0
3.0,1.0,1110,1.0,0,0,1110,0,1952,249000.0
3.0,2.25,1840,2.0,0,0,1840,0,1989,334000.0
4.0,1.75,2720,1.0,0,0,1510,1210,1952,599950.0
2.0,1.75,1090,1.0,0,0,1090,0,1982,149900.0
4.0,1.75,1730,1.0,0,0,1250,480,1945,700000.0
4.0,1.5,1170,1.0,0,0,1170,0,1960,525000.0
4.0,3.75,4740,2.0,0,0,4740,0,1991,1049000.0
3.0,2.5,1960,1.0,0,0,1290,670,1977,402000.0
3.0,2.0,1430,1.0,0,0,980,450,1947,450000.0
3.0,2.25,2510,2.0,0,0,2510,0,1981,520000.0
3.0,1.75,1420,1.0,0,0,820,600,1980,205000.0
3.0,2.25,2680,1.0,0,0,2680,0,2004,635000.0
3.0,1.0,1220,1.0,0,0,1220,0,1958,210500.0
2.0,1.0,1070,1.0,0,0,1070,0,1940,406650.0
3.0,1.75,1580,1.0,0,0,1580,0,1968,350000.0
4.0,1.75,1820,1.0,0,0,930,890,1942,425000.0
3.0,3.5,3590,2.0,0,0,3590,0,1999,798000.0
3.0,1.0,1960,2.0,0,0,1960,0,1908,180000.0
5.0,3.25,3160,2.0,0,0,3160,0,1972,1250000.0
4.0,2.0,2030,2.0,0,0,1630,400,1925,435000.0
3.0,1.5,1240,1.0,0,0,1240,0,1962,355000.0
5.0,3.25,5370,2.0,0,0,3850,1520,1918,3000000.0
5.0,2.5,2670,2.0,0,0,2670,0,1958,685000.0
3.0,1.0,1640,1.0,0,0,1640,0,1960,311000.0
4.0,2.25,2130,1.0,0,0,2130,0,1966,305000.0
3.0,2.5,2550,1.5,0,0,1850,700,1924,675000.0
4.0,2.75,3630,1.0,0,2,1850,1780,1968,769000.0
3.0,1.5,1690,1.5,0,0,1690,0,1954,430000.0
6.0,2.0,2390,1.5,0,0,2390,0,1925,516250.0
3.0,3.5,2350,1.0,0,2,1340,1010,1940,760000.0
3.0,3.5,1420,2.0,0,0,1180,240,2003,579950.0
3.0,2.25,1570,1.0,0,0,1170,400,1980,476000.0
3.0,1.75,1600,1.0,0,0,1600,0,1967,510000.0
2.0,1.0,720,1.0,0,0,720,0,1955,205000.0
3.0,1.0,1470,1.0,0,0,1470,0,1969,240000.0
5.0,3.5,2790,2.0,0,2,1970,820,1991,738000.0
3.0,1.75,1720,1.0,0,0,860,860,1940,420000.0
3.0,1.75,1300,1.0,0,0,1300,0,1969,455000.0
4.0,1.0,2520,1.5,0,0,1820,700,1912,765000.0
4.0,1.5,1780,1.5,0,0,1780,0,1962,372000.0
3.0,1.0,1200,1.0,0,0,1200,0,1948,160000.0
4.0,2.5,2990,2.0,0,0,2990,0,2003,772000.0
5.0,1.75,1910,2.0,0,0,1910,0,1906,1125000.0
3.0,1.0,1370,1.5,0,0,1370,0,1924,479000.0
3.0,2.5,1910,2.0,0,0,1910,0,1999,570000.0
4.0,1.0,1170,1.5,0,0,1170,0,1959,350000.0
3.0,2.5,1250,3.0,0,0,1250,0,2004,353000.0
5.0,2.5,3340,2.0,0,0,3340,0,2002,699000.0
3.0,2.0,1380,2.0,0,0,1380,0,1955,265000.0
1.0,1.0,780,1.5,0,0,780,0,1989,167000.0
4.0,2.25,2080,1.0,0,0,1390,690,1964,500000.0
3.0,1.0,1410,2.0,0,0,1410,0,1901,700000.0
1.0,1.0,520,1.0,0,0,520,0,1918,295000.0
4.0,3.5,3500,2.0,0,2,2590,910,2004,1010000.0
2.0,1.0,840,1.0,0,0,840,0,1969,209000.0
3.0,1.75,2240,1.0,0,0,1440,800,1968,276000.0
4.0,2.5,2100,2.0,0,0,2100,0,2002,380000.0
3.0,1.5,1750,1.0,0,0,1150,600,1954,315000.0
4.0,2.5,3130,2.0,0,0,3130,0,1996,685530.0
3.0,2.0,1470,1.0,0,0,1470,0,1968,254600.0
3.0,2.0,1440,1.0,0,0,720,720,1942,230000.0
3.0,3.0,1430,3.0,0,0,1430,0,2003,335000.0
4.0,2.5,2170,1.0,0,0,1460,710,1980,550000.0
3.0,1.0,1150,1.5,0,0,1150,0,1956,123300.0
4.0,2.75,2170,1.5,0,0,2170,0,1966,275436.0
4.0,3.5,2630,1.5,0,3,1640,990,1984,325000.0
4.0,2.5,2490,2.0,0,0,2490,0,1997,635000.0
3.0,1.75,1710,1.0,0,0,1110,600,1944,513000.0
4.0,2.5,2130,1.0,0,0,1490,640,1980,580000.0
3.0,1.0,940,1.0,0,0,940,0,1954,225000.0
3.0,1.0,1400,1.0,0,0,1060,340,1961,265000.0
4.0,1.75,1630,1.0,0,0,930,700,1978,313000.0
2.0,1.0,1370,1.0,0,0,1370,0,1948,296000.0
4.0,2.75,2380,1.0,0,0,1680,700,1957,655500.0
5.0,1.75,2140,1.0,0,0,2140,0,1951,250750.0
4.0,2.5,1970,2.0,0,0,1970,0,2004,438000.0
3.0,2.75,2550,2.0,0,0,1980,570,1967,590000.0
3.0,1.0,1080,1.0,0,0,1080,0,1947,329500.0
3.0,2.25,3070,2.0,0,0,2110,960,1987,1195000.0
2.0,1.0,1470,1.0,0,0,900,570,1944,415000.0
4.0,2.5,3620,2.0,0,0,3620,0,1984,900000.0
3.0,1.5,1050,1.0,0,0,1050,0,1975,378000.0
2.0,1.0,1050,1.0,0,3,1050,0,1905,474000.0
3.0,1.0,1320,2.0,0,0,1320,0,1900,464000.0
3.0,1.0,1210,1.0,0,0,1210,0,1956,310000.0
3.0,1.5,1860,2.0,0,1,1860,0,1952,580000.0
3.0,2.75,2830,1.0,1,3,1830,1000,1962,999000.0
2.0,1.0,810,1.0,0,0,810,0,1942,510000.0
3.0,1.5,1630,1.0,0,1,1160,470,1940,650000.0
3.0,1.0,880,1.0,0,0,880,0,1978,196000.0
4.0,1.75,1660,1.0,0,0,1010,650,1952,220000.0
3.0,2.25,3440,2.0,0,2,3440,0,1985,855000.0
3.0,1.75,2110,1.0,0,0,1440,670,1978,483000.0
3.0,1.0,1060,1.0,0,0,1060,0,1952,400000.0
3.0,2.5,1900,2.0,0,0,1900,0,1993,435000.0
1.0,1.0,820,1.0,0,0,760,60,2007,219500.0
4.0,3.5,4860,2.0,0,0,4860,0,1996,2950000.0
3.0,2.5,2050,3.0,0,0,2050,0,2008,427000.0
2.0,1.5,1090,1.5,0,0,1090,0,1900,430000.0
2.0,1.5,1090,1.5,0,0,1090,0,1900,685000.0
2.0,1.5,1920,1.0,0,0,1060,860,1937,495000.0
3.0,2.5,1870,2.0,0,0,1870,0,1990,299950.0
4.0,1.75,2690,1.5,0,0,2690,0,1940,390000.0
3.0,1.75,2160,1.5,0,0,1260,900,1928,385000.0
4.0,2.5,3000,2.0,0,0,3000,0,1995,740000.0
4.0,3.0,2290,2.0,0,1,1610,680,1924,991700.0
3.0,2.75,2250,2.5,0,0,1830,420,1909,765000.0
4.0,2.25,2130,2.0,0,2,2130,0,1961,802000.0
4.0,2.75,2500,1.0,0,0,1700,800,1969,950000.0
4.0,2.5,2300,2.0,0,0,2300,0,1988,392000.0
3.0,2.5,3360,1.0,0,0,3360,0,1989,590000.0
4.0,2.5,1920,2.0,0,0,1920,0,1989,425000.0
5.0,1.75,2440,1.5,0,4,1740,700,1944,765000.0
3.0,2.25,1440,2.0,0,0,1440,0,1983,313500.0
3.0,1.0,1780,2.0,0,0,1780,0,1947,320000.0
4.0,1.75,1490,1.0,0,0,1350,140,1960,604000.0
3.0,2.0,1400,2.0,0,0,1060,340,2004,570000.0
4.0,2.5,2150,2.0,0,0,2150,0,1982,639000.0
4.0,2.0,1910,1.0,0,0,1910,0,1963,335000.0
4.0,1.75,2660,2.0,0,0,2080,580,1917,896000.0
3.0,1.75,1650,1.0,0,0,1650,0,1957,259500.0
3.0,2.0,1980,1.0,0,0,1380,600,1958,637000.0
4.0,2.75,2690,1.0,0,0,1370,1320,1980,307450.0
3.0,1.75,1380,1.0,0,0,860,520,1925,535000.0
4.0,2.25,2500,1.5,0,0,1520,980,1940,669500.0
3.0,1.75,1590,1.0,0,0,1590,0,1952,259000.0
4.0,1.5,1100,1.0,0,0,1100,0,1919,441000.0
4.0,2.5,1470,2.0,0,0,980,490,2003,228800.0
2.0,2.0,1680,1.0,0,0,1680,0,2006,530000.0
2.0,2.0,1450,1.0,0,0,750,700,1924,524000.0
4.0,2.25,2020,1.5,0,0,1200,820,1925,430000.0
4.0,3.25,2470,1.5,0,0,1890,580,1906,1325000.0
3.0,1.0,1230,1.0,0,0,1230,0,1969,210000.0
4.0,2.5,1850,1.0,0,0,1230,620,1930,449000.0
2.0,2.5,2540,2.0,0,0,2540,0,2004,945000.0
3.0,1.0,970,1.0,0,0,970,0,1957,200450.0
3.0,1.5,1070,1.0,0,0,1070,0,1985,219950.0
4.0,3.0,2620,1.0,0,0,1870,750,1956,659500.0
4.0,2.75,2110,1.5,0,0,2110,0,1966,746000.0
3.0,1.75,2110,1.0,0,0,1280,830,1982,540000.0
5.0,2.0,1910,1.0,0,0,1020,890,1968,485000.0
2.0,1.0,670,1.0,0,0,670,0,1942,202000.0
4.0,5.5,6930,1.0,0,0,4310,2620,1950,2525000.0
3.0,2.75,2010,1.0,0,0,1360,650,1979,502000.0
2.0,2.75,1770,1.0,0,0,1210,560,2003,279000.0
3.0,1.0,1340,1.0,0,0,1040,300,1921,409500.0
3.0,2.0,1660,1.0,0,0,1260,400,1983,453000.0
4.0,1.0,1820,1.5,0,0,1820,0,1947,367000.0
3.0,2.5,2510,2.0,0,0,2510,0,1992,550000.0
3.0,1.5,1560,1.0,0,0,1560,0,1962,273500.0
4.0,3.0,2280,1.0,0,0,1340,940,1978,505000.0
3.0,2.5,2650,2.0,0,0,2650,0,1994,770000.0
4.0,2.25,2470,2.0,0,0,2470,0,1984,565000.0
3.0,0.75,1270,1.0,0,0,1270,0,1971,316000.0
4.0,1.0,1520,1.5,0,0,1520,0,1960,160000.0
3.0,1.0,1310,1.0,0,0,1310,0,1956,170000.0
3.0,1.0,1310,1.0,0,0,1310,0,1956,235000.0
4.0,3.5,3930,2.0,0,0,3930,0,1999,1799000.0
3.0,1.0,990,1.0,0,0,990,0,1967,310000.0
4.0,1.75,2080,1.0,0,0,1040,1040,1955,285000.0
2.0,1.0,960,1.0,0,0,960,0,1942,280000.0
4.0,4.25,4070,2.0,0,3,4070,0,2004,2298000.0
4.0,2.5,2750,2.0,0,0,2750,0,1989,763776.0
5.0,2.75,3230,1.0,0,2,1880,1350,1965,530000.0
1.0,1.0,890,1.5,0,0,890,0,1996,362000.0
2.0,1.0,990,1.0,0,0,990,0,1931,430000.0
3.0,1.0,1290,1.5,0,0,1290,0,1919,456500.0
4.0,2.5,2170,2.0,0,0,2170,0,1989,445000.0
3.0,1.0,1330,1.0,0,0,960,370,1963,386900.0
3.0,1.0,1340,1.0,0,0,1340,0,1955,479000.0
3.0,2.5,2200,2.0,0,0,2200,0,2000,525000.0
4.0,1.75,2520,1.0,0,0,1260,1260,1979,272000.0
4.0,1.0,1180,1.5,0,0,1180,0,1950,517000.0
3.0,1.75,2660,1.0,0,0,1330,1330,1951,615000.0
3.0,1.75,1250,1.0,0,0,1250,0,1965,439000.0
3.0,2.5,2270,1.0,0,0,2270,0,1988,716000.0
2.0,1.0,1080,1.0,0,2,1080,0,1942,308000.0
3.0,2.25,1620,2.0,0,0,1620,0,1926,800000.0
3.0,2.0,940,1.0,0,0,880,60,1941,575000.0
3.0,1.5,1620,1.0,0,0,1620,0,1967,219950.0
4.0,2.5,2350,2.0,0,0,2350,0,1987,770000.0
3.0,1.75,2090,1.0,0,0,2090,0,1967,424950.0
3.0,2.25,1760,2.0,0,0,1760,0,1984,387000.0
4.0,1.75,2050,1.0,0,3,1450,600,1974,790000.0
2.0,1.0,600,1.0,0,0,600,0,1933,156000.0
2.0,1.0,2540,1.0,0,0,1320,1220,1942,580000.0
4.0,2.25,2090,2.0,0,0,2090,0,1970,490000.0
5.0,3.25,2700,2.0,0,2,2070,630,1926,950000.0
2.0,2.5,1410,2.0,0,0,1090,320,2008,400000.0
2.0,2.5,1170,2.0,0,0,1170,0,2008,325000.0
4.0,2.5,2540,2.0,0,0,2540,0,2002,365000.0
3.0,1.75,2190,1.5,0,0,2190,0,1920,255000.0
5.0,3.5,3890,2.0,0,1,2870,1020,1984,985000.0
4.0,2.5,2030,1.0,0,0,1100,930,1967,595000.0
3.0,1.0,1350,1.0,0,0,1350,0,1944,427500.0
3.0,1.5,1940,1.5,0,0,1310,630,1915,728000.0
2.0,1.0,1260,1.0,0,0,1000,260,1940,549950.0
3.0,2.0,2800,1.0,0,0,1400,1400,1954,650000.0
5.0,3.25,3080,1.0,0,2,2230,850,1968,1125000.0
3.0,1.0,840,1.0,0,0,840,0,1969,203000.0
2.0,1.0,860,1.0,0,0,860,0,1903,311000.0
6.0,2.0,2400,1.0,0,0,1200,1200,1932,387500.0
4.0,2.0,1640,1.0,0,0,1640,0,1963,370000.0
2.0,1.0,1060,1.0,0,0,1060,0,1951,228000.0
2.0,1.75,2080,1.0,0,0,1080,1000,1923,740000.0
4.0,2.0,2090,1.0,0,0,1070,1020,1974,200000.0
3.0,1.0,1240,1.0,0,0,1240,0,1927,660000.0
4.0,2.0,2030,2.0,0,0,2030,0,1944,275000.0
2.0,1.0,1120,1.0,0,0,950,170,1938,708000.0
3.0,2.5,1270,2.0,0,0,1270,0,1993,280000.0
4.0,2.5,2260,2.0,0,0,2260,0,2002,325000.0
3.0,2.5,1780,2.0,0,0,1780,0,1995,495000.0
2.0,2.0,1780,1.5,0,0,980,800,1922,691000.0
4.0,2.5,4080,2.0,0,2,4080,0,1983,2288000.0
3.0,2.5,2120,1.0,0,0,1360,760,1979,329500.0
3.0,2.5,2060,2.0,0,0,2060,0,1989,348000.0
2.0,1.0,1670,1.0,0,0,1670,0,1947,425000.0
3.0,1.0,1080,1.0,0,0,1080,0,1942,210000.0
2.0,1.0,1210,1.0,0,0,710,500,1951,285000.0
3.0,1.0,990,1.0,0,0,990,0,1966,222000.0
4.0,2.5,1720,1.0,0,0,1120,600,1961,200000.0
3.0,2.0,1530,1.0,0,0,1530,0,1995,247500.0
4.0,5.5,6550,1.0,0,0,5400,1150,2006,1500000.0
3.0,1.75,1100,1.0,0,0,1100,0,1942,190000.0
4.0,2.5,3020,1.5,0,0,2020,1000,1921,975000.0
4.0,3.0,3180,2.0,0,0,2070,1110,1925,1130000.0
4.0,1.75,1830,1.0,0,0,1130,700,1958,283200.0
3.0,2.5,2540,1.0,0,0,1880,660,1937,650000.0
3.0,2.0,1770,1.0,0,0,960,810,1954,449500.0
3.0,1.75,1470,1.0,0,0,1470,0,1987,400000.0
1.0,1.0,570,1.0,0,0,570,0,1942,89950.0
3.0,1.0,960,1.0,0,0,960,0,1950,158800.0
4.0,3.0,2940,2.0,0,1,2220,720,2011,870000.0
3.0,1.5,1000,1.0,0,0,1000,0,1989,196000.0
3.0,1.75,2450,1.0,0,0,1340,1110,1940,850000.0
4.0,2.5,3310,2.0,0,0,3310,0,2005,775000.0
3.0,2.5,1670,2.0,0,0,1670,0,2001,483500.0
3.0,1.5,1620,2.0,0,0,1620,0,1990,387000.0
3.0,3.0,2990,2.0,0,0,2990,0,1951,900000.0
3.0,1.5,1240,1.0,0,2,1240,0,1964,336000.0
2.0,1.0,670,1.0,0,0,670,0,1949,415000.0
,,1470,3.0,0,2,1470,0,2006,380000.0
3.0,1.5,1320,1.0,0,0,1320,0,1909,350000.0
4.0,5.25,6110,2.0,0,0,6110,0,2005,1320000.0
3.0,1.75,2440,1.0,0,3,1320,1120,1945,765000.0
4.0,2.5,2900,2.0,0,0,2900,0,2013,527000.0
4.0,2.75,2310,1.5,0,0,1480,830,1908,524000.0
2.0,1.0,1110,1.0,0,0,890,220,1937,448000.0
4.0,3.25,4100,2.0,0,0,2500,1600,1981,775000.0
3.0,1.0,930,1.5,0,0,930,0,1910,176500.0
4.0,2.25,2420,1.0,0,2,1620,800,1952,750000.0
4.0,2.25,2870,1.0,0,0,1730,1140,1951,1265000.0
3.0,1.0,1480,1.0,0,0,1480,0,1958,250000.0
3.0,2.75,1960,1.5,0,2,1960,0,1900,759000.0
3.0,2.0,1470,1.5,0,0,1470,0,1926,640000.0
3.0,3.25,2460,2.0,0,0,2100,360,1910,990000.0
4.0,1.75,1960,1.0,0,0,980,980,1946,395000.0
2.0,1.5,1160,2.0,0,0,890,270,2006,275000.0
3.0,2.5,1910,2.0,0,0,1910,0,1997,390000.0
5.0,2.75,2720,1.5,0,0,1710,1010,1913,752500.0
2.0,1.0,1020,1.5,0,0,1020,0,1906,450000.0
2.0,1.0,900,1.0,0,0,900,0,1909,473000.0
3.0,1.75,1120,1.0,0,0,1120,0,1973,178500.0
3.0,2.5,2340,1.0,0,0,2340,0,1985,485000.0
3.0,1.5,1410,1.0,0,0,780,630,1982,215000.0
4.0,1.75,1920,1.0,0,0,1060,860,1919,589000.0
4.0,1.75,1370,1.0,0,0,1370,0,1918,325000.0
3.0,2.5,1590,2.5,0,0,1590,0,2004,580000.0
4.0,1.75,1850,1.0,0,0,1850,0,1954,181100.0
3.0,2.0,1430,1.0,0,0,830,600,1908,345000.0
3.0,1.75,1940,1.0,0,0,1460,480,1960,781000.0
4.0,1.0,1270,1.5,0,0,1270,0,1903,402500.0
3.0,1.5,1380,1.0,0,0,1080,300,1948,426000.0
3.0,2.5,1720,2.0,0,0,1720,0,2005,389000.0
6.0,3.0,4050,2.0,0,0,2620,1430,1970,670000.0
4.0,3.25,3660,2.5,0,0,3360,300,1909,1506000.0
3.0,2.25,1870,2.0,0,0,1870,0,1997,288400.0
4.0,2.0,2230,1.5,0,0,1510,720,1908,700000.0
4.0,3.0,2020,1.0,0,0,1220,800,1968,830000.0
2.0,2.75,3690,2.0,1,4,3690,0,1989,1899000.0
2.0,1.0,1450,1.0,0,0,1450,0,1967,350500.0
3.0,1.75,1630,1.0,0,0,1630,0,1956,431000.0
3.0,2.5,1840,1.0,0,1,1340,500,1958,485000.0
3.0,1.5,1620,1.0,0,2,1620,0,1949,780000.0
2.0,1.5,1840,1.0,0,2,1340,500,1957,720000.0
3.0,1.0,1360,1.0,0,0,1360,0,1971,415000.0
4.0,1.0,2080,1.0,0,0,1040,1040,1941,480000.0
4.0,2.25,2550,1.0,0,0,1560,990,1979,452250.0
3.0,2.5,2550,2.0,0,0,2550,0,1985,316000.0
2.0,1.0,1160,1.0,1,4,1160,0,1945,700000.0
4.0,2.0,1760,1.0,0,1,780,980,1925,285000.0
3.0,1.75,1720,1.0,0,0,860,860,1906,575000.0
3.0,2.25,2300,1.0,0,2,1580,720,1960,590000.0
4.0,1.75,2500,1.0,0,2,1600,900,1956,587500.0
4.0,2.25,1750,1.5,0,0,1750,0,1968,364000.0
3.0,2.5,1890,2.0,0,0,1890,0,1986,490000.0
3.0,2.25,1800,1.0,0,0,1360,440,1978,410000.0
3.0,2.5,2160,2.0,0,0,2160,0,1999,520000.0
3.0,1.0,1380,1.0,0,0,1380,0,1947,389000.0
2.0,1.0,1180,1.0,0,0,1180,0,1910,450000.0
3.0,2.5,2550,2.0,0,0,2550,0,2006,325000.0
2.0,1.0,1070,1.0,0,0,1070,0,1924,660000.0
3.0,2.25,2870,2.0,0,0,2250,620,1995,850000.0
3.0,2.5,1940,2.0,0,0,1940,0,1990,285000.0
2.0,1.0,870,1.0,0,0,870,0,1923,395000.0
3.0,2.0,1550,2.0,0,0,1550,0,1996,440000.0
3.0,1.75,1400,1.5,0,0,1400,0,1917,249000.0
3.0,1.75,1210,1.5,0,0,1210,0,1930,635000.0
3.0,2.5,3430,2.0,0,0,3430,0,2001,515000.0
3.0,3.25,3020,2.0,0,0,3020,0,1954,1400000.0
2.0,1.0,950,1.0,0,0,950,0,1955,200000.0
4.0,2.75,3370,1.0,0,3,1970,1400,1970,1135000.0
4.0,1.0,1460,1.0,0,2,780,680,1946,445000.0
3.0,1.5,1740,1.5,0,0,1640,100,1920,555000.0
4.0,2.0,1720,1.0,0,0,860,860,1950,537000.0
3.0,1.75,1480,1.0,0,0,1480,0,1968,315000.0
5.0,2.5,3320,2.0,0,0,3320,0,2000,805000.0
4.0,2.5,3490,1.5,0,0,3490,0,1969,414000.0
2.0,1.5,1160,2.0,0,0,1160,0,2002,375000.0
4.0,1.75,3010,1.0,0,0,1780,1230,1952,401000.0
3.0,1.0,1030,1.0,0,0,1030,0,1967,210000.0
2.0,1.0,980,1.0,0,0,780,200,1939,365000.0
5.0,1.5,1990,1.0,0,0,1990,0,1960,178000.0
2.0,1.0,1790,1.0,0,0,1040,750,1923,710000.0
2.0,1.0,810,1.0,0,0,810,0,1928,255000.0
5.0,2.25,2940,1.0,0,0,1700,1240,1977,528000.0
4.0,4.25,4883,2.0,0,3,3859,1024,2006,537000.0
4.0,1.5,1360,1.0,0,0,1010,350,1955,442000.0
3.0,1.75,1370,1.0,0,0,1370,0,1978,375000.0
4.0,2.5,2120,2.0,0,0,2120,0,2005,637250.0
3.0,1.75,1240,1.0,0,0,1240,0,1942,427500.0
4.0,2.5,2770,2.0,0,0,2770,0,2004,700000.0
3.0,1.75,1660,1.0,0,0,1080,580,1909,680000.0
2.0,2.0,1170,1.0,0,0,1170,0,1941,393820.0
4.0,2.75,2470,1.0,0,0,1350,1120,1940,525000.0
2.0,1.75,1310,1.0,0,0,1110,200,1929,505000.0
3.0,2.0,1670,1.0,0,1,1670,0,1959,555565.0
3.0,1.75,1660,1.0,0,0,1240,420,1942,650000.0
5.0,3.25,3500,2.0,0,0,2760,740,2005,632500.0
3.0,2.5,1440,2.0,0,0,1440,0,2005,269000.0
4.0,2.75,2360,1.0,0,0,1390,970,1978,405000.0
3.0,3.5,3460,2.0,0,0,3460,0,1986,845000.0
3.0,1.0,1750,1.0,0,0,1750,0,1961,234000.0
4.0,1.75,1470,1.5,0,0,1470,0,1946,638000.0
3.0,1.75,1710,1.0,0,0,1060,650,1967,290000.0
1.0,0.75,520,1.0,0,0,520,0,1920,262000.0
4.0,2.5,2350,2.0,0,0,2350,0,2003,270000.0
4.0,2.25,2380,2.0,0,0,2240,140,1948,875000.0
3.0,2.25,1920,2.0,0,0,1920,0,1982,299000.0
3.0,1.0,1580,1.0,0,0,1580,0,1947,551000.0
3.0,2.75,3070,2.0,0,1,2360,710,1950,350000.0
3.0,2.5,2660,2.0,0,2,2660,0,1992,1901000.0
2.0,1.75,1700,1.0,0,0,850,850,1915,511718.0
4.0,3.25,5010,2.0,0,0,3710,1300,1978,965000.0
4.0,2.25,2680,2.0,0,0,2680,0,1999,475000.0
4.0,2.75,2720,1.5,0,2,1840,880,1928,1062000.0
2.0,1.0,940,1.0,0,0,940,0,1926,252000.0
6.0,2.5,3596,1.0,0,0,1798,1798,1964,580000.0
2.0,2.25,1240,2.0,0,0,1000,240,2008,374950.0
5.0,4.0,4660,2.0,0,2,2600,2060,1979,739000.0
4.0,1.75,1710,1.0,0,0,910,800,1975,271000.0
2.0,1.0,930,1.0,0,0,930,0,1986,230000.0
3.0,2.25,1430,1.0,0,0,1070,360,1984,210000.0
3.0,2.75,1650,2.0,0,0,1650,0,1988,350000.0
3.0,2.25,1560,1.0,0,0,1110,450,1968,491500.0
3.0,2.5,1870,1.0,0,0,1250,620,1994,325000.0
3.0,2.0,1320,1.0,0,0,1320,0,1987,190000.0
4.0,2.0,1400,1.5,0,0,1400,0,1945,658600.0
3.0,1.5,1940,1.0,0,0,1300,640,1958,299950.0
5.0,2.0,2000,1.5,0,0,1200,800,1931,464000.0
3.0,1.0,1640,1.5,0,0,1640,0,1942,308000.0
3.0,1.0,1020,1.0,0,0,1020,0,1919,625000.0
3.0,1.75,1630,1.0,0,0,1080,550,1977,240000.0
4.0,2.5,2940,2.0,0,0,2940,0,1995,530000.0
5.0,4.5,2120,2.0,1,4,2120,0,1939,1000000.0
1.0,1.0,790,1.0,0,0,790,0,1918,439000.0
4.0,1.75,2020,1.0,0,0,1010,1010,1948,575000.0
3.0,1.75,1530,1.0,0,0,1530,0,1959,418000.0
4.0,3.75,3250,2.0,0,0,2940,310,1930,1208000.0
4.0,3.75,2930,1.5,0,0,2130,800,1925,1100000.0
3.0,3.75,3150,2.0,0,0,3150,0,2007,1900000.0
3.0,2.5,2180,2.0,0,0,2180,0,1985,580000.0
2.0,1.0,1040,1.0,0,0,840,200,1939,380000.0
3.0,1.0,880,1.0,0,0,880,0,1924,256000.0
3.0,1.0,1400,1.0,0,0,1400,0,1957,349950.0
4.0,2.5,2600,2.0,0,0,2600,0,1962,691500.0
3.0,1.75,1590,1.5,0,0,1190,400,1908,556000.0
3.0,2.25,1610,1.0,0,0,1280,330,1968,218000.0
4.0,2.0,1390,1.5,0,0,1390,0,1908,425000.0
3.0,3.25,3710,2.0,0,0,3710,0,1998,935000.0
4.0,1.75,2360,1.0,0,0,2360,0,1974,732000.0
3.0,1.0,1440,1.0,0,0,1440,0,1952,805500.0
3.0,1.75,1400,1.0,0,2,1100,300,1915,507250.0
4.0,2.5,4600,2.0,0,0,4600,0,1990,800000.0
3.0,2.25,2100,2.0,0,1,2100,0,1979,600000.0
4.0,1.75,2010,1.0,0,0,2010,0,1982,627800.0
2.0,2.25,2550,2.0,0,0,1860,690,1902,660000.0
2.0,2.5,1240,2.0,0,0,1240,0,1986,153503.0
3.0,2.25,2090,1.0,0,0,1460,630,1975,456500.0
5.0,2.5,2770,2.0,0,0,2770,0,2002,1306000.0
3.0,2.5,3560,2.0,0,0,3560,0,1997,843500.0
3.0,1.0,1240,1.0,0,0,1240,0,1925,625000.0
2.0,1.75,1640,1.0,0,0,840,800,1921,527000.0
5.0,3.75,3940,1.5,0,3,3940,0,1951,1965000.0
5.0,2.5,3150,2.0,0,0,3150,0,1969,1003000.0
4.0,3.0,2550,2.0,0,0,1720,830,1908,855000.0
4.0,3.25,3940,2.0,0,3,3440,500,2000,725000.0
1.0,1.0,580,1.0,0,0,580,0,2000,315000.0
3.0,1.75,1330,1.0,0,0,1330,0,1978,180000.0
2.0,1.0,930,1.0,0,3,930,0,1926,700000.0
3.0,1.0,1060,2.0,0,0,1060,0,1962,476500.0
3.0,1.5,1180,1.0,0,0,1180,0,1960,193000.0
4.0,2.5,1850,2.0,0,0,1850,0,1990,295000.0
2.0,1.0,820,1.0,0,0,820,0,1925,363000.0
4.0,2.5,3600,2.0,0,0,3600,0,1990,875000.0
3.0,2.0,1850,1.0,0,0,1150,700,1952,257200.0
3.0,2.0,2240,1.0,0,0,2240,0,1968,555000.0
3.0,2.25,1860,2.0,0,0,1860,0,1963,380000.0
4.0,2.75,2390,2.0,0,0,2390,0,1989,282000.0
4.0,2.5,2040,2.0,0,0,2040,0,1990,545000.0
3.0,1.5,1900,1.5,0,0,1640,260,1926,550000.0
3.0,1.5,1900,1.5,0,0,1640,260,1926,921500.0
3.0,1.5,2200,2.0,0,0,1440,760,1904,885000.0
4.0,2.25,2280,1.5,0,2,1960,320,1940,820000.0
3.0,1.0,1090,1.0,0,0,1090,0,1981,289000.0
1.0,1.0,670,1.0,0,0,670,0,1942,334000.0
3.0,1.0,1050,1.0,0,0,1050,0,1906,206000.0
3.0,2.25,2090,1.0,0,0,1440,650,1958,491950.0
3.0,2.5,2030,2.0,0,0,2030,0,2003,430000.0
3.0,2.0,1250,1.0,0,0,1250,0,1980,208000.0
4.0,2.25,2600,1.0,0,0,1390,1210,1978,245000.0
2.0,1.0,640,1.0,0,0,640,0,1918,426000.0
3.0,2.5,2120,2.0,0,0,2120,0,2006,400000.0
3.0,1.0,1330,1.0,0,0,900,430,1942,553000.0
2.0,1.0,750,1.0,0,0,750,0,1948,296000.0
3.0,2.5,2230,1.0,0,0,2230,0,1977,428000.0
4.0,2.5,1890,1.0,0,0,980,910,1980,325000.0
2.0,1.0,820,1.0,0,0,820,0,1952,294000.0
3.0,1.75,1880,1.0,0,0,1380,500,1977,410000.0
4.0,4.25,2360,2.0,0,0,2360,0,1939,590000.0
3.0,2.25,1850,2.0,0,0,1850,0,1985,445000.0
4.0,2.5,2310,2.0,0,4,2010,300,1928,921000.0
3.0,1.5,2520,1.0,0,0,2520,0,1955,496000.0
2.0,1.0,800,1.0,0,0,800,0,1947,95000.0
4.0,1.75,1580,1.0,0,0,790,790,1945,359000.0
3.0,2.5,2430,1.0,0,0,1570,860,1985,452500.0
4.0,1.75,2350,1.5,0,0,1410,940,1946,555000.0
5.0,3.0,3800,1.5,0,0,3800,0,1984,549900.0
5.0,3.0,3670,1.0,0,0,2060,1610,1952,569000.0
4.0,2.0,1780,1.0,0,0,900,880,1974,318500.0
2.0,1.5,1295,2.0,0,0,1105,190,2007,487028.0
3.0,1.0,1350,1.0,0,0,950,400,1959,240000.0
3.0,2.25,1440,1.0,0,0,1440,0,1965,253000.0
5.0,1.75,1320,1.0,0,0,1120,200,1947,380000.0
2.0,0.75,700,1.0,0,0,700,0,1958,250000.0
2.0,1.75,2510,2.0,0,0,2510,0,1977,368500.0
3.0,1.0,3180,1.0,0,0,1400,1780,1969,340000.0
2.0,1.0,910,1.0,0,0,910,0,1918,400000.0
3.0,2.0,1570,1.5,0,0,1570,0,1927,835000.0
3.0,2.5,2450,2.0,0,0,2450,0,1993,299000.0
6.0,2.25,4910,2.5,0,0,3580,1330,1910,1675000.0
3.0,2.0,1570,1.0,0,0,1570,0,1998,265000.0
4.0,2.5,2680,2.0,0,0,2680,0,1998,437500.0
3.0,1.75,2090,2.0,0,0,1610,480,1947,865000.0
3.0,2.0,2150,1.0,0,0,2150,0,1988,626000.0
2.0,2.0,1140,2.0,0,0,1040,100,2009,247300.0
4.0,3.5,4230,2.0,0,0,4230,0,1997,2075000.0
3.0,1.0,1790,1.5,0,0,1790,0,1937,425000.0
5.0,3.5,3100,1.0,0,4,1660,1440,1970,905000.0
3.0,2.5,2220,3.0,0,2,2220,0,1990,641250.0
4.0,2.5,2370,2.0,0,0,2370,0,1984,675000.0
4.0,2.75,4070,2.0,0,0,4070,0,2002,845000.0
4.0,1.0,1790,1.0,0,0,1260,530,1954,401500.0
3.0,2.5,1610,2.0,0,0,1610,0,1987,395000.0
5.0,2.75,2830,1.0,0,0,1630,1200,1958,1100000.0
3.0,1.0,1010,1.0,0,0,1010,0,1954,145000.0
3.0,1.0,1560,1.5,0,0,1390,170,1930,900000.0
3.0,1.5,1330,1.0,0,0,1330,0,1968,374500.0
4.0,2.25,2330,2.0,0,0,2330,0,1965,850000.0
3.0,1.0,960,1.0,0,0,960,0,1951,490000.0
3.0,2.5,1710,2.0,0,0,1710,0,1993,304000.0
4.0,2.25,2230,1.0,0,0,1300,930,1963,400000.0
3.0,2.0,1700,2.0,0,0,1700,0,1992,454000.0
2.0,2.0,1040,1.0,0,0,850,190,1950,160000.0
3.0,1.75,1070,1.0,0,0,1070,0,1966,542000.0
5.0,2.5,3600,1.0,0,0,2410,1190,1968,403500.0
4.0,2.5,2750,2.0,0,0,2750,0,2003,418000.0
4.0,1.5,1920,2.0,0,1,1920,0,1951,406000.0
3.0,2.25,1770,1.0,0,0,1340,430,1978,242500.0
4.0,2.5,2460,2.0,0,0,2460,0,2003,425000.0
4.0,2.0,1550,1.5,0,0,1550,0,1909,613000.0
3.0,2.0,1460,1.0,0,0,1170,290,1995,189000.0
4.0,2.25,2440,1.5,0,0,2440,0,1947,700000.0
3.0,1.0,1640,1.5,0,0,1440,200,1935,750000.0
2.0,1.0,1290,1.0,0,0,1290,0,1906,494000.0
4.0,3.0,3150,2.0,0,0,3150,0,2000,700000.0
2.0,2.5,2305,1.0,0,0,2305,0,2007,705000.0
2.0,1.75,1060,1.0,0,0,1060,0,1977,356000.0
3.0,1.75,2060,1.0,0,0,1350,710,1984,625000.0
2.0,1.0,900,1.0,0,0,900,0,1940,144975.0
4.0,4.5,3890,2.0,0,3,3060,830,2004,970000.0
3.0,1.75,1910,1.0,0,0,1340,570,1977,415000.0
4.0,3.0,2340,1.0,0,0,1340,1000,1979,485000.0
3.0,3.0,2900,2.0,0,0,2900,0,1997,799950.0
4.0,2.5,3290,2.0,0,0,3290,0,1991,783350.0
1.0,1.0,630,1.0,0,0,630,0,1943,430000.0
5.0,4.75,5410,2.0,0,0,5050,360,1941,2544750.0
4.0,2.5,4270,1.0,0,0,2680,1590,1991,975000.0
3.0,1.5,1700,1.0,0,0,1130,570,1950,950000.0
2.0,1.0,1430,1.5,0,0,1150,280,1944,350000.0
4.0,2.75,2850,2.0,0,0,2850,0,2008,637000.0
3.0,2.0,2160,1.0,0,0,2160,0,1991,895000.0
2.0,2.0,1760,1.0,0,0,880,880,1946,579000.0
4.0,1.75,2700,1.0,0,0,1380,1320,1958,314900.0
2.0,1.0,860,1.0,0,0,860,0,1945,122000.0
2.0,1.0,880,1.0,0,0,880,0,1927,405000.0
2.0,2.5,1360,2.0,0,0,1050,310,1997,553650.0
2.0,2.5,1770,3.0,0,0,1770,0,2007,369900.0
3.0,2.0,2030,1.0,0,0,1220,810,1979,225000.0
2.0,1.0,1180,1.0,0,0,1180,0,1918,160000.0
4.0,2.0,2430,1.0,0,0,1310,1120,1961,449500.0
3.0,1.0,1300,1.0,0,0,1300,0,1953,650000.0
4.0,2.5,2360,2.0,0,0,2360,0,1977,542126.0
3.0,1.5,1200,1.0,0,0,1200,0,1985,309950.0
2.0,1.0,1000,1.0,0,0,1000,0,1913,115000.0
2.0,1.5,1556,1.0,0,0,1556,0,1957,221700.0
3.0,2.5,1890,1.5,0,0,1460,430,1915,726000.0
3.0,1.75,1810,1.0,0,0,1010,800,1926,515000.0
4.0,2.5,2730,2.0,0,0,2730,0,1991,756000.0
4.0,3.75,3070,2.0,0,0,2400,670,1927,1570000.0
4.0,2.25,2080,1.0,0,0,1220,860,1979,442000.0
4.0,2.0,1620,2.0,0,0,1620,0,1975,260000.0
2.0,1.75,1150,1.0,0,0,770,380,1923,390000.0
2.0,1.0,1250,1.0,0,0,850,400,1929,459500.0
3.0,1.5,1430,1.0,0,0,1430,0,1948,330000.0
2.0,1.0,790,1.0,0,0,790,0,1944,189000.0
3.0,1.0,1200,1.5,0,0,1200,0,1954,280000.0
2.0,1.75,2110,1.0,0,0,2110,0,1948,400000.0
4.0,2.0,3160,1.0,0,0,2410,750,1942,368000.0
4.0,1.75,2700,1.5,0,0,2700,0,1968,390000.0
2.0,1.0,820,1.0,0,0,820,0,1945,245000.0
4.0,2.5,1800,1.0,0,0,1200,600,1960,375000.0
5.0,1.5,1750,1.0,0,0,1390,360,1961,465000.0
3.0,2.0,1540,1.0,0,0,1540,0,1997,445000.0
3.0,1.0,1130,1.0,0,0,1130,0,1952,250000.0
3.0,1.0,1500,1.0,0,0,1500,0,1952,475500.0
2.0,1.75,1600,1.5,0,0,1600,0,1940,672324.0
3.0,2.0,1200,1.0,0,0,880,320,1937,420000.0
3.0,2.0,1690,1.5,0,0,1690,0,1907,515000.0
4.0,2.5,2270,2.0,0,0,2270,0,1986,732350.0
4.0,2.5,1910,2.0,0,0,1910,0,2005,297500.0
3.0,1.5,1640,1.5,0,0,1640,0,1929,475000.0
4.0,2.5,2120,2.0,0,0,2120,0,2003,414000.0
3.0,1.5,1400,1.0,0,0,1400,0,1952,357250.0
2.0,1.0,760,1.0,0,0,760,0,1950,289950.0
3.0,1.0,1070,1.0,0,0,1070,0,1917,550000.0
3.0,1.75,1460,1.0,0,0,960,500,1958,446000.0
3.0,1.5,1280,1.5,0,0,1280,0,1932,279000.0
3.0,2.25,1650,2.0,0,0,1650,0,1988,370000.0
3.0,2.0,1260,1.0,0,0,1260,0,1998,216000.0
3.0,2.5,2200,1.0,0,1,1400,800,1952,1100000.0
4.0,2.5,3560,1.0,0,1,2060,1500,1977,1280600.0
2.0,1.5,1140,1.0,0,1,630,510,1988,355000.0
4.0,2.5,2550,2.0,0,0,2550,0,1988,699000.0
3.0,2.5,1553,3.0,0,0,1553,0,2014,412000.0
2.0,1.0,1140,1.0,0,0,1140,0,1923,276000.0
2.0,1.0,790,1.0,0,0,790,0,1944,100000.0
4.0,1.75,2130,1.5,0,0,2130,0,1914,955500.0
3.0,1.0,1390,1.0,0,0,1390,0,1958,199000.0
4.0,3.5,4000,2.0,0,0,4000,0,2007,762000.0
4.0,2.0,1520,1.0,0,0,1520,0,1967,425000.0
2.0,1.0,1657,2.0,0,0,1657,0,1910,546000.0
3.0,1.75,1680,1.0,0,0,1180,500,1976,419600.0
4.0,2.25,2270,1.0,0,0,1340,930,1954,735000.0
2.0,2.5,2470,3.0,0,0,1910,560,2011,1234570.0
2.0,2.0,1240,2.0,0,0,1240,0,1985,445000.0
3.0,2.0,1740,1.0,0,0,1740,0,1974,665000.0
5.0,3.5,4090,1.0,0,0,2920,1170,2002,1290000.0
4.0,2.75,2520,2.0,0,0,1720,800,1979,508500.0
5.0,1.0,1340,1.5,0,0,1340,0,1934,345950.0
3.0,1.0,1640,1.0,0,0,1640,0,1968,207500.0
4.0,2.5,3000,1.0,0,0,1550,1450,1969,1075000.0
3.0,1.0,1210,2.0,0,0,1210,0,1930,640000.0
3.0,1.0,1810,1.0,0,0,1360,450,1941,329500.0
4.0,2.75,2200,1.0,0,0,1500,700,1979,460000.0
3.0,1.75,2200,1.5,0,1,2200,0,1948,1230000.0
5.0,3.0,2350,2.0,0,3,1650,700,1924,805000.0
3.0,1.5,1090,1.0,0,0,1090,0,1963,200000.0
3.0,1.75,2280,1.0,0,0,1460,820,1977,749700.0
,1.5,1430,3.0,0,0,1430,0,1999,288000.0
2.0,1.0,1520,1.0,0,0,830,690,1927,535000.0
3.0,2.25,1620,1.0,0,2,1280,340,1950,330000.0
3.0,2.0,1510,1.5,0,0,1510,0,1928,479200.0
5.0,2.5,3001,2.0,0,0,3001,0,2006,373000.0
4.0,1.5,2020,1.0,0,0,1010,1010,1953,355000.0
3.0,2.0,1380,1.0,0,0,1380,0,2008,275000.0
3.0,1.5,1520,1.0,0,0,1020,500,1949,380000.0
2.0,1.75,1090,1.0,0,0,790,300,1915,417000.0
5.0,3.75,4220,2.0,0,0,4220,0,2004,1165000.0
3.0,2.25,2520,1.0,0,0,2520,0,1978,598500.0
3.0,2.0,1760,1.0,0,0,960,800,1920,629000.0
2.0,1.0,930,1.0,0,0,930,0,1957,226950.0
4.0,2.5,2600,1.5,0,0,2200,400,1939,1225000.0
3.0,2.25,2180,1.0,0,0,1700,480,1979,415000.0
3.0,2.5,1910,2.0,0,0,1910,0,2001,595000.0
3.0,1.75,1100,1.0,0,0,1100,0,1968,209950.0
3.0,1.75,1760,1.0,0,0,1760,0,1973,568000.0
2.0,1.0,700,1.0,0,0,480,220,1951,119900.0
3.0,1.0,1080,1.0,0,0,1080,0,1962,207000.0
3.0,1.0,1070,1.0,0,0,1070,0,1967,195000.0
3.0,1.5,1460,1.0,0,0,1460,0,1955,324950.0
1.0,1.0,1050,1.0,0,0,1050,0,1947,210000.0
4.0,2.75,3160,2.0,0,0,3160,0,1995,1078000.0
4.0,1.0,1400,1.0,0,0,1000,400,1954,325088.0
4.0,3.0,3120,2.0,0,0,3120,0,1977,790000.0
2.0,1.0,720,1.0,0,0,720,0,1982,150000.0
3.0,3.0,2840,2.0,0,0,2840,0,1999,790000.0
2.0,1.0,1220,1.0,0,0,770,450,1910,255000.0
4.0,3.0,2820,1.5,0,0,1860,960,1928,697000.0
2.0,1.0,840,1.0,0,0,840,0,1908,457500.0
3.0,2.0,1610,1.5,0,0,1610,0,1940,690000.0
4.0,3.25,1860,2.0,0,0,1860,0,1917,967000.0
4.0,1.75,2260,1.0,0,1,2260,0,1968,980000.0
4.0,2.75,2450,2.0,0,0,2450,0,1988,619420.0
2.0,1.0,850,1.0,0,0,850,0,1910,389000.0
3.0,1.0,1800,1.0,0,0,1020,780,1964,500000.0
4.0,1.75,1230,1.0,0,1,1090,140,1950,569000.0
4.0,2.25,2060,1.0,0,0,1540,520,1967,425000.0
4.0,2.25,2750,1.0,0,0,1500,1250,1948,635000.0
2.0,1.0,1120,1.0,0,0,1120,0,1980,256500.0
4.0,2.5,3010,2.0,0,0,3010,0,2005,695000.0
4.0,1.5,1580,1.5,0,0,1390,190,1945,535000.0
4.0,2.5,2630,2.0,0,0,2630,0,2004,454200.0
2.0,1.0,790,1.0,0,0,790,0,1943,418500.0
4.0,2.75,3110,2.0,0,0,3110,0,1983,749950.0
3.0,1.75,2130,1.0,0,0,1370,760,1999,338500.0
4.0,3.75,4520,1.5,0,2,3270,1250,1992,1250000.0
3.0,2.5,1600,2.0,0,0,1600,0,1993,299950.0
4.0,1.75,1950,1.0,0,0,1330,620,1963,325000.0
4.0,3.0,2010,2.0,0,0,2010,0,1973,434000.0
4.0,1.75,2550,1.0,0,0,1300,1250,1978,328950.0
5.0,3.75,5340,2.5,0,3,3740,1600,1912,2095000.0
4.0,2.0,2000,2.0,0,0,2000,0,1978,570000.0
3.0,2.25,2170,2.0,0,0,2170,0,2014,802000.0
3.0,1.0,1550,1.5,0,0,1550,0,1918,525000.0
6.0,3.0,2790,2.5,0,0,2790,0,1907,700000.0
3.0,1.75,1980,1.0,0,0,1040,940,1956,350000.0
2.0,1.5,1190,3.0,0,0,1190,0,2005,277500.0
5.0,2.75,3650,1.0,0,0,2360,1290,1975,1575000.0
3.0,1.0,1510,1.5,0,0,1510,0,1913,195000.0
3.0,2.0,1200,1.0,0,0,1200,0,1968,222000.0
5.0,3.0,2830,1.0,0,0,1500,1330,1979,865000.0
4.0,2.0,1650,1.0,0,0,1000,650,1959,445000.0
4.0,1.5,1710,1.5,0,0,1710,0,1924,495800.0
3.0,1.0,1740,1.5,0,0,1740,0,1924,548500.0
3.0,1.75,1840,1.0,0,0,1220,620,1974,310000.0
3.0,1.5,1820,1.0,0,0,1820,0,1962,205000.0
5.0,3.75,3860,2.0,0,0,3860,0,2003,470000.0
3.0,1.5,1810,1.5,0,0,1810,0,2002,430000.0
2.0,2.0,1030,3.0,0,0,1030,0,1999,310000.0
4.0,1.0,1410,1.5,0,0,1410,0,1953,355000.0
5.0,2.5,2140,1.0,0,2,1370,770,1968,621500.0
6.0,1.5,1930,1.0,0,0,1030,900,1971,175000.0
6.0,1.5,1930,1.0,0,0,1030,900,1971,326000.0
4.0,3.5,1930,1.5,0,2,1930,0,1920,690000.0
4.0,2.5,2210,2.0,0,0,2210,0,2003,335000.0
4.0,1.0,1360,1.0,0,0,1360,0,1961,197000.0
3.0,1.75,1830,1.0,0,0,930,900,1950,312500.0
3.0,2.25,2120,1.0,0,0,1420,700,1959,436000.0
4.0,2.5,2700,2.0,0,0,2700,0,2002,1015000.0
4.0,2.5,3160,2.0,0,1,2250,910,1992,805000.0
4.0,2.25,2770,2.0,0,0,2770,0,1979,652427.0
3.0,2.5,2240,1.0,0,0,2240,0,1945,1008000.0
4.0,2.5,2570,2.0,0,0,2570,0,1999,355000.0
2.0,1.0,880,1.0,0,0,880,0,1939,334550.0
3.0,2.25,1820,2.0,0,0,1820,0,1984,557500.0
4.0,2.25,1660,1.0,0,0,1110,550,1963,277500.0
4.0,3.0,2200,1.0,0,0,2200,0,1960,300000.0
4.0,1.0,1640,1.5,0,0,1460,180,1928,325000.0
4.0,2.0,1650,1.0,0,0,760,890,1951,402500.0
3.0,1.75,1420,1.0,0,0,1420,0,1963,461000.0
3.0,1.0,1270,1.5,0,0,1270,0,1926,540000.0
3.0,1.0,1070,1.0,0,0,1070,0,1971,385000.0
2.0,1.0,1060,1.0,0,0,860,200,1924,480000.0
3.0,2.25,2190,1.0,0,1,1240,950,1963,539950.0
3.0,2.25,1940,2.0,0,0,1940,0,1990,529000.0
3.0,2.5,1300,2.0,0,0,1060,240,2008,417000.0
3.0,1.5,1330,1.0,0,0,1330,0,1966,405000.0
3.0,2.25,1940,1.0,0,0,1630,310,1966,299000.0
3.0,1.75,2100,1.0,0,0,2100,0,1983,299000.0
3.0,1.0,1290,1.0,0,0,980,310,1951,372220.0
2.0,1.75,1560,1.0,0,0,780,780,1904,494400.0
3.0,1.75,2630,1.0,0,0,1330,1300,1958,280000.0
3.0,2.5,2100,2.0,0,0,2100,0,1992,277950.0
3.0,2.75,2070,2.0,0,0,2070,0,1996,770000.0
4.0,2.5,2960,2.0,0,0,2960,0,1989,760000.0
2.0,2.0,1300,1.0,0,0,1300,0,2004,230000.0
4.0,2.5,2520,2.0,0,0,2520,0,1994,525000.0
3.0,1.0,1150,1.5,0,0,1150,0,1927,307000.0
4.0,2.0,2030,1.5,0,0,1430,600,1947,253779.0
3.0,1.5,1880,1.0,0,0,1480,400,1968,405000.0
2.0,1.0,2320,2.0,0,0,2320,0,1942,360000.0
2.0,1.0,1050,1.5,0,3,1050,0,1910,521000.0
4.0,2.5,3030,2.0,0,0,3030,0,1978,680000.0
1.0,0.75,530,1.0,0,2,530,0,1950,355000.0
3.0,1.5,1090,1.0,0,0,1090,0,1968,200000.0
3.0,2.25,2220,1.0,0,0,1330,890,1993,330000.0
3.0,2.25,1430,2.0,0,0,1430,0,1987,221000.0
4.0,4.5,3780,2.0,0,4,2770,1010,1910,1598890.0
2.0,1.0,1560,1.0,0,0,780,780,1947,310000.0
4.0,2.25,2220,1.5,0,0,1310,910,1932,862000.0
3.0,1.5,1140,1.0,0,0,1140,0,1960,200000.0
4.0,2.5,2540,1.0,0,0,2540,0,1957,630000.0
3.0,2.25,1440,2.0,0,0,1440,0,1985,432250.0
3.0,2.25,1570,1.0,0,0,1070,500,1977,478000.0
4.0,2.25,1860,1.0,0,0,1400,460,1962,249000.0
5.0,3.0,2440,1.0,0,0,1450,990,2006,495000.0
4.0,2.5,2100,1.0,0,2,1240,860,1960,630000.0
4.0,2.5,2150,2.0,0,0,2150,0,1997,550000.0
3.0,2.5,2440,2.0,0,0,2440,0,1994,350000.0
5.0,1.5,1930,2.0,0,0,1930,0,1966,270000.0
4.0,2.0,1830,1.0,0,0,1830,0,1963,488250.0
4.0,3.5,1850,2.0,0,0,1130,720,1986,248000.0
4.0,3.5,3210,3.0,0,0,3210,0,2014,889000.0
1.0,1.0,1090,1.0,0,0,980,110,1927,375000.0
3.0,1.5,1870,2.0,0,2,1870,0,1906,933000.0
3.0,2.25,1920,1.0,0,2,1460,460,1977,625000.0
2.0,1.0,700,1.0,0,0,700,0,1943,328000.0
4.0,2.25,3380,1.0,0,2,1690,1690,1969,470000.0
5.0,2.5,2430,2.0,0,0,2430,0,2007,502500.0
3.0,1.75,1950,1.0,0,0,1210,740,1976,484000.0
2.0,1.0,900,1.0,0,0,900,0,1961,252500.0
3.0,2.5,2060,2.0,0,0,2060,0,1987,610000.0
4.0,2.0,2180,1.0,0,0,1280,900,1969,419000.0
4.0,2.25,2140,2.0,0,0,2140,0,1986,322500.0
6.0,1.0,1730,1.5,0,0,1250,480,1918,563000.0
4.0,2.5,3140,2.0,0,0,3140,0,1993,464000.0
4.0,4.25,3010,2.0,0,3,1940,1070,1951,870000.0
2.0,1.5,800,2.0,0,0,800,0,2003,280000.0
3.0,2.5,3300,2.0,0,0,3300,0,1994,850000.0
2.0,1.0,1530,1.0,0,0,1130,400,1946,458950.0
2.0,1.0,760,1.0,0,0,760,0,1946,122000.0
5.0,3.0,2450,2.0,0,0,2450,0,1994,525000.0
2.0,1.0,1000,1.0,0,0,1000,0,1962,286300.0
2.0,1.0,840,1.0,0,0,840,0,1952,218450.0
3.0,1.5,1380,1.0,0,0,1080,300,1955,525000.0
3.0,1.5,1380,1.0,0,0,1080,300,1955,650000.0
4.0,2.0,2020,1.5,0,0,2020,0,1949,356000.0
2.0,1.0,1260,1.0,0,0,1040,220,1951,436500.0
3.0,1.75,1440,1.0,0,0,1180,260,1979,410000.0
4.0,1.75,1540,1.0,0,0,1540,0,1950,512500.0
4.0,1.0,1060,1.0,0,1,880,180,1925,510000.0
4.0,1.75,1900,1.0,0,0,1900,0,1966,566000.0
3.0,1.75,2870,1.5,0,1,2870,0,1948,525000.0
3.0,1.0,1050,1.0,0,0,930,120,1920,435000.0
3.0,2.75,1840,1.0,0,2,1340,500,1989,406500.0
5.0,2.75,3000,1.0,0,0,1500,1500,1966,550000.0
3.0,2.0,1200,1.5,0,0,1200,0,1949,251000.0
3.0,1.5,1840,1.0,0,0,1220,620,1959,830000.0
4.0,2.5,2790,2.0,0,0,2790,0,1989,803000.0
3.0,1.0,970,1.0,0,0,970,0,1942,206000.0
4.0,1.0,1070,1.5,0,0,1070,0,1944,200000.0
2.0,1.0,900,1.0,0,0,900,0,1952,219000.0
4.0,4.0,2680,1.0,0,0,1380,1300,1962,777000.0
3.0,2.5,2000,2.0,0,0,2000,0,1979,593700.0
3.0,1.5,1660,1.0,0,0,1660,0,1956,712500.0
4.0,1.5,1770,1.5,0,0,1240,530,1946,600000.0
3.0,2.0,1230,1.5,0,0,1230,0,1940,554663.0
3.0,1.0,1740,1.0,0,0,1020,720,1962,267000.0
3.0,2.0,1710,1.0,0,0,1710,0,1953,390000.0
6.0,2.0,2020,1.0,0,0,1010,1010,1979,335000.0
4.0,2.5,2410,1.0,0,0,1990,420,1975,938000.0
4.0,2.75,2310,1.0,0,0,1410,900,1993,370000.0
5.0,2.5,2400,2.0,0,0,2400,0,2003,335000.0
5.0,2.0,3160,1.5,0,0,1870,1290,1923,695000.0
3.0,1.0,1560,1.0,0,0,1560,0,1953,387500.0
3.0,2.5,1770,2.0,0,0,1770,0,1992,245000.0
3.0,2.0,1600,1.0,0,0,1600,0,1990,308550.0
3.0,1.75,1330,1.0,0,0,1330,0,1968,225000.0
4.0,2.5,2970,2.0,0,0,2970,0,1993,715000.0
3.0,1.0,1020,1.0,0,0,1020,0,1954,335000.0
3.0,2.5,2490,2.0,0,0,2490,0,2003,634000.0
5.0,2.0,1700,1.0,0,0,1000,700,1956,337500.0
1.0,1.0,850,1.0,0,0,850,0,1940,440000.0
3.0,1.75,1250,1.0,0,2,1250,0,1990,350000.0
2.0,1.0,610,1.0,0,0,610,0,1918,400000.0
4.0,3.5,3700,2.0,0,0,3700,0,1989,1288000.0
3.0,1.0,950,1.0,0,0,950,0,1954,435000.0
4.0,2.5,3860,2.0,0,0,2930,930,2004,681000.0
3.0,3.5,1360,2.0,0,0,1240,120,2007,397000.0
4.0,2.5,3890,2.0,0,0,3890,0,1996,775000.0
3.0,2.25,1680,1.0,0,0,1130,550,1959,480000.0
3.0,2.5,1520,2.0,0,0,1520,0,1985,158000.0
3.0,2.0,2420,1.5,0,0,2420,0,2005,590000.0
5.0,2.75,3890,2.0,0,0,3890,0,2004,772500.0
5.0,1.5,2940,1.0,0,0,1470,1470,1955,464500.0
3.0,1.75,1350,1.0,0,0,1350,0,1966,281000.0
3.0,2.25,2190,1.0,0,0,2190,0,1990,620000.0
3.0,2.25,2280,1.0,0,1,1150,1130,1985,475000.0
2.0,2.0,1070,1.0,0,0,910,160,1932,245000.0
5.0,2.25,2540,1.5,0,0,1510,1030,1925,660000.0
4.0,2.25,2270,1.0,0,0,1310,960,1973,527500.0
2.0,1.0,1220,1.0,0,0,1220,0,1914,135000.0
3.0,1.75,1890,1.0,0,0,1890,0,2003,275000.0
4.0,2.0,1990,1.0,0,0,1080,910,1926,430000.0
3.0,1.0,1220,1.0,0,0,1220,0,1968,213500.0
3.0,3.0,2640,2.0,0,0,2640,0,2012,535000.0
3.0,1.75,1480,1.0,0,0,1480,0,1952,641000.0
3.0,2.0,2320,1.0,0,0,2320,0,1952,436300.0
4.0,1.75,2410,1.5,0,0,2410,0,1911,1440000.0
4.0,2.75,2090,1.0,0,0,2090,0,1949,830000.0
3.0,1.0,920,1.0,0,0,920,0,1910,380000.0
3.0,0.75,850,1.0,0,0,600,250,1945,132500.0
3.0,1.0,1130,1.0,0,0,1130,0,1954,179950.0
3.0,1.0,1260,1.0,0,0,1260,0,1954,188200.0
4.0,2.0,2090,1.0,0,0,2090,0,1951,659000.0
3.0,2.0,2020,1.5,0,0,1180,840,1926,317000.0
3.0,2.25,1970,1.0,0,0,1470,500,1959,625000.0
3.0,1.75,1820,1.0,0,0,1230,590,1976,350000.0
3.0,1.5,1840,1.5,0,0,1340,500,1915,750000.0
4.0,1.75,2100,1.0,0,0,1280,820,1959,457000.0
4.0,2.0,1770,2.0,0,0,1770,0,1906,632500.0
3.0,2.0,1110,1.0,0,0,1110,0,1991,223000.0
4.0,2.75,2090,1.0,0,0,1240,850,1976,610000.0
4.0,1.75,2080,2.0,0,0,2080,0,1948,385000.0
3.0,3.25,1400,2.0,0,0,1160,240,2005,367500.0
3.0,1.0,1060,1.0,0,0,1060,0,1949,385100.0
2.0,1.0,720,1.0,0,0,720,0,1920,230000.0
3.0,2.75,1100,2.0,0,0,780,320,2008,286000.0
3.0,1.0,1010,1.0,0,0,1010,0,1967,201700.0
4.0,4.75,5230,2.5,0,0,5230,0,2002,1350000.0
4.0,1.75,2420,1.0,0,0,1480,940,1979,525000.0
3.0,1.5,1200,1.0,0,0,1200,0,1975,361000.0
3.0,1.5,1950,3.0,0,0,1950,0,2002,530000.0
3.0,2.25,1870,1.0,0,0,1870,0,1950,455000.0
4.0,2.25,1310,1.0,0,0,1310,0,1966,421000.0
4.0,2.0,1520,1.5,0,0,1520,0,1945,640000.0
3.0,1.0,1270,1.0,0,0,1270,0,1955,240000.0
2.0,1.0,840,1.0,0,0,840,0,1928,360000.0
2.0,1.0,900,1.0,0,0,900,0,1953,157340.0
4.0,3.0,3010,2.0,0,4,2560,450,1950,1240000.0
3.0,1.0,1050,1.0,0,0,1050,0,1954,250000.0
6.0,2.75,3360,1.0,0,0,2040,1320,1962,735000.0
7.0,4.75,5370,1.5,0,0,5370,0,1967,884900.0
3.0,3.5,2690,2.0,0,0,2690,0,1948,775000.0
3.0,1.75,1710,1.0,0,0,1710,0,1948,463000.0
3.0,2.5,1640,3.0,0,0,1640,0,2009,579000.0
6.0,3.75,4000,2.0,0,2,3080,920,2004,570000.0
5.0,4.5,4140,2.0,0,0,4140,0,2005,1060000.0
4.0,2.75,3140,1.0,0,0,2080,1060,1971,375000.0
2.0,1.75,1320,1.0,0,0,920,400,1938,422000.0
4.0,3.5,3080,2.0,0,0,2010,1070,2014,866500.0
3.0,2.5,2500,2.0,0,0,2500,0,1986,705000.0
4.0,2.5,2520,2.0,0,0,2520,0,1994,470000.0
3.0,1.25,2350,1.0,0,0,1320,1030,1966,360000.0
4.0,2.5,2570,1.0,0,4,1510,1060,1948,795000.0
4.0,2.5,3100,2.0,0,0,3100,0,2003,800000.0
4.0,3.5,4730,1.5,0,0,4270,460,1935,2453500.0
3.0,1.75,1030,1.0,0,0,930,100,1927,277284.0
2.0,1.0,1020,1.0,0,0,1020,0,1953,460000.0
3.0,2.5,2080,2.0,0,0,2080,0,1996,898888.0
3.0,1.0,1410,1.0,0,0,1410,0,1981,211000.0
2.0,2.0,1360,2.0,0,0,1360,0,2004,222000.0
3.0,2.5,2620,2.0,0,0,2620,0,1992,672000.0
3.0,2.25,2260,1.0,0,0,1690,570,1974,778000.0
3.0,1.75,1490,1.0,0,0,1490,0,1976,312500.0
4.0,2.5,2530,1.5,0,0,1720,810,1975,650000.0
6.0,2.25,3140,1.0,0,0,1570,1570,1959,740000.0
3.0,2.0,1820,1.0,0,0,1820,0,1972,320000.0
4.0,2.5,1770,2.0,0,0,1770,0,1990,455000.0
5.0,4.0,4430,2.0,0,0,4430,0,2013,2450000.0
3.0,3.25,1490,3.0,0,0,1220,270,2001,500000.0
3.0,1.75,1790,1.0,0,0,1130,660,1978,325000.0
3.0,2.5,1710,3.0,0,0,1510,200,2004,416000.0
4.0,2.25,2070,2.0,0,0,2070,0,1968,495000.0
2.0,1.0,1140,1.0,0,0,1140,0,1908,549000.0
5.0,2.0,3930,1.5,0,0,3070,860,1968,589000.0
3.0,1.5,1100,1.0,0,0,1100,0,1967,194820.0
3.0,2.5,2260,1.5,0,0,1280,980,1910,405000.0
3.0,2.5,2260,1.5,0,0,1280,980,1910,625000.0
3.0,1.0,1130,1.0,0,0,1130,0,1954,205000.0
3.0,3.75,1950,1.0,0,0,1360,590,1959,345100.0
3.0,1.0,960,1.0,0,0,960,0,1953,200000.0
4.0,3.5,4210,2.0,0,0,4210,0,2001,1905000.0
3.0,1.5,3430,1.0,0,2,2230,1200,1988,524500.0
4.0,2.75,3470,2.0,0,0,2070,1400,1993,598600.0
5.0,3.0,2140,1.0,0,0,1280,860,1978,367777.0
3.0,2.75,2520,1.0,0,0,1360,1160,1946,750000.0
5.0,2.25,3550,2.0,0,0,3550,0,1968,575000.0
2.0,1.0,700,1.0,0,0,700,0,1949,84000.0
2.0,1.0,740,1.0,0,0,740,0,1926,255000.0
4.0,3.75,3300,1.5,0,4,2600,700,1926,1740000.0
3.0,2.25,1640,1.0,0,0,1240,400,1977,415000.0
3.0,2.5,2780,2.0,0,1,2780,0,1990,449900.0
5.0,1.5,1830,1.5,0,0,1830,0,1929,220000.0
4.0,2.5,3540,2.0,0,0,3540,0,2003,899000.0
3.0,2.5,1440,1.0,0,0,1440,0,1954,430000.0
4.0,2.5,2960,2.0,0,0,2960,0,2001,472500.0
6.0,2.5,3180,1.0,0,0,1590,1590,1967,680000.0
5.0,4.0,3310,2.0,0,0,3310,0,2000,1650000.0
3.0,2.0,2390,2.0,0,0,2390,0,1921,810000.0
3.0,2.5,2460,2.0,0,0,2460,0,1977,605000.0
3.0,1.75,1630,1.0,0,0,1630,0,1958,522000.0
5.0,2.75,3490,2.0,0,0,3490,0,2005,759000.0
4.0,2.75,2500,2.0,0,0,2500,0,1966,411000.0
4.0,2.5,2080,1.0,0,0,1240,840,1984,286950.0
3.0,1.5,1290,3.0,0,0,1290,0,2000,440000.0
3.0,1.0,1700,1.0,0,0,1700,0,1955,149000.0
3.0,1.0,1700,1.0,0,0,1700,0,1955,284700.0
3.0,2.5,2540,1.0,0,1,1290,1250,1964,374950.0
3.0,1.5,1180,1.0,0,0,1180,0,1952,816000.0
4.0,1.75,1520,1.0,0,0,1370,150,1960,533250.0
3.0,2.75,2390,1.0,0,0,1390,1000,1942,689800.0
4.0,2.75,2740,1.5,0,3,1820,920,1947,775000.0
3.0,2.5,2190,1.0,0,0,1760,430,1991,702000.0
3.0,1.0,1350,1.5,0,0,1350,0,1942,160000.0
3.0,1.0,1350,1.5,0,0,1350,0,1942,255500.0
4.0,2.75,2980,1.0,0,0,1860,1120,1973,949000.0
2.0,1.0,790,1.0,0,0,790,0,1944,169500.0
4.0,2.25,2130,2.0,0,0,2130,0,1965,586000.0
4.0,2.5,2700,1.0,0,0,1600,1100,1978,680000.0
3.0,2.0,3200,1.0,0,0,2000,1200,1977,851500.0
2.0,1.5,1159,1.0,0,0,1159,0,1948,582500.0
4.0,3.5,3080,2.0,0,0,3080,0,2008,637000.0
3.0,1.0,1000,1.0,0,0,1000,0,1955,225000.0
3.0,3.25,2260,2.0,0,0,1880,380,2003,795000.0
4.0,2.25,2270,1.0,0,0,1290,980,1976,304999.0
1.0,0.75,760,1.0,0,0,760,0,1915,95000.0
4.0,1.75,1420,1.0,0,0,1040,380,1942,240000.0
4.0,2.5,2500,1.0,0,0,1250,1250,1958,772000.0
2.0,1.5,1450,1.0,0,0,1450,0,1983,245000.0
5.0,3.0,2500,1.0,0,0,1430,1070,1999,430000.0
3.0,1.5,2210,1.5,0,0,2210,0,1916,799000.0
5.0,2.75,3020,2.0,0,0,3020,0,2007,880000.0
4.0,2.5,3290,2.0,0,0,3290,0,2004,750000.0
4.0,4.0,5780,2.0,0,0,4130,1650,2008,2890000.0
3.0,2.5,1820,2.0,0,0,1820,0,1993,532000.0
4.0,2.75,2500,1.0,0,0,1380,1120,1978,525000.0
2.0,1.0,1210,1.0,0,1,1210,0,1952,239000.0
2.0,1.5,1090,1.0,0,0,970,120,1951,460000.0
4.0,2.25,1330,1.5,0,0,1330,0,1962,540000.0
2.0,1.0,890,1.0,0,0,890,0,1923,475000.0
3.0,1.75,1360,1.0,0,0,1360,0,1968,445000.0
5.0,3.75,4220,2.0,0,2,3420,800,1991,1575000.0
4.0,2.5,3780,2.0,0,0,3780,0,2004,549950.0
4.0,2.0,2610,1.5,0,0,1690,920,1940,294950.0
3.0,2.5,1980,3.0,0,2,1980,0,1993,736000.0
3.0,1.75,1290,1.0,0,0,1290,0,1980,214946.0
5.0,3.25,3620,2.0,0,2,3620,0,2003,856000.0
2.0,2.5,2680,1.0,0,0,2680,0,2004,775000.0
3.0,1.75,1200,1.0,0,0,1200,0,1959,205000.0
2.0,2.75,1992,1.5,1,4,1288,704,1903,429592.0
4.0,1.75,1640,1.0,0,0,1120,520,1977,414250.0
4.0,2.75,1920,1.0,0,0,960,960,1906,399950.0
3.0,2.25,1840,1.0,0,0,1370,470,1979,319990.0
3.0,1.5,1310,1.0,0,0,1310,0,1970,524000.0
2.0,1.0,1050,1.5,0,0,1050,0,1913,349950.0
4.0,2.5,2570,1.5,0,0,1580,990,1927,889000.0
3.0,1.0,930,1.5,0,0,930,0,1919,300000.0
1.0,1.0,730,1.0,0,0,730,0,1911,395000.0
2.0,2.5,1270,3.0,0,0,1270,0,2008,348000.0
2.0,1.0,1150,1.0,0,1,710,440,1921,830000.0
2.0,1.0,820,1.0,0,0,820,0,1965,173000.0
4.0,1.75,3000,1.0,0,3,1500,1500,1950,585000.0
3.0,2.0,2220,1.0,0,0,1110,1110,1966,576750.0
5.0,3.25,2500,1.0,0,3,1250,1250,1962,495000.0
3.0,3.5,1540,2.0,0,0,1360,180,2007,216650.0
4.0,2.75,2750,1.0,0,0,1800,950,1978,615000.0
4.0,2.5,3130,1.0,0,0,1620,1510,1978,675000.0
3.0,2.0,1430,1.0,0,0,990,440,1983,510000.0
3.0,2.5,2680,2.0,0,0,2680,0,1995,630000.0
4.0,2.5,3010,2.0,0,0,3010,0,2003,359950.0
3.0,1.5,1530,1.5,0,0,1530,0,1986,265000.0
3.0,1.0,1240,1.0,0,0,1240,0,1916,210000.0
3.0,2.5,2260,1.0,0,2,2260,0,1998,367000.0
4.0,2.25,2820,1.5,0,2,1800,1020,1926,1075000.0
3.0,2.5,3560,1.0,0,2,1650,1910,1948,756000.0
3.0,2.25,1630,1.0,0,0,1630,0,1960,203000.0
4.0,2.5,2880,2.0,0,3,2880,0,2002,535000.0
3.0,3.25,2200,2.0,0,0,1710,490,1947,525000.0
3.0,1.75,1620,1.0,0,0,1220,400,1981,347500.0
3.0,1.75,1480,2.5,0,0,1480,0,2005,620000.0
4.0,2.5,2250,2.0,0,0,2250,0,1996,645000.0
4.0,3.0,3540,2.0,0,0,3000,540,1940,2200000.0
3.0,2.0,1790,1.0,0,0,1790,0,1990,280000.0
3.0,2.0,1400,1.0,0,0,700,700,1924,432000.0
3.0,1.5,2390,2.0,0,1,1790,600,1929,790000.0
4.0,1.75,2400,1.0,0,0,2400,0,1957,635000.0
3.0,1.5,2050,1.0,0,0,1350,700,1958,442000.0
4.0,3.0,2640,2.0,0,0,2640,0,2001,490000.0
5.0,1.75,2320,1.0,0,0,1290,1030,1962,250000.0
4.0,2.5,2440,2.5,0,0,2440,0,1902,1325000.0
3.0,1.0,1260,1.0,0,0,1260,0,1954,120000.0
5.0,4.75,6240,1.0,0,3,4610,1630,2003,2950000.0
4.0,2.5,1930,2.0,0,0,1930,0,1993,325000.0
4.0,1.75,1200,1.0,0,0,1200,0,1968,210000.0
1.0,1.0,970,1.0,0,0,570,400,1920,215000.0
3.0,1.75,1810,1.0,0,0,1210,600,1968,387000.0
3.0,1.0,1380,1.5,0,0,1380,0,1925,408000.0
3.0,1.0,1470,1.0,0,0,1470,0,1953,410000.0
3.0,1.0,1010,1.0,0,0,1010,0,1925,216000.0
3.0,1.0,1010,1.0,0,0,1010,0,1925,390000.0
3.0,1.5,1340,1.0,0,0,1340,0,1950,357000.0
3.0,1.0,970,1.0,0,0,970,0,1970,215000.0
3.0,1.0,1122,1.5,0,0,1122,0,1900,265000.0
3.0,2.75,1670,3.0,0,0,1350,320,2014,589950.0
3.0,1.75,2840,1.0,0,3,1600,1240,1950,440000.0
2.0,1.0,770,1.0,0,0,770,0,1914,248000.0
3.0,2.25,2040,2.0,0,0,2040,0,1977,730000.0
4.0,2.5,3052,2.0,0,0,3052,0,2004,425000.0
3.0,2.5,2620,2.0,0,0,1830,790,1977,680000.0
5.0,2.25,3120,2.0,0,0,3120,0,1980,341500.0
2.0,1.0,1100,1.0,0,0,900,200,1950,395000.0
4.0,2.75,3410,1.5,0,0,3410,0,1962,1225000.0
5.0,2.75,2510,1.0,0,1,1600,910,1975,695500.0
3.0,1.75,1680,1.0,0,0,1200,480,1977,308000.0
3.0,2.0,1960,1.0,0,0,1000,960,1977,422500.0
2.0,1.0,1040,1.0,0,0,1040,0,1915,418000.0
5.0,1.5,1750,1.5,0,0,1750,0,1961,385000.0
3.0,3.25,2170,1.5,0,0,1650,520,1928,876650.0
3.0,2.5,1639,2.0,0,0,1479,160,2003,450000.0
4.0,2.25,2100,1.0,0,0,1290,810,1973,418800.0
2.0,1.0,880,2.0,0,0,880,0,1945,330000.0
3.0,1.75,1940,1.0,0,0,1290,650,1963,550000.0
4.0,2.5,2490,1.0,0,0,1390,1100,1990,270000.0
3.0,2.25,2060,2.0,0,0,1800,260,1940,978500.0
4.0,2.5,2720,2.0,0,2,2500,220,1981,975000.0
3.0,2.25,2180,1.0,0,0,1750,430,1973,455000.0
4.0,3.25,3600,2.0,0,2,3310,290,1991,1415000.0
2.0,1.0,840,1.0,0,0,840,0,1951,220000.0
3.0,2.0,2370,2.0,0,0,2370,0,1970,490000.0
4.0,2.25,2270,2.0,0,0,2270,0,1978,420000.0
4.0,2.5,2720,2.0,0,0,2720,0,2003,408500.0
3.0,1.5,1140,1.5,0,0,1140,0,1915,716000.0
4.0,2.5,2460,2.0,0,0,1620,840,1938,965000.0
3.0,1.5,1240,1.0,0,0,1240,0,1968,357823.0
5.0,4.5,10040,2.0,1,2,7680,2360,1940,7062500.0
3.0,2.25,1670,1.0,0,0,1170,500,1977,425000.0
4.0,1.75,2220,1.0,0,0,1110,1110,1953,711777.0
3.0,1.0,980,1.0,0,0,980,0,1966,335000.0
4.0,1.5,1890,1.5,0,0,1890,0,1919,825000.0
2.0,1.0,1100,1.5,0,0,1100,0,1900,210000.0
2.0,1.75,2770,2.0,0,0,1780,990,1983,575000.0
4.0,2.75,4250,2.0,0,0,4250,0,2003,1208000.0
2.0,2.0,1370,1.0,0,0,1370,0,2005,431500.0
3.0,1.5,1480,1.0,0,0,1480,0,1959,475000.0
4.0,3.75,3770,2.5,0,0,2890,880,1916,1495000.0
6.0,3.0,2870,2.0,0,0,2330,540,1960,540000.0
3.0,2.5,3820,2.0,0,0,3820,0,1987,775000.0
3.0,2.5,1530,1.0,0,0,1210,320,1997,635000.0
3.0,2.75,4120,1.0,0,2,4120,0,1999,1300000.0
3.0,2.25,1590,1.0,0,0,1100,490,1976,405000.0
3.0,1.0,1520,1.0,0,0,1040,480,1951,210000.0
4.0,2.5,2350,2.0,0,0,2150,200,1923,880000.0
4.0,2.0,1370,1.5,0,0,1370,0,1955,239000.0
3.0,2.5,1540,1.0,0,0,770,770,1944,515000.0
3.0,3.25,3786,1.0,1,4,1934,1852,1978,1379900.0
4.0,2.25,1500,2.0,0,0,1500,0,1999,215000.0
6.0,2.0,1750,1.0,0,0,1750,0,1943,315000.0
3.0,1.5,1800,1.0,0,0,1200,600,1957,442500.0
2.0,1.75,1180,1.0,0,0,1180,0,1941,311000.0
2.0,1.0,830,1.0,0,0,830,0,1925,425000.0
3.0,1.75,1540,1.0,0,0,1040,500,1919,433500.0
3.0,2.25,1610,2.0,0,0,1610,0,1978,450000.0
3.0,2.25,1990,2.0,0,0,1990,0,1987,675000.0
3.0,2.5,2070,2.0,0,0,2070,0,1999,535000.0
3.0,1.75,1760,1.0,0,0,1230,530,1967,577000.0
3.0,1.75,1740,1.0,0,0,1290,450,1939,480000.0
3.0,1.5,1950,1.0,0,0,1530,420,1914,400000.0
3.0,1.0,1280,1.5,0,0,1280,0,1947,304000.0
3.0,1.75,1460,1.0,0,0,1460,0,1990,355000.0
4.0,3.25,3770,2.0,0,0,3770,0,1992,998000.0
4.0,1.75,2410,2.0,0,3,2060,350,1936,550000.0
4.0,1.75,2410,2.0,0,3,2060,350,1936,550000.0
3.0,1.75,1400,2.0,0,0,1400,0,1948,210000.0
3.0,2.5,2100,2.0,0,0,2100,0,1990,317000.0
4.0,3.5,5360,1.0,0,0,3270,2090,1971,700000.0
3.0,1.0,1000,1.0,0,0,1000,0,1969,265000.0
4.0,3.5,3150,2.0,0,0,3150,0,2001,700000.0
5.0,3.5,4180,2.0,0,2,3160,1020,1990,1020000.0
4.0,2.25,2840,1.0,0,0,2240,600,1972,1145000.0
4.0,2.5,2110,1.0,0,0,1290,820,1985,460000.0
2.0,1.5,1660,1.0,0,0,1000,660,1950,410000.0
4.0,3.0,2160,1.0,0,0,1320,840,1921,665000.0
4.0,2.5,2420,2.0,0,0,2420,0,1994,600000.0
4.0,1.75,1920,1.0,0,0,1170,750,1967,502000.0
4.0,2.5,2310,2.0,0,0,2310,0,1978,364950.0
3.0,2.25,2330,1.5,0,2,1520,810,1927,680000.0
5.0,2.5,2340,1.0,0,0,1670,670,1967,235500.0
4.0,2.5,2590,2.0,0,0,2590,0,2001,576000.0
2.0,3.0,1410,2.0,0,0,1140,270,2006,405000.0
3.0,2.75,2850,1.0,0,0,1540,1310,1989,335000.0
2.0,1.0,730,1.0,0,0,730,0,1953,122000.0
3.0,1.75,1470,1.0,0,3,1070,400,1939,432000.0
4.0,2.25,2330,1.0,0,0,2330,0,1974,375000.0
4.0,2.25,2460,1.0,0,0,2460,0,1959,276000.0
3.0,2.25,2080,1.5,0,0,1680,400,1977,450000.0
2.0,1.0,990,1.0,0,0,990,0,1910,210000.0
3.0,2.5,1450,2.0,0,0,1450,0,2011,279000.0
3.0,1.75,1340,2.0,0,0,1340,0,1900,635000.0
3.0,2.5,2730,2.0,0,0,2730,0,1998,350000.0
3.0,1.0,1140,1.0,0,0,1140,0,1958,218000.0
4.0,1.5,1950,1.5,0,1,1650,300,1944,750000.0
4.0,1.75,2000,1.0,0,0,1150,850,1958,310597.0
3.0,1.0,900,1.0,0,0,700,200,1923,355000.0
5.0,2.75,3390,2.0,0,0,3390,0,2004,735000.0
1.0,1.0,720,1.0,0,0,720,0,1940,155000.0
3.0,1.0,940,1.0,0,0,940,0,1965,354000.0
3.0,1.75,1770,1.0,0,0,1400,370,1982,415000.0
1.0,1.0,590,1.0,0,0,590,0,1926,202000.0
3.0,2.5,1980,2.0,0,0,1470,510,1996,580000.0
4.0,3.25,3070,2.0,0,0,2180,890,1962,1495000.0
4.0,2.5,3500,2.0,0,0,3500,0,2004,790000.0
3.0,2.5,2100,2.0,0,0,2100,0,1999,499900.0
4.0,2.25,2620,1.0,0,0,1820,800,1952,525000.0
4.0,2.5,2810,2.0,0,0,2810,0,1989,810000.0
4.0,1.5,2290,1.0,0,0,1330,960,1947,425000.0
3.0,1.75,1350,1.0,0,0,1350,0,1993,241250.0
4.0,2.5,2770,1.0,0,0,1600,1170,1961,318700.0
4.0,1.75,2530,1.5,0,2,2070,460,1917,720000.0
3.0,1.0,1280,1.5,0,0,1280,0,1941,291000.0
3.0,1.75,1060,1.0,0,0,1060,0,1983,420000.0
2.0,1.75,1000,1.0,0,0,1000,0,1975,210000.0
3.0,3.25,3870,2.0,0,2,2970,900,1991,645000.0
5.0,2.0,3370,1.5,0,0,2140,1230,1907,762000.0
4.0,1.75,2290,1.0,0,0,2290,0,1936,247500.0
3.0,2.25,1670,2.0,0,0,1670,0,1990,282500.0
3.0,1.75,1460,1.0,0,0,1460,0,1961,395000.0
3.0,1.75,1770,1.0,0,0,1030,740,1960,295000.0
2.0,1.0,820,1.0,0,0,820,0,1954,235000.0
3.0,1.75,1900,1.0,0,2,1450,450,1948,770000.0
2.0,2.0,1870,1.0,0,0,1870,0,2006,559950.0
4.0,2.0,1840,1.0,0,0,920,920,1942,639000.0
3.0,1.0,1590,1.0,0,0,1140,450,1967,314950.0
3.0,1.0,1640,1.0,0,0,1640,0,1946,525000.0
3.0,2.25,3000,1.5,1,4,3000,0,2001,2400000.0
3.0,1.75,2160,1.0,0,0,1390,770,1960,820000.0
3.0,3.0,2490,2.0,0,3,1790,700,1911,1385000.0
3.0,2.0,1290,1.0,0,0,1290,0,1950,521450.0
3.0,2.5,3190,2.0,0,0,3190,0,1988,760750.0
4.0,1.0,1540,1.5,0,0,1540,0,1923,759600.0
3.0,2.0,2140,1.0,0,0,1480,660,1966,346150.0
2.0,1.0,980,1.0,0,0,980,0,1926,390000.0
5.0,2.25,2450,2.0,0,0,2450,0,1973,359950.0
3.0,2.0,1360,1.5,0,0,910,450,1924,430000.0
4.0,3.5,4610,2.0,0,0,4610,0,2000,960000.0
7.0,6.75,7480,2.0,0,2,5080,2400,1953,800000.0
3.0,2.5,2860,2.0,0,0,2860,0,1999,1010000.0
3.0,2.0,1810,1.0,0,0,1810,0,1970,290000.0
4.0,2.0,2240,1.0,0,0,2240,0,1948,1350000.0
3.0,3.25,3610,2.0,0,0,2440,1170,2003,777000.0
2.0,1.0,1450,1.5,0,0,1450,0,1921,526000.0
3.0,3.5,1450,2.0,0,0,1200,250,2007,550000.0
3.0,1.5,1820,1.0,0,0,1200,620,1958,276000.0
5.0,3.25,5620,2.0,0,0,4140,1480,1916,2500000.0
3.0,1.75,2080,1.0,0,0,1040,1040,1950,325000.0
3.0,2.5,1780,3.0,0,0,1780,0,2007,365000.0
8.0,6.0,4340,2.0,0,0,4340,0,1967,2150000.0
4.0,3.25,2860,2.0,0,0,1980,880,1925,825050.0
3.0,1.5,2540,1.0,0,0,1500,1040,1959,690000.0
4.0,1.0,1140,1.5,0,0,1140,0,1958,390000.0
3.0,2.0,1320,3.0,0,0,1320,0,1995,385000.0
3.0,2.5,2040,2.0,0,0,2040,0,1987,619000.0
4.0,2.25,1790,1.0,0,0,1170,620,1983,494000.0
3.0,2.0,1910,1.0,0,0,1910,0,1955,412450.0
3.0,1.75,1460,2.0,0,0,1460,0,1928,580000.0
3.0,1.5,1420,1.0,0,0,1420,0,1957,269900.0
4.0,1.5,1790,1.5,0,0,1790,0,1928,704300.0
3.0,2.0,1390,2.0,0,0,1390,0,2005,267000.0
4.0,1.75,1880,1.0,0,0,1280,600,1976,310000.0
3.0,1.5,1570,2.0,0,0,1570,0,1908,227064.0
3.0,2.5,2690,2.0,0,0,1840,850,1943,925000.0
3.0,1.75,1670,1.0,0,2,1670,0,1992,245000.0
3.0,1.0,1040,1.0,0,0,1040,0,1969,339888.0
4.0,2.0,1560,1.0,0,0,1560,0,1968,439000.0
2.0,1.0,1470,1.0,0,0,1470,0,1940,400000.0
3.0,2.25,2070,1.5,0,0,2070,0,1955,560000.0
2.0,1.0,1370,1.0,0,2,1130,240,1941,703011.0
2.0,1.0,1120,1.0,0,0,770,350,1926,363000.0
4.0,2.75,2640,2.0,0,0,2640,0,2001,650000.0
3.0,1.0,1030,1.0,0,0,1030,0,1972,299950.0
3.0,1.0,1120,1.0,0,0,1120,0,1942,228950.0
4.0,1.75,1730,1.0,0,0,880,850,1956,465000.0
3.0,2.5,2090,2.0,0,2,2090,0,1983,725000.0
3.0,1.0,920,1.0,0,0,920,0,1977,212500.0
4.0,2.25,2970,2.0,0,0,2970,0,1983,526000.0
3.0,2.5,1720,2.0,0,0,1720,0,1993,383000.0
3.0,1.75,1460,1.0,0,0,1460,0,1988,244000.0
3.0,1.5,1540,1.5,0,0,1490,50,1930,565000.0
8.0,3.0,2850,1.0,0,0,2850,0,1959,373000.0
3.0,2.0,1310,1.0,0,0,1310,0,1962,300000.0
5.0,2.5,2430,2.0,0,0,2430,0,2001,405000.0
3.0,1.5,1700,1.0,0,1,1700,0,1954,979000.0
4.0,1.75,2160,2.0,0,0,2160,0,1978,324888.0
3.0,1.5,860,1.0,0,0,860,0,1929,445000.0
3.0,3.5,2050,2.0,0,0,1520,530,2006,761000.0
4.0,2.0,1650,1.0,0,0,1130,520,1972,435000.0
3.0,2.25,1570,1.0,0,0,1180,390,1991,252000.0
3.0,1.75,1660,1.5,0,0,1660,0,1957,350000.0
3.0,1.0,1220,1.0,0,0,1220,0,1955,875000.0
3.0,1.0,1220,1.0,0,0,1220,0,1955,940000.0
3.0,2.0,1780,1.0,0,0,1780,0,1964,280000.0
3.0,2.5,2180,2.0,0,0,2180,0,2004,450000.0
3.0,2.5,3520,2.5,0,0,3520,0,2004,905000.0
3.0,2.5,2220,2.0,0,0,2220,0,1998,382450.0
3.0,2.0,1610,1.0,0,0,1610,0,1967,246700.0
3.0,1.5,1070,1.0,0,0,1070,0,1956,220000.0
3.0,1.0,1060,1.0,0,0,910,150,1913,555750.0
3.0,1.5,1160,1.0,0,0,1160,0,1962,262500.0
2.0,1.0,910,1.0,0,0,910,0,1949,515000.0
3.0,2.5,2970,2.0,0,0,2970,0,1998,499500.0
1.0,1.0,790,1.0,0,0,790,0,1942,135000.0
2.0,2.0,1540,2.0,0,0,1540,0,1948,462500.0
4.0,2.5,3130,1.0,0,4,2530,600,1956,937500.0
3.0,1.5,1470,1.0,0,0,1280,190,1941,458000.0
4.0,2.75,3160,1.5,0,0,2100,1060,1933,845000.0
3.0,2.25,2675,2.0,0,0,2675,0,1984,660000.0
3.0,2.0,1340,1.0,0,0,1340,0,1987,265000.0
9.0,4.5,3830,2.5,0,0,2450,1380,1938,599999.0
3.0,2.5,1800,2.0,0,0,1800,0,1987,280000.0
3.0,3.25,2990,2.0,0,0,2990,0,1974,1055000.0
4.0,3.0,3720,1.0,0,0,1930,1790,1960,875000.0
3.0,1.0,920,1.0,0,0,920,0,1961,125000.0
4.0,3.0,3280,2.0,0,0,3280,0,2005,634800.0
4.0,1.0,1440,1.0,0,0,1440,0,1964,269950.0
3.0,2.25,1940,1.0,0,0,1100,840,1981,359950.0
3.0,1.75,1590,1.0,0,0,1590,0,1979,417000.0
2.0,2.0,1340,1.0,0,0,1340,0,2007,389000.0
4.0,2.5,3770,2.0,0,2,3770,0,1997,1038000.0
6.0,2.5,2680,1.0,0,0,1340,1340,1967,698000.0
4.0,2.5,2820,2.0,0,0,2820,0,2008,685000.0
3.0,1.75,1520,1.0,0,0,1520,0,1932,198500.0
4.0,2.5,2560,2.0,0,0,2560,0,2012,350000.0
3.0,2.5,3310,1.0,0,0,2160,1150,1919,649950.0
3.0,1.5,1540,1.0,0,0,1540,0,1968,441000.0
3.0,1.75,1430,1.0,0,0,1430,0,1964,462600.0
4.0,2.5,2506,2.0,0,0,2506,0,2006,365070.0
4.0,2.0,2250,1.0,0,0,1200,1050,1956,550000.0
5.0,1.75,2740,1.0,0,0,1370,1370,1945,470000.0
3.0,1.75,1540,1.0,0,0,1540,0,1977,340000.0
4.0,2.75,4190,1.0,0,0,2040,2150,1965,910000.0
4.0,1.75,1690,1.0,0,0,1190,500,1979,405000.0
4.0,2.25,1990,1.5,0,2,1420,570,1932,661000.0
4.0,2.5,2410,2.0,0,0,2410,0,1993,635000.0
2.0,1.0,1150,1.0,0,0,950,200,1948,282000.0
4.0,1.75,1720,2.0,0,0,1720,0,1956,235000.0
3.0,2.0,1260,2.0,0,0,1260,0,1981,277500.0
5.0,2.5,2020,1.0,0,0,1430,590,1978,346500.0
5.0,2.25,2240,1.0,0,0,1490,750,1959,480000.0
4.0,2.25,1930,2.0,0,0,1930,0,1996,360000.0
3.0,2.5,1820,1.0,0,0,1420,400,1994,245000.0
3.0,3.5,1560,2.0,0,0,1240,320,1995,625000.0
5.0,3.0,2170,1.5,0,0,1450,720,1911,750500.0
3.0,1.75,1600,1.0,0,0,1180,420,1977,525000.0
4.0,3.5,3760,2.0,0,0,2950,810,1998,740000.0
3.0,1.5,1240,1.0,0,0,1240,0,1957,523000.0
3.0,1.75,1090,1.5,0,0,1090,0,1929,292000.0
4.0,2.5,2740,1.0,0,2,1820,920,1961,625000.0
3.0,2.5,3110,2.0,0,2,3110,0,2002,700000.0
3.0,2.5,1610,2.0,0,0,1280,330,2007,399950.0
4.0,3.5,1880,3.0,0,0,1650,230,2007,545000.0
4.0,2.0,1740,1.0,0,0,870,870,1954,339999.0
4.0,2.25,3270,2.0,0,0,2180,1090,1909,1210000.0
3.0,2.5,1990,2.0,0,0,1990,0,2003,545000.0
4.0,1.75,1960,1.0,0,0,1960,0,1967,260000.0
3.0,1.75,1680,1.0,0,0,960,720,1992,526000.0
4.0,3.0,2910,2.0,0,0,2910,0,2003,701000.0
3.0,2.25,1500,1.0,0,0,1210,290,1968,290000.0
1.0,1.0,580,1.0,0,0,580,0,1908,330600.0
3.0,1.75,2540,1.0,0,0,1270,1270,1949,550500.0
2.0,1.0,950,1.0,0,0,950,0,1949,430000.0
4.0,5.5,7080,2.0,0,0,5760,1320,2008,4000000.0
2.0,1.0,810,1.0,0,0,810,0,1928,260600.0
5.0,3.0,4080,2.0,0,2,2720,1360,1961,825000.0
4.0,2.0,1820,1.0,0,0,1300,520,1956,378950.0
4.0,2.5,2650,2.0,0,0,2650,0,2000,435000.0
3.0,2.25,1670,2.0,0,0,1250,420,2015,631000.0
3.0,2.5,2480,2.0,0,0,2480,0,1986,415000.0
3.0,1.75,1240,1.0,0,0,1070,170,1967,222000.0
3.0,2.0,1390,1.0,0,0,1390,0,1987,245000.0
3.0,2.5,2880,2.0,0,0,2880,0,1985,720000.0
3.0,1.0,1060,1.0,0,0,1060,0,1960,215000.0
2.0,1.0,1070,1.0,0,0,830,240,1924,579100.0
4.0,1.75,1640,1.5,0,0,870,770,1943,522500.0
3.0,2.0,1510,1.0,0,0,910,600,1972,489000.0
3.0,1.0,1230,1.5,0,0,1230,0,1925,240000.0
3.0,2.0,1510,1.0,0,0,1510,0,2007,420250.0
4.0,2.5,3180,2.0,0,0,2120,1060,1967,523000.0
4.0,2.0,2260,1.0,0,0,1430,830,1958,628000.0
4.0,2.5,1920,2.0,0,0,1920,0,1990,320000.0
3.0,2.5,1980,2.0,0,0,1980,0,1999,359950.0
2.0,1.0,1200,1.0,0,0,1200,0,1958,232000.0
4.0,2.25,2020,1.0,0,2,1210,810,1961,810000.0
4.0,1.5,2010,1.5,0,0,1890,120,1921,245000.0
3.0,2.25,1930,1.0,0,0,1470,460,1984,273000.0
5.0,2.5,2710,1.0,0,0,1720,990,1959,1191000.0
5.0,1.0,1950,1.5,0,0,1450,500,1917,438000.0
3.0,1.75,2110,1.0,0,0,2110,0,1959,400000.0
3.0,1.0,1250,1.0,0,0,1250,0,1951,340000.0
2.0,2.5,1380,3.0,0,0,1380,0,2006,552000.0
3.0,1.75,2050,2.0,0,0,2050,0,1991,790000.0
3.0,1.5,1800,2.0,0,0,1800,0,1931,360000.0
3.0,1.0,1310,1.0,0,0,1310,0,1934,235000.0
2.0,1.0,1010,1.0,0,0,1010,0,1913,775000.0
3.0,2.75,1850,1.5,0,0,1850,0,1965,489200.0
3.0,2.25,1750,2.0,0,0,1750,0,1977,341000.0
4.0,2.5,2154,2.0,0,0,2154,0,2012,335000.0
3.0,1.75,1230,2.0,0,0,1010,220,2004,393500.0
3.0,2.0,1960,1.0,0,3,980,980,1940,360000.0
4.0,1.0,1070,1.0,0,0,870,200,1923,400800.0
3.0,1.0,1450,1.0,0,0,1190,260,1939,585000.0
4.0,2.75,3680,2.0,0,3,2480,1200,1936,1600000.0
4.0,2.5,5760,2.0,0,4,4390,1370,1994,2880500.0
3.0,1.0,1220,1.0,0,0,1220,0,1955,300000.0
4.0,2.75,2950,2.0,0,0,1810,1140,1912,1045000.0
3.0,1.5,1340,2.0,0,0,1040,300,1999,360000.0
4.0,2.25,2870,2.0,0,1,2220,650,1926,665900.0
4.0,1.0,2590,1.5,0,0,2000,590,1911,470000.0
4.0,1.75,2090,1.0,0,0,1070,1020,1963,581000.0
6.0,3.5,3000,1.0,0,0,1500,1500,1979,527000.0
4.0,1.75,1730,1.0,0,0,880,850,1955,423000.0
4.0,3.5,2850,1.5,0,0,2040,810,1926,875000.0
3.0,1.0,1020,1.0,0,0,1020,0,1951,410000.0
3.0,2.5,2200,2.0,0,0,2200,0,1997,606000.0
3.0,2.5,3240,2.0,0,0,3240,0,1997,654000.0
3.0,0.75,490,1.5,0,0,490,0,1959,150000.0
3.0,2.5,2990,1.0,0,0,1550,1440,2003,373000.0
5.0,2.0,2450,1.0,0,0,1240,1210,1900,550000.0
3.0,2.5,1900,2.0,0,0,1900,0,1990,512500.0
4.0,2.5,2640,2.0,0,0,2640,0,2003,360000.0
3.0,2.0,1340,3.0,0,0,1340,0,1997,369000.0
4.0,2.5,3220,2.0,0,0,3220,0,2003,825000.0
3.0,2.0,930,1.0,0,0,930,0,1978,255000.0
4.0,2.5,3240,1.0,0,0,2260,980,1946,1285000.0
5.0,2.5,2630,1.5,0,0,2630,0,1968,270000.0
3.0,2.5,1730,2.0,0,0,1730,0,1996,480680.0
4.0,1.75,2120,1.0,0,0,1220,900,1965,525000.0
3.0,1.0,880,1.5,0,0,880,0,1946,291500.0
4.0,2.0,1800,1.0,0,0,1800,0,1974,305000.0
3.0,1.75,1600,1.0,0,0,1600,0,1998,285000.0
3.0,2.5,3280,2.0,1,3,3280,0,1925,1875000.0
5.0,1.75,3290,1.0,0,0,1790,1500,1968,329500.0
4.0,2.25,2890,3.0,1,4,2890,0,1984,1570000.0
3.0,2.5,1730,1.0,0,0,1330,400,1991,379260.0
3.0,2.5,1590,2.0,0,0,1590,0,2000,356000.0
4.0,1.75,1710,1.0,0,0,1710,0,1956,571900.0
3.0,1.75,1995,2.0,0,0,1995,0,1957,271500.0
3.0,1.75,1300,1.0,0,0,1300,0,1967,390000.0
3.0,2.5,2720,1.0,0,0,2040,680,1985,550000.0
2.0,2.5,1360,2.0,0,0,1360,0,1999,755000.0
2.0,2.5,1590,2.0,0,0,1300,290,1994,509500.0
2.0,1.0,1200,1.0,0,0,1080,120,1942,486700.0
2.0,1.0,1170,1.5,0,0,1170,0,1910,527500.0
5.0,2.5,2010,1.5,0,0,1510,500,1912,475000.0
3.0,2.75,1880,2.0,0,0,1810,70,2001,268000.0
3.0,2.0,3250,2.0,0,0,3250,0,1978,562000.0
4.0,2.5,2270,1.0,0,0,1310,960,1975,780000.0
9.0,3.0,3680,2.0,0,0,2830,850,1908,700000.0
3.0,2.0,1880,1.0,0,0,1040,840,1931,710000.0
3.0,1.0,1050,1.0,0,0,910,140,1947,445000.0
3.0,3.25,2250,1.0,0,0,2250,0,2005,729000.0
3.0,3.25,1689,3.0,0,0,1689,0,2008,384400.0
6.0,3.0,2860,1.0,0,0,1430,1430,1962,815000.0
4.0,2.5,2710,3.0,0,0,2710,0,1990,865000.0
3.0,2.0,1770,1.0,0,0,1770,0,1967,514000.0
4.0,2.75,2820,1.0,0,0,1860,960,1965,615000.0
4.0,3.25,3400,1.0,0,0,2000,1400,1980,865000.0
4.0,2.5,3110,2.0,0,0,3110,0,2004,755000.0
4.0,1.0,1480,1.0,0,0,1080,400,1953,425000.0
2.0,1.0,940,1.0,0,0,940,0,1910,375000.0
4.0,2.5,2680,2.0,0,0,2680,0,2009,750000.0
4.0,2.75,3190,2.0,0,0,3190,0,2005,722000.0
3.0,2.5,1920,2.0,0,1,1920,0,1949,1011000.0
3.0,2.5,2610,2.0,0,0,2610,0,1996,725000.0
3.0,0.75,1040,1.0,0,0,1040,0,1947,170000.0
4.0,3.25,2880,1.0,0,0,2270,610,1982,845000.0
3.0,2.0,1450,2.0,0,0,1450,0,1991,271900.0
6.0,4.5,3902,3.0,0,4,2782,1120,1977,1300000.0
4.0,2.5,2460,1.0,0,0,1500,960,1977,261500.0
3.0,2.5,2170,2.0,0,0,2170,0,2003,619500.0
5.0,2.25,1970,1.0,0,0,1450,520,1986,435000.0
3.0,1.0,1000,1.0,0,0,1000,0,1954,210000.0
3.0,2.0,1580,1.0,0,0,790,790,1909,489950.0
4.0,1.5,2130,1.0,0,0,1100,1030,1962,260000.0
4.0,1.0,1370,1.0,0,0,1370,0,1949,300000.0
4.0,2.0,2150,1.0,0,2,1330,820,1966,530000.0
3.0,1.75,1370,1.0,0,0,1370,0,1977,235000.0
3.0,1.0,1370,2.0,0,0,1370,0,1918,593500.0
3.0,3.0,3290,2.0,0,2,2330,960,1975,562000.0
3.0,2.0,3190,2.0,0,0,3190,0,1994,585000.0
4.0,3.25,4140,1.0,0,1,3300,840,1977,2400000.0
3.0,1.75,1690,1.0,0,0,1690,0,1986,199500.0
5.0,1.0,1690,1.5,0,0,1690,0,1914,544500.0
3.0,1.0,1430,1.0,0,0,1430,0,1962,394900.0
4.0,3.75,1980,2.0,0,0,1980,0,2009,912000.0
3.0,2.5,1490,2.0,0,0,1490,0,1990,260000.0
5.0,3.0,3620,1.0,0,2,1900,1720,1964,858000.0
4.0,2.5,2720,1.0,0,1,1870,850,1963,1275000.0
4.0,1.75,1490,1.0,0,0,1490,0,1970,242150.0
3.0,1.75,1230,1.0,0,0,1230,0,1986,220000.0
3.0,2.0,1900,1.0,0,0,1340,560,1977,235000.0
3.0,1.75,1530,1.0,0,0,1530,0,1978,370000.0
3.0,1.75,2290,1.0,0,0,1390,900,1981,450000.0
5.0,1.5,2240,1.0,0,0,1280,960,1956,534950.0
4.0,2.5,3470,2.0,0,0,3470,0,2005,730000.0
4.0,2.5,3050,1.0,0,0,1550,1500,1983,465000.0
3.0,1.0,1100,1.0,0,0,1100,0,1955,178000.0
3.0,1.0,1610,1.0,0,0,1080,530,1976,215000.0
3.0,2.75,1910,1.0,0,0,1210,700,1984,300000.0
3.0,2.0,1510,1.0,0,2,1230,280,1973,430000.0
3.0,1.5,1280,2.0,0,0,1280,0,1985,183000.0
3.0,2.5,1910,2.5,0,0,1530,380,2007,585000.0
3.0,1.0,1170,2.0,0,0,1170,0,1969,192950.0
2.0,1.0,1550,1.0,0,0,1550,0,1930,599000.0
3.0,1.0,1060,1.0,0,0,1060,0,1968,326500.0
2.0,1.0,1040,1.0,0,0,1040,0,1944,358803.0
3.0,2.5,1550,2.0,0,0,1550,0,1999,537000.0
3.0,2.5,2490,1.0,1,4,1580,910,1961,1155000.0
2.0,1.0,920,1.0,0,0,920,0,1950,156000.0
3.0,1.0,1250,1.5,0,0,1250,0,1939,219000.0
3.0,1.5,2540,2.0,0,0,1630,910,1922,1190000.0
5.0,1.75,2190,1.0,0,2,1380,810,1978,248000.0
3.0,1.75,1340,1.0,0,0,1340,0,1987,340000.0
5.0,2.5,2410,1.0,0,0,1400,1010,1975,899100.0
3.0,1.75,1830,1.0,0,0,1830,0,1963,346950.0
3.0,1.0,1850,2.0,0,0,1740,110,1928,330000.0
3.0,1.0,1410,1.0,0,0,1410,0,1954,325000.0
3.0,1.75,1460,1.0,0,0,1460,0,1975,315000.0
3.0,2.5,1500,2.0,0,0,1200,300,2014,649950.0
3.0,1.0,1130,1.5,0,0,1130,0,1942,316000.0
2.0,2.5,1620,2.0,0,0,1620,0,2008,386000.0
2.0,1.75,2330,1.0,0,0,1450,880,1982,535000.0
3.0,3.0,1520,3.0,0,0,1520,0,2003,600000.0
4.0,2.5,2840,2.0,0,0,2840,0,2001,339000.0
3.0,2.0,1520,1.0,0,0,1520,0,1949,167000.0
3.0,1.0,1740,1.0,0,0,1740,0,1952,430000.0
4.0,4.0,4000,2.0,0,0,4000,0,2007,688000.0
3.0,2.25,2780,1.0,0,3,1670,1110,1948,834500.0
4.0,4.25,3500,1.0,0,4,2140,1360,1951,1075000.0
3.0,1.0,1060,1.0,0,0,1060,0,1960,250000.0
3.0,1.0,1290,1.5,0,0,1290,0,1926,402500.0
3.0,2.5,2390,1.0,0,0,1600,790,1978,432500.0
5.0,1.75,2460,1.0,0,0,1380,1080,1972,485000.0
4.0,2.75,2930,1.0,0,3,1580,1350,1978,560000.0
4.0,2.25,2200,2.0,0,0,2200,0,1990,410000.0
3.0,2.5,1870,1.0,0,0,1470,400,1980,455000.0
4.0,2.5,2060,1.0,0,0,1190,870,1975,459500.0
4.0,1.75,1610,1.0,0,0,1610,0,1968,371000.0
3.0,2.25,2120,2.0,0,0,2120,0,2002,289500.0
3.0,3.5,1450,2.0,0,0,1160,290,2007,395000.0
2.0,1.0,1980,1.0,0,0,1090,890,1923,496752.0
2.0,1.0,860,1.0,0,0,860,0,1943,227000.0
3.0,1.75,1460,1.0,0,0,1460,0,1985,330000.0
5.0,2.0,2590,1.0,0,0,1340,1250,1958,480000.0
2.0,1.0,1120,1.0,0,0,1120,0,1976,290000.0
3.0,1.0,1340,1.5,0,0,1340,0,1945,281000.0
4.0,1.5,1780,1.5,0,3,1780,0,1926,705000.0
4.0,2.5,2920,1.5,0,0,1910,1010,1909,1400000.0
4.0,3.25,2820,1.0,0,0,1410,1410,1958,485000.0
3.0,2.25,1550,3.0,0,0,1550,0,2003,622000.0
3.0,2.25,1600,1.0,0,3,1600,0,1958,380000.0
4.0,2.75,3190,2.0,0,4,3190,0,1982,2125000.0
3.0,1.75,1960,1.0,0,0,980,980,1939,561500.0
3.0,1.0,970,1.0,0,0,970,0,1972,242000.0
3.0,1.5,1360,1.0,0,0,1360,0,1966,348500.0
3.0,1.5,1360,1.0,0,0,1360,0,1966,370000.0
6.0,3.75,3810,2.0,0,0,3810,0,1977,752000.0
3.0,1.75,1340,1.0,0,0,1100,240,1985,230000.0
3.0,2.25,1990,3.0,0,0,1990,0,2012,715000.0
3.0,1.75,1120,1.0,0,0,1120,0,1968,240415.0
4.0,1.75,2060,1.5,0,0,1460,600,1922,562000.0
3.0,1.5,1170,1.0,0,0,1170,0,1917,360000.0
3.0,2.5,1610,2.0,0,1,1080,530,2014,659950.0
3.0,2.0,1890,2.0,0,0,1430,460,2012,458500.0
2.0,2.0,1070,2.0,0,0,720,350,2008,259950.0
3.0,1.75,1680,1.0,0,0,1680,0,1989,366000.0
4.0,2.75,2890,2.0,0,0,2890,0,2014,978000.0
2.0,1.0,1360,1.0,0,0,1060,300,1947,525000.0
3.0,1.5,1660,2.0,0,0,1660,0,1907,926300.0
2.0,1.0,1620,1.0,0,0,1620,0,1951,750000.0
2.0,1.0,960,1.0,0,1,960,0,1942,660000.0
4.0,1.75,1000,1.5,0,0,1000,0,1947,305000.0
2.0,2.5,2395,1.0,0,0,2395,0,2003,800000.0
4.0,1.75,3050,1.0,0,0,1800,1250,1966,600000.0
2.0,1.0,1120,1.5,0,0,1120,0,1972,435000.0
4.0,3.25,2960,2.0,0,0,2190,770,2007,1135000.0
3.0,2.25,1250,3.0,0,0,1250,0,2008,318000.0
4.0,2.0,1940,1.0,0,0,980,960,1910,639000.0
3.0,2.5,1750,2.0,0,0,1750,0,1977,453000.0
4.0,1.75,2150,1.0,0,0,2150,0,1955,800000.0
2.0,1.75,1500,1.0,0,0,910,590,1942,437000.0
3.0,2.75,3230,2.0,1,4,3230,0,1925,1150000.0
4.0,2.5,3000,2.0,0,0,3000,0,1985,490000.0
4.0,1.75,1520,1.0,0,0,1520,0,1967,499950.0
3.0,1.5,1190,1.0,0,0,1190,0,1968,160134.0
3.0,1.0,990,1.0,0,0,990,0,1953,191000.0
3.0,1.0,1250,1.0,0,0,1250,0,1965,221000.0
4.0,2.0,2080,1.0,0,0,1330,750,1960,352800.0
3.0,2.5,1640,2.0,0,0,1640,0,1988,350000.0
4.0,1.5,1550,1.5,0,0,1350,200,1918,458000.0
3.0,1.0,1290,1.0,0,0,1290,0,1960,359950.0
3.0,3.0,3250,2.0,0,3,3250,0,2004,1050000.0
3.0,1.75,1260,1.0,0,0,1260,0,1942,353000.0
3.0,3.5,2840,3.0,0,0,2840,0,2006,717550.0
3.0,2.25,1960,2.0,0,0,1960,0,1977,450000.0
3.0,1.0,760,1.0,0,0,760,0,1903,167500.0
3.0,1.75,2240,2.0,0,0,2240,0,1976,550000.0
4.0,2.25,2240,2.0,0,0,2240,0,1970,939000.0
3.0,1.75,1820,1.0,0,2,1820,0,1948,700000.0
4.0,3.5,3370,2.0,0,3,3370,0,2005,480000.0
3.0,1.0,1160,1.0,0,0,1160,0,1929,501000.0
3.0,2.25,1640,1.0,0,0,1320,320,1987,580000.0
1.0,0.75,820,1.0,0,0,820,0,1999,527550.0
4.0,2.5,2800,2.0,0,0,2800,0,2005,399000.0
3.0,1.75,1780,1.5,0,0,1080,700,1957,240000.0
4.0,2.75,2200,1.0,0,0,1410,790,1989,353000.0
4.0,2.0,1480,1.0,0,0,740,740,1910,335000.0
3.0,3.0,2010,2.0,0,0,1860,150,2001,475000.0
3.0,2.0,2880,1.5,0,0,2080,800,1926,660000.0
3.0,1.0,940,1.0,0,0,940,0,1900,551000.0
4.0,1.75,1620,1.0,0,0,1620,0,1968,249950.0
4.0,3.25,4400,2.0,0,0,4400,0,1988,1150000.0
3.0,1.75,1530,1.0,0,0,1410,120,1955,575000.0
4.0,2.75,3460,1.0,0,4,1780,1680,1974,1088890.0
4.0,2.5,2890,2.0,0,0,2890,0,2006,515000.0
3.0,1.5,1980,1.0,0,0,1980,0,1959,235000.0
3.0,1.0,1980,1.5,0,0,1980,0,1912,796000.0
2.0,1.5,1450,1.0,0,0,820,630,1984,450000.0
4.0,3.0,4280,1.0,0,4,2180,2100,1971,2050000.0
4.0,2.5,1810,2.0,0,0,1810,0,1994,270000.0
3.0,3.0,2490,2.0,1,4,2490,0,2000,1705000.0
3.0,1.0,1610,1.5,0,0,1610,0,1928,565000.0
1.0,2.5,1820,2.0,0,0,1090,730,1910,680000.0
5.0,5.75,9200,2.0,0,0,6200,3000,2001,5570000.0
4.0,2.5,3520,2.0,0,0,3520,0,1992,864500.0
4.0,2.25,3740,1.0,0,0,1870,1870,1951,1150000.0
3.0,2.25,2150,2.0,0,0,2150,0,1991,335000.0
4.0,3.25,3526,2.0,0,0,3526,0,1997,911000.0
2.0,1.0,1070,1.0,0,0,830,240,1950,425000.0
3.0,1.0,1410,1.0,0,0,1410,0,1949,299950.0
4.0,2.5,3190,2.0,0,0,3190,0,1999,864000.0
2.0,1.0,1270,1.0,0,0,1270,0,1939,425000.0
4.0,1.5,1970,1.5,0,0,1970,0,1963,374950.0
3.0,2.25,1640,1.0,0,0,1180,460,1968,247000.0
3.0,1.0,1600,1.0,0,0,1600,0,1953,475000.0
3.0,2.5,3020,2.0,0,0,3020,0,2003,275000.0
2.0,1.0,1350,1.0,0,0,1350,0,1947,355000.0
4.0,1.75,1870,1.0,0,0,1070,800,1959,285000.0
3.0,2.75,2730,1.5,1,4,1940,790,1963,1338750.0
2.0,1.0,1100,1.0,0,0,620,480,1980,325000.0
5.0,3.5,4320,2.0,0,0,4320,0,1997,1670000.0
3.0,2.5,2700,1.0,0,3,1350,1350,1959,402000.0
3.0,3.0,3700,1.0,0,0,2170,1530,2000,1100000.0
4.0,1.75,2190,1.0,0,0,1250,940,1959,375000.0
5.0,2.75,2840,1.0,0,0,1420,1420,1960,396000.0
4.0,2.75,2610,1.0,0,0,1310,1300,1987,320000.0
3.0,2.5,2630,2.0,0,0,2630,0,2001,610000.0
3.0,1.5,1090,1.0,0,0,1090,0,1966,249950.0
4.0,3.5,3090,2.0,0,0,3090,0,1999,675000.0
2.0,2.0,1670,1.0,0,0,860,810,1919,448000.0
3.0,1.0,1300,2.0,0,0,1300,0,1900,819000.0
3.0,2.5,3670,1.0,0,4,2530,1140,1983,1250000.0
4.0,2.5,1700,2.0,0,0,1700,0,1994,225000.0
2.0,3.0,2560,1.0,0,0,2560,0,2004,790000.0
4.0,2.5,2770,2.0,0,0,2400,370,1993,685000.0
3.0,3.25,3240,2.0,0,0,3240,0,2001,812000.0
2.0,2.5,2300,1.0,0,0,2300,0,2007,705000.0
4.0,3.0,2483,2.0,0,0,2483,0,2005,360000.0
1.0,1.5,760,3.0,0,0,760,0,2006,344000.0
4.0,1.5,2040,2.0,0,0,2040,0,1903,825000.0
3.0,1.0,1200,1.0,0,0,950,250,1945,476500.0
2.0,1.0,960,1.0,0,0,960,0,1949,379500.0
3.0,1.75,2410,1.0,0,0,2410,0,1980,620000.0
3.0,3.25,2260,2.0,0,0,1760,500,2000,477590.0
3.0,1.0,1910,1.0,0,0,1010,900,1946,490000.0
3.0,1.5,1500,1.5,0,0,1140,360,1927,470000.0
3.0,2.25,1360,2.0,0,0,1140,220,2006,500000.0
3.0,1.0,1320,1.0,0,0,1320,0,1982,370000.0
2.0,1.5,1940,1.0,0,0,970,970,1923,790000.0
4.0,2.5,2650,2.0,0,0,2650,0,1986,725000.0
4.0,2.75,3040,2.0,0,0,2100,940,1906,840000.0
3.0,1.0,1240,1.0,0,0,1240,0,1952,390000.0
3.0,2.25,2210,1.0,0,0,1510,700,1958,507000.0
3.0,1.75,1540,1.0,0,0,770,770,1951,263500.0
3.0,2.5,1320,2.0,0,0,1270,50,2004,369000.0
3.0,2.5,3040,2.0,0,0,3040,0,2008,500000.0
2.0,1.0,910,1.0,0,0,910,0,1923,570000.0
4.0,3.0,2040,1.0,0,0,1490,550,1994,284000.0
2.0,1.0,980,1.0,0,0,980,0,1947,415000.0
3.0,1.0,980,1.5,0,0,980,0,1903,197500.0
4.0,3.75,4420,2.0,0,1,3420,1000,1962,925000.0
3.0,2.0,1570,1.0,0,0,820,750,1953,468000.0
3.0,1.0,1600,1.5,0,0,1080,520,1930,355000.0
4.0,1.75,1830,1.0,0,0,930,900,1939,639000.0
3.0,2.5,2820,2.0,0,0,2820,0,1991,720000.0
3.0,1.75,1800,1.0,0,0,900,900,1950,381000.0
3.0,4.0,4380,2.0,0,0,4380,0,1983,1050000.0
3.0,3.0,2980,2.0,0,0,2980,0,2005,670000.0
3.0,1.0,1690,1.0,0,0,1690,0,1942,400000.0
4.0,3.5,4040,2.0,0,0,4040,0,1987,910000.0
3.0,1.0,1250,1.0,0,0,1250,0,1931,294000.0
3.0,1.75,1500,1.0,0,0,1500,0,1968,315001.0
3.0,2.0,1630,1.0,0,0,1630,0,1959,360000.0
3.0,2.0,1410,2.0,0,0,1410,0,1902,520000.0
3.0,1.0,1140,1.0,0,0,770,370,1944,474000.0
4.0,2.5,3280,2.0,0,0,3280,0,2004,702000.0
4.0,3.5,3490,2.0,0,0,3490,0,2001,728000.0
4.0,2.5,2020,2.0,0,0,2020,0,1993,308000.0
5.0,4.0,4580,3.0,1,4,4580,0,2004,2000000.0
3.0,2.5,2270,2.0,0,0,2270,0,1986,340000.0
2.0,1.75,1310,1.0,0,0,1310,0,1947,306500.0
3.0,2.0,1420,1.5,0,0,1420,0,1904,716000.0
4.0,3.0,2980,2.0,0,0,2640,340,1981,950000.0
5.0,3.0,4180,2.0,0,0,4180,0,2003,673200.0
4.0,2.25,1950,1.0,0,0,1350,600,1961,564500.0
4.0,1.75,1790,1.0,0,0,1790,0,1974,393000.0
5.0,1.75,1400,1.0,0,0,1400,0,1916,425000.0
3.0,1.0,1320,1.0,0,0,1320,0,1979,150000.0
4.0,2.25,1620,1.0,0,0,1200,420,1980,327000.0
4.0,2.5,3120,2.0,0,0,3120,0,1998,444900.0
4.0,2.5,2100,2.0,0,0,2100,0,1998,305000.0
3.0,3.25,1370,3.0,0,0,1370,0,2004,469000.0
3.0,1.75,1520,1.0,0,0,1520,0,1969,525000.0
3.0,2.5,2410,1.0,0,0,1630,780,1978,330000.0
4.0,1.0,1260,1.0,0,0,1260,0,1911,618000.0
4.0,2.5,2830,1.0,0,0,1690,1140,1982,295500.0
3.0,2.0,2064,2.0,0,0,2064,0,1903,567035.0
4.0,2.25,2640,1.0,0,0,1770,870,1977,518000.0
2.0,1.0,1020,1.0,0,0,1020,0,1978,303000.0
4.0,2.5,2200,2.0,0,0,2200,0,1998,300000.0
3.0,1.5,1420,1.0,0,0,1420,0,1956,413107.0
3.0,1.0,1350,1.5,0,0,1350,0,1914,400000.0
3.0,1.0,1290,1.0,0,0,1290,0,1941,535000.0
4.0,2.0,1680,1.0,0,0,840,840,1915,555000.0
3.0,2.5,2280,2.0,0,0,2280,0,2008,312000.0
3.0,2.25,1840,1.5,0,0,1540,300,1910,785200.0
4.0,2.0,2040,1.0,0,2,1020,1020,1959,749000.0
3.0,1.5,1490,1.0,0,0,1010,480,1957,285000.0
4.0,2.5,2440,2.0,0,0,2440,0,2007,425000.0
3.0,2.0,1930,1.0,0,0,1260,670,1958,360000.0
3.0,1.0,1200,1.0,0,0,1200,0,1954,260000.0
3.0,2.0,1550,1.0,0,0,1150,400,1959,369000.0
4.0,2.5,2180,1.0,0,0,1620,560,1978,275000.0
3.0,2.25,1430,3.0,0,0,1430,0,2005,407000.0
2.0,1.75,1230,1.0,0,0,990,240,1949,575000.0
3.0,1.5,1670,2.0,0,3,1670,0,1928,1236000.0
2.0,2.5,2720,1.0,0,1,1700,1020,1936,875000.0
4.0,1.5,2220,1.0,0,0,1270,950,1961,320000.0
3.0,1.5,1520,1.0,0,0,1520,0,1954,810000.0
3.0,1.75,1590,1.0,0,0,1090,500,1984,274000.0
4.0,1.75,1480,1.0,0,0,1120,360,1959,239900.0
4.0,1.5,1860,1.0,0,0,1080,780,1953,450000.0
4.0,2.0,1360,1.0,0,0,960,400,1960,263400.0
3.0,1.0,1360,1.0,0,0,1360,0,1954,265000.0
4.0,3.0,2360,1.0,0,2,1460,900,1960,418000.0
3.0,2.0,2360,2.0,0,0,2360,0,2003,390000.0
3.0,2.0,1860,1.0,0,0,930,930,1909,430000.0
3.0,2.25,2630,2.5,0,2,2630,0,1987,1442500.0
2.0,1.75,1280,1.0,0,0,1280,0,1996,297000.0
4.0,2.25,2330,2.0,0,1,1600,730,1988,650000.0
2.0,1.0,720,1.0,0,0,720,0,1950,195000.0
3.0,3.5,3380,2.0,0,0,2700,680,1999,554000.0
3.0,2.0,3650,2.0,0,0,3650,0,1991,550000.0
3.0,1.75,1640,1.5,0,0,1640,0,1951,700000.0
4.0,1.0,1730,1.5,0,0,1730,0,1948,300000.0
2.0,1.0,1030,1.5,0,0,1030,0,1952,315000.0
3.0,1.0,1790,1.0,0,0,1400,390,1943,603000.0
2.0,1.0,840,1.0,0,2,840,0,1924,530000.0
3.0,1.75,1300,1.0,0,0,1300,0,1969,397500.0
3.0,1.0,1240,1.5,0,0,1240,0,1904,221000.0
4.0,2.25,2170,1.0,0,0,1220,950,1976,466000.0
3.0,1.0,1330,2.0,0,0,1330,0,1905,197500.0
3.0,3.0,1390,2.0,0,0,1140,250,2006,280000.0
2.0,1.5,1240,1.0,0,0,860,380,1909,412000.0
2.0,1.0,880,1.0,0,0,880,0,1950,454000.0
4.0,2.25,2540,1.0,0,0,1450,1090,1990,540000.0
5.0,1.5,2520,1.5,0,0,1510,1010,1928,250000.0
5.0,2.25,2510,1.0,0,0,2510,0,1967,900000.0
5.0,1.75,2020,1.0,0,0,1220,800,1962,245000.0
3.0,1.75,2060,1.0,0,0,1350,710,1987,290000.0
2.0,1.0,930,1.0,0,0,930,0,1933,160000.0
2.0,1.5,2700,1.5,0,4,1660,1040,1910,1260000.0
2.0,1.0,1060,1.0,0,0,940,120,1939,325000.0
2.0,1.0,670,1.0,0,0,670,0,1947,185000.0
3.0,2.0,1750,1.0,0,0,950,800,1916,477000.0
2.0,1.0,930,1.0,0,0,930,0,1942,100000.0
4.0,2.5,2420,1.0,0,0,1370,1050,1985,345000.0
4.0,2.25,2410,1.0,0,1,1950,460,1965,530000.0
3.0,1.0,1150,1.0,0,0,1150,0,1953,203000.0
4.0,2.5,2480,2.0,0,0,2480,0,2004,599000.0
4.0,1.0,1310,1.5,0,0,1310,0,1940,370000.0
3.0,1.0,1240,1.0,0,0,1040,200,1954,140000.0
3.0,1.0,1150,2.0,0,0,1150,0,1911,500000.0
3.0,1.75,1460,1.0,0,2,730,730,1929,527200.0
5.0,2.75,3060,1.0,0,0,1600,1460,1979,549900.0
4.0,2.5,3520,2.0,0,0,3520,0,2006,760000.0
2.0,1.0,960,1.0,0,0,960,0,1951,319000.0
3.0,2.5,2430,2.0,0,0,2430,0,1997,362300.0
3.0,2.5,1930,1.0,0,3,1440,490,1973,421000.0
3.0,1.0,1090,1.5,0,0,1090,0,1945,690000.0
3.0,2.5,2790,1.0,0,0,1650,1140,1953,640000.0
4.0,1.75,1650,1.0,0,0,910,740,1978,238000.0
3.0,3.0,3740,2.0,0,2,3740,0,1991,789000.0
6.0,4.0,5310,2.0,0,2,3600,1710,1967,1050000.0
3.0,2.5,1690,2.0,0,0,1690,0,2008,302500.0
4.0,1.75,1400,1.0,0,0,1400,0,1963,259950.0
3.0,1.5,1440,1.0,0,0,1440,0,1975,456000.0
3.0,2.5,1360,2.0,0,0,1360,0,1987,369950.0
3.0,1.75,1726,2.0,0,0,1726,0,1982,363750.0
3.0,1.75,2220,1.0,0,2,2220,0,1989,585000.0
3.0,2.5,1850,2.0,0,0,1850,0,1986,268000.0
5.0,2.5,2860,2.0,0,0,2160,700,1910,1200000.0
3.0,1.0,1120,1.0,0,0,920,200,1905,345000.0
4.0,2.5,2340,2.0,0,0,2340,0,1993,539000.0
5.0,3.25,3760,2.0,0,0,2550,1210,1984,851000.0
3.0,2.5,1920,2.0,0,2,1780,140,1997,900000.0
3.0,2.5,3230,2.0,0,2,2430,800,1945,850000.0
3.0,1.75,1260,1.0,0,0,1260,0,1966,390000.0
3.0,1.75,1540,1.0,0,0,920,620,1955,345000.0
3.0,2.5,1700,2.0,0,0,1700,0,2005,534500.0
6.0,5.25,3600,2.0,0,0,2400,1200,1971,643500.0
3.0,2.75,3150,1.5,0,0,2130,1020,1925,1206500.0
2.0,1.75,1280,1.0,0,0,730,550,1929,495000.0
2.0,1.0,980,1.0,0,0,830,150,1950,535000.0
4.0,2.5,2190,2.0,0,0,2190,0,2004,435000.0
4.0,2.0,2470,2.0,0,0,1970,500,2009,305000.0
4.0,2.5,2590,2.0,0,0,2590,0,2001,799000.0
4.0,2.5,2580,2.0,0,0,2580,0,1999,700000.0
3.0,2.25,1270,2.0,0,0,1040,230,2005,467000.0
3.0,1.0,1250,1.0,0,0,1250,0,1959,263000.0
4.0,2.5,4660,2.0,0,0,3020,1640,2003,760000.0
4.0,2.5,2019,2.0,0,3,2019,0,2008,293000.0
3.0,2.0,1490,1.0,0,0,1490,0,1989,245000.0
2.0,1.5,1560,1.0,0,0,1560,0,1949,181000.0
3.0,1.0,1030,1.0,0,0,1030,0,1962,240000.0
4.0,2.75,2560,1.0,0,2,1450,1110,1975,880000.0
3.0,2.0,1460,1.0,0,0,1460,0,1995,285000.0
2.0,1.0,770,1.0,0,0,770,0,1950,407500.0
4.0,2.5,1960,2.0,0,0,1960,0,2004,325000.0
3.0,1.75,1900,1.0,0,0,1390,510,1978,405000.0
3.0,2.5,1970,1.5,0,0,1230,740,1927,291700.0
3.0,2.5,2490,2.0,0,3,2490,0,1995,370000.0
3.0,1.5,1430,1.0,0,0,1430,0,1953,270000.0
4.0,2.5,2680,1.0,0,0,1380,1300,1952,800000.0
3.0,1.75,1610,1.0,0,0,910,700,1928,626500.0
4.0,3.5,4300,2.0,0,1,3580,720,1987,1130000.0
4.0,2.5,3200,2.0,0,0,3200,0,2003,399950.0
3.0,1.75,2140,1.0,0,0,1570,570,1958,419000.0
4.0,2.5,4240,2.0,0,0,4240,0,1989,1160000.0
4.0,3.5,3410,2.0,0,0,3410,0,2008,1405000.0
4.0,2.75,2090,2.0,0,0,2090,0,1967,710000.0
3.0,1.0,1410,1.0,0,2,1230,180,1942,650000.0
4.0,2.5,2820,2.0,0,0,2820,0,1984,369900.0
4.0,2.5,2770,2.0,0,0,2770,0,1997,641000.0
3.0,1.0,1400,1.0,0,0,1400,0,1951,403000.0
3.0,3.25,3620,2.0,0,0,2730,890,2005,1015000.0
4.0,2.5,2260,1.0,0,0,1770,490,1974,865000.0
4.0,2.5,3440,1.5,1,3,2260,1180,1931,2485000.0
4.0,1.0,2150,2.0,0,3,1850,300,1926,810000.0
3.0,2.5,1256,3.0,0,0,1256,0,2005,316750.0
4.0,2.25,2220,2.0,0,0,2220,0,1989,652500.0
6.0,2.75,2850,1.0,0,0,1850,1000,1962,360000.0
2.0,1.0,700,1.0,0,0,700,0,1953,208000.0
4.0,2.5,3700,2.0,0,0,3700,0,1992,898000.0
4.0,1.75,1400,1.0,0,0,1050,350,1961,295000.0
4.0,1.75,3130,2.0,0,0,3130,0,1978,652500.0
4.0,3.0,2170,2.0,0,0,2170,0,1992,560000.0
3.0,1.0,1020,1.0,0,0,1020,0,1957,280000.0
3.0,2.5,1760,1.5,0,0,1760,0,1937,289950.0
3.0,2.5,1860,1.0,0,0,1860,0,1978,397500.0
2.0,1.0,1140,1.0,0,0,1140,0,1956,380000.0
3.0,2.5,1670,1.0,0,0,1310,360,1988,415900.0
2.0,1.75,1710,1.0,0,0,1510,200,1923,475000.0
1.0,1.0,500,1.0,0,0,500,0,1928,125000.0
3.0,1.0,1470,1.0,0,0,1020,450,1958,238000.0
4.0,1.5,1370,1.0,0,0,1070,300,1953,296000.0
6.0,3.0,3470,1.5,0,0,3470,0,1924,475000.0
3.0,2.25,1650,1.5,0,0,1650,0,1910,390000.0
3.0,1.0,1180,1.0,0,0,1030,150,1940,425000.0
6.0,3.0,3110,1.5,0,0,1810,1300,1921,725000.0
3.0,2.25,2080,1.0,0,0,1530,550,1973,605000.0
3.0,1.0,1600,2.0,0,0,1600,0,1906,302000.0
3.0,2.25,2380,2.0,0,0,1650,730,1931,886000.0
4.0,1.75,1630,1.0,0,0,980,650,1918,540000.0
4.0,2.25,1910,2.0,0,0,1910,0,1975,435000.0
4.0,3.25,3140,2.0,0,0,2300,840,1992,409000.0
3.0,1.0,1250,1.0,0,0,1250,0,1975,405000.0
3.0,2.5,1990,2.0,0,0,1990,0,2004,560200.0
4.0,1.75,2110,1.0,0,0,1170,940,1975,324000.0
4.0,2.5,2490,2.0,0,0,2490,0,1999,390000.0
2.0,1.0,800,1.0,0,0,800,0,1938,414000.0
3.0,2.5,2360,2.0,0,0,2360,0,1998,441500.0
3.0,2.5,1770,2.0,0,0,1770,0,1992,375000.0
4.0,2.5,2710,2.0,0,0,2710,0,1999,668500.0
5.0,1.5,1940,1.5,0,0,1940,0,1940,540000.0
4.0,3.25,3450,2.0,0,3,2430,1020,1960,1035000.0
4.0,3.25,3440,2.0,0,4,2520,920,2014,1345000.0
4.0,2.75,2410,1.0,0,0,1780,630,1956,758000.0
4.0,2.25,2290,2.0,0,0,2290,0,1978,949880.0
3.0,1.0,1030,1.5,0,0,1030,0,1927,570000.0
4.0,2.5,2290,2.0,0,0,2290,0,1988,736000.0
3.0,1.5,1490,1.5,0,0,1490,0,1906,670000.0
4.0,1.75,2370,1.0,0,0,1270,1100,1949,1130000.0
4.0,2.0,1930,1.5,0,0,1930,0,1914,650000.0
2.0,1.75,1600,1.0,0,0,850,750,1918,690000.0
4.0,2.25,2240,2.0,0,0,2240,0,1988,610000.0
2.0,1.0,770,1.0,0,0,770,0,1924,413500.0
3.0,2.5,2300,2.0,0,2,2300,0,1968,765000.0
4.0,2.75,3400,2.0,0,0,3400,0,2001,828200.0
2.0,1.0,900,1.0,0,0,900,0,1918,205000.0
3.0,2.5,1450,1.0,0,0,1030,420,1995,465000.0
4.0,2.5,2240,2.0,0,0,2240,0,2005,556000.0
4.0,2.5,1780,2.0,0,0,1780,0,1994,540000.0
4.0,2.5,2320,2.0,0,0,2320,0,2004,423000.0
3.0,1.75,1590,1.0,0,0,1590,0,1963,375000.0
3.0,1.0,990,1.5,0,0,990,0,1936,173250.0
3.0,1.5,2605,1.0,0,0,1355,1250,2003,599900.0
5.0,2.75,2870,1.0,0,0,1650,1220,1976,646000.0
5.0,4.75,5180,2.0,0,2,4070,1110,2001,1075000.0
4.0,2.0,2180,1.0,0,0,1020,1160,1900,558000.0
2.0,1.0,850,1.0,0,0,850,0,1949,354000.0
4.0,4.0,4050,2.0,0,0,3360,690,1990,1195000.0
4.0,2.0,2250,1.5,0,0,1650,600,1909,670000.0
6.0,4.25,3100,3.0,0,2,3100,0,1978,1125000.0
2.0,1.0,1747,2.5,0,0,1747,0,1948,267500.0
4.0,2.5,2410,2.0,0,0,2410,0,2002,299800.0
4.0,1.75,2070,1.0,0,0,1250,820,1958,430000.0
5.0,1.0,1860,1.5,0,0,1530,330,1921,775000.0
3.0,1.0,950,1.0,0,0,830,120,1944,333000.0
3.0,2.0,1060,1.0,0,0,1060,0,1951,336000.0
2.0,1.0,880,2.0,0,0,880,0,1945,323000.0
4.0,2.5,2550,2.0,0,0,2550,0,2001,575000.0
2.0,2.25,1550,2.0,0,0,1550,0,2008,328000.0
3.0,1.0,1590,1.5,0,0,1290,300,1926,572500.0
3.0,1.75,1650,1.0,0,0,1040,610,1908,600000.0
4.0,3.0,2430,2.0,0,0,2430,0,2003,412000.0
3.0,2.5,1810,1.0,0,0,1310,500,1960,827500.0
4.0,2.5,2890,2.0,0,0,2890,0,1994,300000.0
3.0,2.5,1280,2.0,0,0,1280,0,1985,415000.0
7.0,2.75,3410,1.5,0,0,2130,1280,1906,750000.0
3.0,2.75,2220,2.0,0,0,1700,520,1914,800000.0
3.0,1.0,1060,1.0,0,0,1060,0,1954,420000.0
3.0,1.5,1120,1.0,0,0,1120,0,1957,266000.0
4.0,2.5,2680,2.0,0,0,2680,0,2004,499000.0
4.0,1.5,1770,2.0,0,0,1770,0,1947,440000.0
3.0,2.0,2950,2.0,0,0,2310,640,1918,495000.0
2.0,1.75,1260,1.0,0,0,840,420,1951,630000.0
3.0,1.75,1430,1.0,0,0,1430,0,1972,424000.0
4.0,2.5,2730,2.0,0,0,2730,0,1986,760000.0
4.0,3.5,3270,2.0,0,0,2110,1160,1990,650000.0
4.0,1.75,1720,1.0,0,0,1720,0,1960,248500.0
3.0,1.75,1270,1.0,0,0,1270,0,1962,379600.0
4.0,2.5,3260,1.0,0,0,1960,1300,1978,538000.0
4.0,2.5,2050,2.0,0,0,2050,0,1988,530000.0
4.0,2.25,2050,2.0,0,0,2050,0,1967,545000.0
4.0,3.0,3580,1.5,0,0,3580,0,1985,925000.0
4.0,2.75,1960,1.5,0,0,1960,0,1983,565000.0
2.0,1.0,840,1.0,0,0,840,0,1947,405100.0
3.0,1.75,1300,1.0,0,0,1300,0,1963,502000.0
3.0,2.25,1260,2.0,0,0,1260,0,2003,425000.0
3.0,2.25,1650,2.0,0,0,1650,0,1985,233500.0
3.0,2.5,1710,2.0,0,2,1710,0,1986,287000.0
3.0,1.0,1180,1.0,0,0,1180,0,1966,190000.0
3.0,2.25,2780,2.0,0,0,2780,0,1979,666000.0
2.0,1.0,950,1.0,0,0,950,0,1909,330000.0
5.0,3.5,3620,2.0,0,2,2790,830,1958,1490000.0
3.0,2.25,2140,2.0,0,0,2140,0,1987,393000.0
4.0,2.75,1920,1.0,0,0,1010,910,1998,353000.0
2.0,1.0,750,1.0,0,0,750,0,1916,260000.0
3.0,2.5,2060,2.0,0,0,1900,160,2001,680000.0
3.0,2.25,2380,1.0,0,0,2380,0,1963,921000.0
2.0,1.0,750,1.0,0,0,750,0,1949,319000.0
3.0,1.0,1160,1.0,0,0,920,240,1983,280000.0
3.0,1.0,1050,1.0,0,0,1050,0,1942,220000.0
3.0,1.5,1740,1.0,0,0,1060,680,1977,219000.0
4.0,2.75,2050,1.0,0,0,1540,510,1988,528000.0
3.0,1.75,1980,1.0,0,0,1310,670,1949,405000.0
3.0,2.5,1690,2.0,0,0,1150,540,2014,372977.0
4.0,3.25,2320,1.5,0,2,2320,0,1910,934550.0
3.0,1.5,2480,2.0,0,3,2130,350,1940,1465000.0
4.0,2.25,2290,2.0,0,0,2120,170,1958,975000.0
5.0,2.5,3180,2.0,0,0,3180,0,1990,800866.0
7.0,3.5,3470,2.0,0,0,3470,0,1980,950000.0
4.0,3.0,1540,1.5,0,0,1540,0,1902,624000.0
5.0,2.25,2800,2.0,1,4,2800,0,1963,1850000.0
3.0,1.0,1050,1.0,0,0,1050,0,1953,310000.0
3.0,1.75,1480,1.0,0,0,1480,0,1968,315000.0
3.0,2.0,1010,1.0,0,0,1010,0,1942,675000.0
3.0,1.75,1660,1.0,0,0,1660,0,1965,490000.0
5.0,2.25,2760,1.0,0,0,1380,1380,1958,600000.0
2.0,1.0,1040,1.0,0,3,1040,0,1949,154000.0
4.0,1.75,2220,2.0,0,3,2220,0,1964,480000.0
3.0,1.0,1270,1.0,0,0,1270,0,1954,196900.0
3.0,3.25,2960,2.0,0,0,2960,0,1989,735000.0
3.0,2.0,1330,1.0,0,0,1330,0,1986,205500.0
2.0,1.75,1210,2.0,0,0,1210,0,2014,357186.0
4.0,2.5,2120,2.0,0,0,2120,0,1998,275000.0
3.0,1.75,2090,1.0,0,0,2090,0,1948,248500.0
3.0,2.5,2680,2.0,0,0,2680,0,1990,350000.0
4.0,2.75,1790,1.0,0,0,1220,570,1987,390000.0
3.0,2.75,1950,1.0,0,0,1250,700,1956,390000.0
5.0,2.25,3740,1.5,0,0,3740,0,1979,660000.0
3.0,1.75,1140,1.0,0,0,1140,0,1950,310000.0
3.0,2.5,2480,2.0,0,0,2480,0,2000,717000.0
5.0,2.5,2580,1.0,0,0,1410,1170,1964,260000.0
3.0,2.0,2290,1.0,0,0,1490,800,1960,745000.0
4.0,2.5,2320,1.0,0,0,1320,1000,1975,470000.0
3.0,2.5,2530,2.0,0,0,2530,0,1997,429000.0
4.0,2.0,1400,1.0,0,0,1400,0,1969,220000.0
3.0,3.0,2060,2.0,0,0,1400,660,2007,497000.0
3.0,1.0,1640,1.5,0,0,1640,0,1909,716100.0
4.0,1.0,1960,1.5,0,0,1960,0,1979,371000.0
5.0,2.75,3000,1.0,0,0,1500,1500,1961,379000.0
3.0,1.0,1320,1.0,0,0,1320,0,1954,937500.0
4.0,2.0,1760,1.5,0,0,1760,0,1906,720000.0
3.0,3.25,2130,2.0,0,1,1420,710,1924,616000.0
3.0,2.0,1390,1.0,0,0,1390,0,1988,259000.0
3.0,1.75,1400,1.5,0,0,1100,300,1904,538000.0
3.0,2.75,3230,1.5,0,0,3230,0,1966,605000.0
3.0,1.0,1110,1.0,0,0,1110,0,1967,369950.0
3.0,2.5,1670,2.0,0,0,1670,0,2002,310000.0
3.0,1.0,1540,1.0,0,0,1540,0,1960,227500.0
4.0,2.25,2090,1.0,0,0,1670,420,1973,274000.0
3.0,2.0,1410,1.0,0,0,1410,0,1987,410000.0
3.0,2.0,1370,1.0,0,0,1370,0,1964,354800.0
4.0,2.25,1910,1.0,0,0,1300,610,1954,650000.0
3.0,2.0,1678,1.0,0,0,1678,0,1994,353000.0
3.0,1.0,960,1.0,0,0,960,0,1977,224975.0
2.0,1.75,2080,1.0,0,1,2080,0,1951,600000.0
3.0,2.25,1790,1.0,0,0,1340,450,1976,437500.0
3.0,2.5,2540,2.0,0,0,2540,0,1999,567000.0
5.0,1.5,1790,2.0,0,0,1790,0,1963,225000.0
2.0,1.0,940,1.0,0,0,940,0,1941,255000.0
5.0,3.75,6810,2.5,0,0,6110,700,1922,2479000.0
2.0,1.0,900,1.0,0,0,900,0,1951,370000.0
4.0,1.75,1900,1.0,0,0,1140,760,1975,675000.0
3.0,1.0,1440,1.0,0,0,1040,400,1953,285000.0
3.0,1.75,2070,1.0,0,0,1420,650,1973,310000.0
4.0,2.5,2240,1.0,0,0,1140,1100,1972,475000.0
4.0,2.5,3320,2.0,0,0,3320,0,2006,410000.0
4.0,2.25,1950,1.0,0,0,1330,620,1947,895000.0
3.0,1.5,1240,1.0,0,0,790,450,1941,375000.0
4.0,2.5,1830,2.0,0,0,1830,0,2003,349000.0
3.0,1.75,1740,1.5,0,0,1740,0,1903,650500.0
3.0,1.75,1410,1.0,0,0,1410,0,1950,760000.0
4.0,2.75,2050,1.0,0,0,1180,870,1986,480000.0
4.0,2.75,3220,2.0,0,0,3220,0,1993,689000.0
3.0,1.75,1960,1.0,0,0,980,980,1911,415000.0
3.0,1.75,1070,1.0,0,0,1070,0,1968,195000.0
5.0,2.5,2820,1.0,0,0,1410,1410,1967,318000.0
4.0,3.0,4060,1.0,0,0,2030,2030,1989,404000.0
2.0,1.0,800,1.0,0,0,800,0,1925,339950.0
3.0,1.0,1260,1.0,0,0,1260,0,1979,215000.0
3.0,2.5,2420,2.0,0,0,2420,0,1990,339900.0
1.0,1.5,810,2.0,0,0,810,0,1982,285000.0
3.0,1.0,1600,1.5,0,0,1110,490,1947,550000.0
4.0,1.0,1350,1.5,0,0,1350,0,1964,430000.0
3.0,1.0,970,1.0,0,0,970,0,1967,219000.0
2.0,1.5,1780,1.0,0,0,1080,700,1947,555000.0
3.0,2.0,1350,1.0,0,0,1350,0,1989,233000.0
3.0,1.75,1840,1.0,0,0,1270,570,1972,248000.0
5.0,2.25,2550,1.0,0,0,1580,970,1975,454000.0
4.0,2.5,1700,2.0,0,0,1700,0,1931,950000.0
3.0,2.5,2430,2.0,0,0,1730,700,1980,359000.0
5.0,2.0,2740,1.5,0,0,2210,530,1962,407500.0
3.0,1.5,1560,1.0,0,0,1040,520,1964,224000.0
2.0,1.0,1040,1.0,0,0,1040,0,1954,210000.0
4.0,1.75,1820,1.0,0,0,1820,0,1968,261000.0
3.0,3.0,1833,3.0,0,0,1833,0,1998,719000.0
3.0,2.5,2160,2.0,0,0,2160,0,1994,440000.0
3.0,2.75,2100,2.0,0,0,1510,590,1998,525000.0
3.0,1.5,1370,2.0,0,0,1370,0,1968,375000.0
2.0,2.5,1414,2.0,0,0,1414,0,1986,428000.0
5.0,3.25,4115,2.0,0,0,4115,0,2014,988830.0
3.0,1.75,1550,1.0,0,0,1550,0,1949,199950.0
4.0,2.25,2100,1.5,0,0,1750,350,1929,840000.0
3.0,1.75,1160,1.0,0,0,1160,0,1992,285000.0
5.0,2.5,3597,2.0,0,0,3597,0,2006,330000.0
3.0,1.5,1230,1.0,0,0,1230,0,1960,147500.0
4.0,2.5,2190,2.0,0,0,2190,0,1978,320000.0
3.0,1.75,1040,1.0,0,0,1040,0,1967,382500.0
5.0,4.0,4690,2.0,0,0,3040,1650,1926,2048000.0
4.0,2.25,2270,1.0,0,0,1720,550,1974,596000.0
4.0,2.25,1950,2.0,0,0,1950,0,1979,220000.0
3.0,2.5,1880,2.0,0,0,1880,0,1993,325000.0
4.0,2.5,2850,2.0,0,0,2850,0,2001,679950.0
2.0,1.0,1160,1.0,0,0,1160,0,1947,175000.0
3.0,1.75,1370,1.0,0,1,1370,0,1966,268000.0
4.0,3.5,3260,2.0,0,0,3260,0,1997,715000.0
7.0,2.25,3170,2.0,0,0,3170,0,1969,600000.0
,1.0,390,1.0,0,0,390,0,1953,228000.0
5.0,2.5,3450,2.0,0,0,3450,0,1992,950000.0
2.0,1.75,1490,1.0,0,2,1490,0,1983,475000.0
3.0,1.5,1460,1.0,0,0,1460,0,1963,700000.0
3.0,1.75,1300,1.0,0,0,1300,0,1962,275000.0
3.0,1.75,1300,1.0,0,0,1300,0,1962,369500.0
4.0,2.0,1540,1.0,0,0,1040,500,1978,215000.0
4.0,2.25,2130,2.0,0,0,2130,0,1964,593450.0
2.0,1.75,1350,1.0,0,0,1350,0,2008,498800.0
5.0,3.25,2450,2.0,0,0,1770,680,1951,849000.0
4.0,2.5,1940,2.0,0,0,1940,0,1925,1151250.0
5.0,2.5,2890,2.0,0,2,2890,0,2003,825000.0
3.0,1.75,1680,1.0,0,0,1340,340,1989,265000.0
4.0,2.25,1960,1.0,0,0,1220,740,1985,285000.0
3.0,1.75,1590,1.0,0,0,1190,400,1979,240000.0
4.0,1.0,1390,1.0,0,0,1390,0,1958,261000.0
4.0,1.75,2440,1.0,0,0,1610,830,1978,330000.0
4.0,2.0,1850,1.0,0,0,1540,310,1978,250000.0
4.0,2.5,2800,2.0,0,0,2800,0,1993,350000.0
3.0,2.5,3780,1.5,0,0,3780,0,1986,930000.0
3.0,2.0,1910,1.0,0,0,1000,910,1980,275000.0
4.0,2.25,2460,1.0,0,0,1230,1230,1969,325000.0
1.0,1.0,810,1.0,0,1,590,220,1936,255000.0
3.0,1.5,1900,1.0,0,0,1500,400,1943,562200.0
2.0,1.75,3490,1.0,0,3,2320,1170,1980,952000.0
3.0,2.5,2200,1.0,0,0,1570,630,1988,365000.0
3.0,1.5,1190,1.0,0,0,1190,0,1969,332900.0
3.0,2.25,2040,2.0,0,0,2040,0,1983,721000.0
4.0,2.5,2400,2.0,0,0,2400,0,1999,487275.0
3.0,2.5,1670,2.0,0,0,1670,0,1995,310000.0
2.0,1.0,990,1.0,0,0,990,0,1908,245000.0
3.0,1.75,2920,1.0,0,0,2920,0,1964,325000.0
3.0,1.75,1840,1.0,0,0,1840,0,1971,550000.0
2.0,1.0,910,1.5,0,0,910,0,1906,350000.0
5.0,2.5,2950,2.0,0,0,2950,0,2006,599000.0
3.0,1.5,1240,1.0,0,0,1240,0,1955,259950.0
4.0,2.5,1980,2.0,0,0,1980,0,1996,240000.0
3.0,1.0,1200,1.0,0,0,1200,0,1969,186000.0
3.0,1.5,1280,1.0,0,0,1280,0,1982,395000.0
4.0,2.5,3150,2.0,0,0,3150,0,2004,475000.0
5.0,3.5,3500,2.0,0,0,3500,0,1996,815000.0
3.0,1.5,1680,1.0,0,0,1680,0,1951,572000.0
3.0,2.5,1360,2.0,0,0,1360,0,1986,419500.0
3.0,2.25,2110,1.0,0,0,1530,580,1980,298700.0
2.0,1.0,2034,1.0,1,4,1159,875,1947,549000.0
3.0,1.5,1900,1.0,0,0,1120,780,1960,278000.0
4.0,2.0,2380,1.5,0,0,1470,910,1926,455000.0
5.0,3.5,4050,1.0,0,2,2230,1820,1988,925000.0
2.0,1.5,1120,3.0,0,0,1120,0,1999,465000.0
4.0,4.0,2850,2.0,0,0,2120,730,1999,620000.0
4.0,2.25,2360,1.0,0,0,1640,720,1963,499900.0
5.0,3.0,2540,1.0,0,0,1270,1270,1962,620000.0
3.0,1.75,1160,1.0,0,0,1040,120,1941,450000.0
4.0,3.5,2710,2.0,0,0,2220,490,2007,690000.0
5.0,2.25,3120,2.0,0,0,3120,0,1969,1895000.0
5.0,2.25,3120,2.0,0,0,3120,0,1969,1940000.0
3.0,2.0,1870,1.0,0,0,1870,0,1951,832500.0
3.0,1.0,1010,1.0,0,0,1010,0,1955,245000.0
3.0,2.5,2980,1.5,0,0,2980,0,1990,820000.0
4.0,2.75,2420,2.0,0,0,2420,0,2005,369000.0
4.0,3.25,3830,2.0,0,0,3830,0,2014,1050000.0
3.0,3.0,3040,3.0,0,2,3040,0,1993,653000.0
2.0,1.75,1460,1.0,0,0,1460,0,1980,220650.0
5.0,3.0,1940,1.0,0,0,1200,740,2007,300000.0
4.0,3.5,3780,2.0,0,2,3780,0,2001,970000.0
4.0,2.5,1950,2.0,0,0,1950,0,2004,360000.0
3.0,2.5,2450,2.0,0,0,2450,0,2000,672500.0
4.0,1.5,1730,1.5,0,0,1730,0,1953,268000.0
4.0,1.5,1690,1.5,0,0,1690,0,1929,440000.0
3.0,2.5,2550,2.0,0,2,2550,0,1981,1400000.0
4.0,2.5,2290,2.0,0,0,2290,0,1986,590000.0
4.0,2.25,2710,1.0,0,0,1850,860,1962,359000.0
4.0,1.75,1880,1.0,0,0,1180,700,1978,266500.0
4.0,2.5,2930,2.0,0,0,2930,0,2014,635000.0
3.0,2.5,3110,2.0,0,0,3110,0,2001,559000.0
4.0,2.5,3480,2.0,0,0,3480,0,1989,895000.0
2.0,1.5,1110,1.0,0,0,1110,0,1961,625000.0
4.0,2.25,2440,1.0,0,0,1880,560,1957,650000.0
4.0,1.75,2280,1.0,0,0,1280,1000,1957,312500.0
3.0,1.0,900,1.0,0,0,790,110,1944,225000.0
4.0,1.75,1980,1.0,0,0,1330,650,1968,425000.0
3.0,2.75,3360,1.0,0,0,1820,1540,1988,329999.0
5.0,2.25,2340,2.0,0,0,2340,0,1973,572000.0
4.0,2.5,3110,2.0,0,0,3110,0,2002,386500.0
2.0,1.0,980,1.0,0,0,980,0,1904,452000.0
4.0,2.0,1480,1.0,0,0,1480,0,1943,278000.0
3.0,2.25,1800,1.0,0,0,1800,0,1976,474900.0
2.0,1.75,2130,1.0,0,0,1500,630,1946,450000.0
2.0,1.0,1270,1.0,0,0,1100,170,1900,611000.0
2.0,2.5,1150,2.0,0,0,1150,0,2004,214100.0
3.0,2.5,1840,2.0,0,0,1840,0,2012,317000.0
4.0,3.5,3180,2.0,0,1,2060,1120,1979,1000000.0
5.0,2.75,1510,2.0,0,1,1510,0,1946,1000000.0
4.0,2.5,3070,2.0,0,0,3070,0,2005,525000.0
3.0,2.25,1800,2.0,0,0,1800,0,1983,436000.0
3.0,1.75,1540,1.0,0,0,1540,0,1983,450000.0
3.0,1.75,2330,1.0,0,0,1970,360,1980,588500.0
4.0,1.75,1400,1.0,0,0,1400,0,1953,340000.0
4.0,2.5,2846,1.5,0,0,1976,870,2000,482000.0
4.0,3.5,5830,2.0,0,0,5830,0,2005,1575000.0
3.0,2.5,3380,2.0,0,0,3380,0,1965,749000.0
3.0,1.5,1440,1.0,0,0,1440,0,1968,330000.0
3.0,2.5,1740,3.0,0,0,1740,0,2008,568000.0
3.0,1.75,1470,1.0,0,0,1470,0,1957,239000.0
3.0,2.5,2810,2.0,0,0,2810,0,2003,528000.0
4.0,3.0,2090,1.0,0,0,1350,740,1994,385000.0
4.0,3.25,4110,2.0,0,2,2570,1540,1979,825000.0
5.0,3.25,3230,2.0,0,1,2350,880,2002,815000.0
4.0,2.5,2601,2.0,0,0,2601,0,1995,625000.0
3.0,1.75,2070,1.0,0,3,1340,730,1955,690000.0
3.0,1.0,1660,1.0,0,0,1270,390,1957,210000.0
4.0,1.0,1590,1.5,0,0,1590,0,1924,599000.0
3.0,1.75,1860,1.0,0,0,1310,550,1951,860000.0
3.0,1.0,1420,1.0,0,0,1420,0,1954,147200.0
3.0,1.0,1240,1.5,0,0,960,280,1910,476900.0
4.0,2.5,2500,1.0,0,0,1590,910,1978,450000.0
4.0,2.5,2640,2.0,0,0,2640,0,1999,570000.0
3.0,1.0,1440,1.5,0,0,1440,0,1910,567500.0
5.0,3.25,3030,2.0,0,2,2130,900,1976,790000.0
3.0,1.5,1820,1.0,0,0,1820,0,1952,875000.0
3.0,2.0,2220,2.0,0,0,1640,580,1980,490000.0
3.0,1.75,2430,1.0,0,0,1410,1020,1978,335000.0
3.0,1.75,1670,1.0,0,0,1670,0,1962,550000.0
3.0,1.75,1180,1.0,0,0,940,240,1981,385000.0
3.0,1.75,1620,1.0,0,0,1210,410,1976,395000.0
2.0,1.0,1030,1.0,0,0,1030,0,1928,650000.0
4.0,2.75,2900,2.0,0,0,2900,0,2007,637000.0
3.0,2.25,3420,1.0,0,0,1710,1710,1963,692500.0
3.0,1.75,1710,1.0,0,0,1710,0,1964,322400.0
3.0,1.5,1580,1.0,0,0,1580,0,1957,233500.0
3.0,2.0,1230,1.0,0,0,990,240,1984,400000.0
5.0,2.5,2200,1.5,0,0,1420,780,1916,547000.0
5.0,2.25,2570,1.0,0,1,1470,1100,1950,519000.0
4.0,3.5,3320,1.0,0,2,2040,1280,1977,1025000.0
3.0,1.0,1090,1.0,0,0,1090,0,1955,365000.0
5.0,2.75,2970,2.0,0,0,2970,0,1978,699000.0
3.0,1.75,1970,1.0,0,0,1970,0,1968,525000.0
4.0,3.0,3220,2.0,0,0,2450,770,1990,430000.0
3.0,1.0,1600,1.0,0,0,1600,0,1966,325000.0
2.0,1.0,670,1.0,0,0,670,0,1942,279000.0
4.0,1.75,2360,2.0,0,0,1660,700,1911,805000.0
3.0,3.0,2150,1.5,0,0,1540,610,1949,419950.0
2.0,1.0,620,1.0,0,0,620,0,1927,425000.0
4.0,1.75,1730,2.0,0,0,1730,0,1949,446000.0
5.0,2.0,2500,1.0,0,0,1040,1460,1963,455000.0
3.0,1.0,990,1.0,0,0,990,0,1943,226550.0
3.0,2.0,1420,1.5,0,0,1420,0,1904,764000.0
3.0,2.25,2170,2.0,0,0,2170,0,1978,439950.0
4.0,2.0,1880,1.0,0,0,1880,0,1952,453000.0
3.0,1.0,1300,1.0,0,0,1300,0,1971,219950.0
3.0,1.5,2360,2.0,0,0,1930,430,1926,702500.0
3.0,1.5,1780,1.0,0,0,1780,0,1956,285000.0
2.0,2.25,2160,3.0,0,0,2160,0,2005,798750.0
2.0,1.0,950,1.0,0,2,950,0,1948,320000.0
3.0,1.75,1680,1.5,0,0,1680,0,1985,425000.0
4.0,2.5,2290,2.0,0,0,2290,0,2004,540000.0
4.0,5.25,4140,2.0,0,2,4140,0,2005,1060000.0
4.0,3.75,3920,3.0,0,0,3920,0,2013,1165000.0
3.0,1.75,1500,1.0,0,0,1500,0,1951,576000.0
3.0,1.75,1720,1.0,0,0,1140,580,1977,525000.0
4.0,2.5,2641,2.0,0,0,2641,0,1998,324950.0
3.0,2.5,4930,2.0,0,0,3930,1000,1981,600000.0
3.0,2.5,2460,1.0,0,0,1520,940,2001,464000.0
4.0,2.25,1995,2.0,0,0,1995,0,1981,266000.0
3.0,2.5,3010,2.0,0,0,3010,0,1998,775000.0
3.0,1.75,1270,1.0,0,0,1270,0,1952,415000.0
4.0,2.75,3080,2.0,0,3,3080,0,2003,550000.0
3.0,2.25,1670,2.0,0,0,1670,0,1990,235000.0
3.0,2.0,1470,1.0,0,0,1470,0,1987,280000.0
3.0,1.75,1730,1.0,0,0,1260,470,1976,459000.0
3.0,1.0,1070,1.0,0,0,1070,0,1969,195000.0
3.0,1.5,1660,1.0,0,0,1080,580,1959,235000.0
4.0,2.25,2410,1.0,0,0,2410,0,1965,711800.0
3.0,2.5,1040,3.0,0,0,1040,0,2007,440000.0
2.0,1.0,970,1.0,0,0,970,0,1916,515000.0
5.0,2.75,2910,1.5,0,0,2910,0,1939,1200000.0
3.0,1.75,2340,1.5,0,0,2340,0,1965,560000.0
3.0,1.75,1880,1.0,0,0,1330,550,1985,340000.0
2.0,1.0,1110,1.5,0,0,970,140,1912,600000.0
4.0,2.5,2790,2.0,0,0,2790,0,1997,764000.0
4.0,2.0,1590,1.0,0,0,1590,0,2001,337000.0
6.0,2.75,5700,1.0,0,4,2850,2850,1977,1385000.0
4.0,1.0,1200,1.0,0,0,1060,140,1919,249000.0
3.0,3.0,3200,1.0,0,0,2360,840,1978,350000.0
3.0,2.25,1510,1.0,0,0,1150,360,1993,269950.0
3.0,1.75,1880,1.0,0,0,1880,0,1978,735000.0
4.0,2.5,3070,2.0,0,0,2070,1000,1940,1295000.0
4.0,2.25,2110,2.0,0,0,2110,0,1974,475000.0
3.0,2.0,2350,1.5,0,0,2350,0,1989,339000.0
4.0,3.5,3270,1.0,0,2,1660,1610,1997,600000.0
4.0,1.75,2220,1.0,0,0,1320,900,1918,397500.0
4.0,3.5,5990,2.0,0,0,5990,0,2004,1525000.0
3.0,2.0,1760,2.0,0,0,1760,0,1985,460000.0
4.0,2.75,2200,1.0,0,0,1120,1080,1951,370000.0
4.0,1.0,1550,1.5,0,0,1550,0,1957,250000.0
4.0,3.75,5070,2.0,0,0,5070,0,2000,1100000.0
2.0,2.25,1040,2.0,0,0,1040,0,2008,430000.0
3.0,1.5,2560,1.5,0,0,1660,900,1927,1085000.0
3.0,1.75,1850,1.0,0,0,1850,0,1952,670000.0
3.0,1.5,2090,1.0,0,0,1790,300,1954,461550.0
3.0,2.5,2010,2.0,0,0,1390,620,2014,479990.0
4.0,2.5,2518,2.0,0,0,2518,0,2005,643000.0
3.0,2.75,2810,2.0,0,0,2040,770,1988,607000.0
3.0,2.5,2600,1.0,0,0,2600,0,1984,625000.0
3.0,2.5,2060,1.0,0,0,1160,900,1953,731100.0
3.0,2.5,2920,2.0,0,3,2920,0,1999,859000.0
4.0,2.5,2130,2.0,0,0,2130,0,1986,435000.0
3.0,3.0,2290,1.0,0,0,1420,870,1948,465000.0
3.0,1.0,1230,1.5,0,0,1230,0,1927,740000.0
3.0,1.75,2020,1.0,0,0,2020,0,1961,740000.0
3.0,2.0,1430,1.0,0,0,990,440,1980,250000.0
2.0,2.5,2270,3.0,0,0,1820,450,2009,656000.0
4.0,2.5,1910,2.0,0,0,1910,0,1992,300000.0
3.0,1.5,1780,1.0,0,0,1780,0,1954,643000.0
4.0,2.5,2690,2.0,0,0,2690,0,2007,311000.0
3.0,1.75,1330,1.0,0,0,1330,0,1975,360000.0
4.0,2.5,3060,1.0,0,0,1700,1360,1968,475000.0
3.0,3.25,1760,3.0,0,0,1760,0,2008,469950.0
3.0,1.75,1570,1.0,0,0,1570,0,1960,240000.0
2.0,1.0,960,1.0,0,0,810,150,1936,232000.0
3.0,2.0,1680,1.0,0,0,1680,0,1991,350000.0
2.0,1.0,1440,1.5,0,0,1440,0,1928,803000.0
3.0,2.25,1960,1.0,0,0,1600,360,1980,355000.0
4.0,2.0,1790,1.0,0,2,840,950,1909,475000.0
3.0,2.5,2560,2.0,0,0,2560,0,1988,823000.0
2.0,1.5,1010,1.0,0,0,1010,0,1918,395000.0
4.0,3.75,2560,2.0,0,0,1900,660,1963,499000.0
2.0,1.75,1200,1.0,0,0,800,400,1904,420000.0
3.0,2.5,3910,2.0,0,0,3910,0,1999,961500.0
4.0,1.75,2260,1.0,0,0,2260,0,1967,833000.0
3.0,2.25,2110,2.0,0,0,2110,0,1978,479000.0
4.0,2.5,3340,2.0,0,0,3340,0,1996,1150000.0
3.0,1.0,1400,1.5,0,0,1400,0,1944,267000.0
4.0,1.75,1760,1.5,0,0,1760,0,1988,555000.0
3.0,2.5,2010,2.0,0,0,2010,0,1987,490000.0
4.0,2.0,2300,1.5,0,0,1550,750,1915,619000.0
5.0,2.75,2510,1.0,0,0,1600,910,1963,569950.0
3.0,2.0,1340,2.0,0,0,1340,0,1905,549000.0
3.0,1.75,1560,1.5,0,0,1560,0,1962,422500.0
4.0,3.5,3350,1.0,0,1,2140,1210,1980,400000.0
4.0,2.75,3710,2.0,0,0,3710,0,1999,692500.0
4.0,2.5,2430,2.0,0,0,2430,0,2002,310000.0
3.0,1.75,2430,1.0,0,2,1630,800,1977,499900.0
3.0,2.25,2100,2.0,0,0,2100,0,1983,492000.0
2.0,2.5,1880,1.0,0,0,1880,0,1987,460000.0
3.0,2.5,1630,2.0,0,0,1630,0,1919,800000.0
4.0,1.0,1640,1.5,0,0,1640,0,1925,832600.0
4.0,2.75,2310,1.0,0,0,1670,640,1989,470000.0
2.0,2.0,1930,1.0,0,0,1930,0,2003,542000.0
4.0,4.5,4750,2.0,0,2,3600,1150,2005,1309500.0
4.0,2.5,2300,1.0,0,3,1650,650,1959,308130.0
2.0,1.0,1050,1.0,0,0,1050,0,2005,310000.0
2.0,1.0,1500,1.0,0,0,1500,0,1947,235000.0
3.0,1.0,1150,1.0,0,0,1150,0,1958,215000.0
4.0,1.5,1920,1.0,0,0,1370,550,1959,210000.0
4.0,2.75,3660,2.0,0,0,3660,0,1990,730000.0
3.0,1.75,1720,1.0,0,0,1140,580,1981,245000.0
3.0,2.25,2100,1.0,0,4,1470,630,1948,540000.0
4.0,2.5,2400,2.0,0,0,2400,0,2001,299000.0
3.0,2.5,2540,2.0,0,0,2540,0,1991,510000.0
4.0,1.75,2080,1.0,0,0,1050,1030,1966,198000.0
5.0,3.25,3400,2.0,0,0,3400,0,1999,950000.0
4.0,1.75,2200,2.0,0,0,2200,0,1978,300000.0
5.0,1.75,2140,1.0,0,0,1200,940,1962,528000.0
5.0,3.25,3850,2.0,0,2,3030,820,2002,507000.0
4.0,3.25,4270,2.0,0,0,3060,1210,2001,770000.0
3.0,1.75,1340,1.0,0,0,1340,0,1975,255000.0
1.0,1.5,1100,1.5,0,0,1100,0,1978,220000.0
5.0,2.75,2870,2.0,0,0,2870,0,2005,690700.0
2.0,1.0,1320,1.0,0,0,1320,0,1953,447000.0
6.0,2.0,2150,1.0,0,0,1270,880,1952,755000.0
4.0,1.5,2470,1.5,0,0,1480,990,1940,700000.0
4.0,2.75,1910,1.0,0,0,1000,910,1980,250000.0
3.0,2.5,2130,2.0,0,0,2130,0,2003,320000.0
4.0,2.5,2240,2.0,0,0,2240,0,1989,565000.0
5.0,2.75,1800,2.0,0,0,1680,120,1939,754300.0
3.0,1.5,2160,1.0,0,2,1400,760,1949,650000.0
4.0,2.5,3140,2.0,0,0,3140,0,2003,529888.0
3.0,2.5,1920,2.0,0,0,1920,0,2000,432000.0
3.0,1.0,1050,1.5,0,0,1050,0,1955,235000.0
4.0,3.5,3695,2.0,0,0,3695,0,2014,994900.0
4.0,2.5,3910,2.0,0,0,2710,1200,2000,489000.0
4.0,2.75,3010,2.0,0,0,3010,0,2010,800000.0
4.0,1.5,1370,1.0,0,0,900,470,1972,370000.0
4.0,2.75,2080,1.0,0,0,1240,840,1979,436000.0
3.0,2.5,2250,2.0,0,0,2250,0,2006,395000.0
5.0,1.75,2120,1.0,0,0,1320,800,1942,377691.0
5.0,3.0,2220,2.0,0,3,2220,0,2003,370000.0
3.0,2.5,1440,1.0,0,0,1440,0,1987,515000.0
3.0,1.0,910,1.0,0,0,910,0,1969,169000.0
3.0,1.0,1270,1.0,0,0,1270,0,1921,475000.0
3.0,2.5,2480,2.0,0,0,2480,0,1999,420000.0
6.0,2.75,2630,2.0,0,0,2510,120,1900,1297000.0
3.0,2.0,2410,2.0,0,0,1840,570,1985,822000.0
4.0,2.75,2930,1.0,0,0,2310,620,1964,1500000.0
3.0,2.25,1570,1.0,0,0,1180,390,1988,485000.0
4.0,1.0,1900,1.0,0,0,1200,700,1956,270000.0
6.0,2.5,2590,1.0,0,0,1390,1200,1978,300000.0
4.0,2.5,3810,2.0,0,0,3810,0,2007,878000.0
3.0,2.5,2290,2.0,0,0,2290,0,2001,590000.0
1.0,2.25,1220,2.0,0,2,1220,0,1946,611900.0
3.0,1.75,1100,1.0,0,0,1100,0,1968,240000.0
4.0,2.5,2810,2.0,0,0,2810,0,2003,395000.0
3.0,1.0,890,1.0,0,0,890,0,1957,169000.0
3.0,2.0,1280,1.0,0,0,1280,0,1963,200500.0
3.0,2.5,2320,2.0,0,0,2320,0,1990,308000.0
3.0,2.25,1720,2.0,0,0,1720,0,1983,290256.0
3.0,1.75,1530,1.0,0,0,1040,490,1967,279950.0
3.0,1.75,1580,1.0,0,0,1580,0,1979,195000.0
3.0,1.0,1360,1.0,0,0,1360,0,1945,630000.0
4.0,3.0,2680,2.0,0,2,2680,0,1902,1160000.0
3.0,2.25,1640,2.0,0,0,1640,0,1994,478000.0
3.0,2.25,2520,2.0,0,2,1700,820,1944,835000.0
3.0,2.25,1400,2.0,0,0,1400,0,2005,639000.0
4.0,2.75,2300,2.0,0,0,2300,0,1984,623000.0
3.0,1.75,1900,1.0,0,0,1260,640,1959,220000.0
3.0,2.25,2000,1.0,0,0,1250,750,1978,526000.0
2.0,1.0,900,1.0,0,0,900,0,1948,243500.0
4.0,2.5,2980,2.0,0,0,2890,90,2000,750000.0
4.0,2.0,1850,1.0,0,0,1850,0,1963,329000.0
4.0,1.0,1570,1.5,0,0,1570,0,1920,525000.0
2.0,1.0,670,1.0,0,0,670,0,1948,190000.0
4.0,2.5,2660,1.0,0,0,2660,0,1955,772650.0
3.0,2.5,2110,2.0,0,0,2110,0,1989,355000.0
3.0,1.75,1970,1.0,0,0,1570,400,1980,650000.0
3.0,2.75,1210,1.5,0,2,1210,0,1910,678500.0
4.0,2.5,2670,2.0,0,0,2670,0,1996,669950.0
3.0,2.25,3000,1.0,0,0,3000,0,1983,850000.0
3.0,2.75,2200,2.0,0,0,2200,0,2002,572000.0
3.0,1.75,1540,1.0,0,0,1200,340,1984,492450.0
3.0,1.75,2080,1.0,0,0,2080,0,1960,813000.0
3.0,2.0,1780,1.0,0,0,1780,0,1967,710000.0
3.0,1.5,1960,2.0,0,0,1330,630,1911,792500.0
5.0,1.5,1690,1.5,0,0,1690,0,1961,285900.0
3.0,2.0,2080,1.0,0,0,1250,830,1981,389000.0
3.0,2.25,2070,2.0,0,2,1490,580,1966,675000.0
2.0,0.75,760,1.0,0,0,760,0,1931,352000.0
4.0,3.25,4020,2.0,0,0,4020,0,2000,1050000.0
4.0,1.75,3620,1.0,0,0,1820,1800,1965,768500.0
4.0,2.0,2330,1.0,0,0,1230,1100,1961,500000.0
3.0,2.5,1460,1.0,0,0,1460,0,1956,685000.0
4.0,2.75,2250,1.0,0,0,1200,1050,1951,648475.0
6.0,5.0,2850,2.0,0,0,2850,0,1994,655000.0
4.0,2.75,2640,2.0,0,0,1730,910,1925,895000.0
3.0,1.0,1310,1.0,0,0,960,350,1962,195000.0
4.0,2.5,2720,2.0,0,0,2720,0,1989,368000.0
4.0,3.5,3430,2.0,0,0,3430,0,2001,997000.0
3.0,2.75,1990,1.0,0,0,1340,650,1977,335000.0
3.0,2.0,1170,1.0,0,0,1170,0,1984,250000.0
3.0,1.75,1390,1.0,0,0,1390,0,1985,278500.0
4.0,1.5,1540,2.0,0,0,1540,0,1973,260000.0
2.0,1.0,760,1.0,0,0,760,0,1920,162500.0
4.0,1.0,1280,1.0,0,0,1280,0,1950,239000.0
4.0,2.5,2990,2.0,0,0,2990,0,2004,600000.0
4.0,2.25,1770,2.0,0,0,1770,0,1998,350000.0
5.0,3.75,3830,2.0,0,0,3830,0,2005,852500.0
3.0,2.5,2870,2.0,0,0,2870,0,2008,485000.0
3.0,1.0,1520,1.0,0,0,1520,0,1953,299000.0
2.0,1.0,660,1.0,0,0,660,0,1952,227450.0
3.0,1.0,1800,1.0,0,0,1200,600,1942,383000.0
2.0,3.25,3570,1.0,0,0,2370,1200,1998,835000.0
5.0,1.5,3050,1.5,0,0,1920,1130,1931,760000.0
2.0,1.0,820,1.0,0,0,820,0,1924,532500.0
3.0,2.5,3610,1.0,0,0,1950,1660,1998,635000.0
3.0,2.0,1490,1.0,0,0,770,720,1912,438500.0
3.0,2.5,1560,1.5,0,0,1360,200,1936,545500.0
3.0,1.75,1660,1.0,0,0,1660,0,1956,675000.0
3.0,1.75,1180,1.0,0,0,760,420,1928,450000.0
3.0,1.0,960,1.0,0,0,960,0,1900,199999.0
3.0,1.5,1630,1.0,0,0,1630,0,1988,375000.0
4.0,2.25,2260,2.0,0,0,2260,0,1982,600000.0
3.0,1.5,1520,1.0,0,0,1520,0,1959,292600.0
5.0,2.75,3050,1.0,0,0,1650,1400,1956,1038000.0
3.0,1.0,1000,1.0,0,0,1000,0,1945,610000.0
4.0,2.5,2650,2.0,0,0,2650,0,1993,397450.0
3.0,2.25,1750,1.0,0,0,1270,480,1963,382000.0
3.0,2.25,1770,1.0,0,0,1270,500,1966,370000.0
3.0,2.25,1770,1.0,0,0,1270,500,1966,520000.0
2.0,1.0,770,1.0,0,0,770,0,1948,260000.0
4.0,2.5,3370,2.0,0,0,3370,0,2014,890000.0
5.0,2.0,2130,1.0,0,0,1440,690,1946,344000.0
3.0,1.0,1050,1.0,0,0,1050,0,1958,205000.0
5.0,2.5,2803,1.0,0,0,2803,0,1963,379000.0
3.0,2.0,2080,2.0,0,0,2080,0,1982,424240.0
3.0,2.0,2080,2.0,0,0,2080,0,1982,589950.0
4.0,1.75,2120,1.0,0,1,1190,930,1951,582000.0
3.0,2.5,2550,2.0,0,0,2550,0,1989,349000.0
3.0,1.0,1290,1.0,0,0,1290,0,1966,658000.0
5.0,2.75,1790,1.5,0,0,1060,730,1915,294000.0
5.0,3.5,2720,2.0,0,0,1860,860,1993,690000.0
3.0,1.0,1040,1.5,0,2,1040,0,1912,600000.0
3.0,1.0,840,1.0,0,0,840,0,1969,199990.0
3.0,1.75,1650,1.0,0,0,1650,0,1959,220000.0
4.0,2.25,2080,1.0,0,0,1460,620,1976,440000.0
4.0,2.5,1540,2.0,0,0,1540,0,2014,439990.0
4.0,2.5,3880,2.0,0,0,3880,0,2006,815000.0
4.0,2.25,1860,2.0,0,0,1860,0,1995,535000.0
3.0,1.75,1280,1.0,0,0,1280,0,1975,215000.0
3.0,2.5,3200,1.5,0,0,2100,1100,1965,605000.0
3.0,2.5,2200,2.0,0,0,2200,0,1990,349900.0
3.0,1.0,1570,1.0,0,0,1070,500,1940,495000.0
3.0,2.5,2074,2.0,0,0,2074,0,1997,515100.0
4.0,2.5,2450,2.0,0,0,2450,0,1994,620000.0
4.0,2.25,2520,2.0,0,0,2520,0,1980,657500.0
5.0,1.75,2190,1.0,0,2,1190,1000,1963,250000.0
5.0,1.75,2190,1.0,0,2,1190,1000,1963,385000.0
3.0,1.5,2320,1.0,0,0,2320,0,1976,307000.0
3.0,2.5,1370,1.0,0,0,1090,280,1994,288000.0
3.0,1.75,1730,1.5,0,0,1730,0,1944,226450.0
3.0,2.5,1640,1.0,0,0,1110,530,1967,390000.0
3.0,1.0,1300,1.0,0,0,1300,0,1971,350000.0
3.0,1.5,1560,1.0,0,0,1060,500,1969,368000.0
2.0,1.0,1120,1.0,0,0,730,390,1921,469000.0
3.0,2.25,2670,2.0,0,0,2670,0,1985,865000.0
5.0,2.5,3810,1.5,0,0,3810,0,1967,515000.0
3.0,1.75,1440,1.0,0,0,1440,0,1979,410000.0
4.0,1.0,1200,1.0,0,0,1200,0,1968,210000.0
3.0,1.75,1520,1.0,0,0,820,700,1969,460000.0
4.0,2.5,2500,1.0,0,0,1830,670,1979,241500.0
4.0,2.25,2010,2.0,0,0,2010,0,1975,322200.0
4.0,1.0,1210,1.5,0,2,1210,0,1943,279000.0
2.0,1.0,1100,1.0,0,0,1100,0,1943,303000.0
3.0,1.5,1050,1.0,0,0,800,250,1950,420000.0
3.0,1.75,2120,1.0,0,0,1380,740,1961,249000.0
3.0,1.0,1240,1.0,0,0,1240,0,1952,294950.0
4.0,3.5,3460,2.0,0,0,2560,900,2004,1315000.0
3.0,1.75,1270,1.0,0,0,1270,0,1953,335000.0
4.0,2.25,2980,1.5,0,2,2020,960,1935,1155000.0
2.0,1.0,1250,1.5,0,0,1250,0,1926,520000.0
4.0,1.75,1740,1.0,0,0,1740,0,1965,560000.0
4.0,1.5,1730,2.0,0,0,1730,0,1959,243400.0
3.0,2.0,1240,1.0,0,0,1240,0,1988,405000.0
2.0,1.0,1670,1.5,0,0,1670,0,1930,495000.0
4.0,2.5,2140,2.0,0,0,2140,0,1992,350000.0
5.0,2.75,2530,1.0,0,0,1520,1010,1992,368500.0
2.0,1.0,960,1.0,0,0,960,0,1948,99000.0
4.0,3.75,4130,2.0,0,0,4130,0,2001,1070000.0
4.0,1.75,1710,1.0,0,0,1710,0,1983,430000.0
3.0,1.5,1490,1.0,0,0,1490,0,1963,412500.0
4.0,3.25,4750,2.0,0,0,4750,0,1988,1122500.0
4.0,2.5,3400,2.0,0,0,3400,0,1988,915000.0
3.0,2.5,2210,2.0,0,0,2210,0,1994,535000.0
3.0,1.5,1650,1.0,0,0,1130,520,1979,390000.0
3.0,1.5,1260,1.0,0,0,780,480,1944,499000.0
3.0,1.0,1960,1.0,0,0,1260,700,1963,375000.0
4.0,2.5,1800,2.0,0,0,1800,0,1995,349000.0
3.0,2.25,1940,1.0,0,0,1240,700,1964,635000.0
4.0,2.75,2820,2.0,0,0,2820,0,2001,682000.0
4.0,2.25,2820,1.0,0,0,1920,900,1966,321027.0
2.0,1.0,720,1.0,0,0,720,0,1915,150000.0
3.0,1.75,1640,1.0,0,0,1110,530,1969,410000.0
3.0,2.0,1560,2.0,0,0,1560,0,1923,449950.0
6.0,2.5,1560,1.0,0,0,1060,500,1913,194990.0
4.0,1.75,1910,1.0,0,0,1210,700,1956,475000.0
5.0,1.75,1570,2.0,0,0,1570,0,1908,530000.0
4.0,2.5,2038,2.0,0,0,2038,0,2011,319950.0
3.0,2.25,1720,1.0,0,0,1220,500,1978,210000.0
3.0,2.75,1670,1.5,0,0,1670,0,1925,485000.0
4.0,2.75,2830,2.0,0,0,2830,0,1998,774000.0
4.0,2.0,1690,1.0,0,0,1210,480,1958,478000.0
4.0,2.5,1620,2.0,0,0,1620,0,1924,385000.0
4.0,2.5,2360,2.0,0,0,2360,0,1989,595000.0
3.0,1.5,1480,1.0,0,0,1170,310,1960,285000.0
4.0,2.5,2700,2.0,0,0,2700,0,2004,723000.0
3.0,1.5,1780,1.0,0,0,1240,540,1960,279000.0
3.0,1.5,1430,1.0,0,0,1430,0,1958,195000.0
2.0,1.0,2160,1.0,0,0,1170,990,1925,625000.0
3.0,1.75,1800,2.0,0,0,1800,0,1979,270000.0
2.0,2.0,1930,1.0,0,0,1930,0,2006,559000.0
4.0,2.25,1960,1.0,0,0,1330,630,1976,474000.0
4.0,2.5,1920,2.0,0,0,1920,0,1992,303500.0
3.0,1.75,1470,1.0,0,0,1470,0,1949,350000.0
5.0,3.0,2980,1.0,0,0,1680,1300,1940,367500.0
5.0,3.0,2980,1.0,0,0,1680,1300,1940,595000.0
3.0,2.0,2360,1.0,0,0,2360,0,1981,589000.0
3.0,1.75,1790,1.0,0,0,1790,0,1974,585000.0
3.0,2.25,2130,1.0,0,0,1370,760,1976,482975.0
4.0,2.5,2030,2.0,0,0,2030,0,2003,365500.0
4.0,2.0,1790,1.0,0,0,1790,0,1972,570000.0
3.0,2.5,2260,2.0,0,0,2260,0,1990,335000.0
4.0,2.0,2350,1.5,0,0,1450,900,1914,767500.0
3.0,2.5,1690,2.0,0,0,1150,540,2014,386591.0
3.0,1.0,1320,1.5,0,0,1320,0,1913,279000.0
4.0,2.5,2690,2.0,0,0,2690,0,1998,620000.0
4.0,2.25,2810,1.0,0,1,1710,1100,1958,407000.0
3.0,2.5,2280,2.0,0,0,2280,0,1994,364250.0
4.0,2.5,2870,2.0,0,0,2540,330,1979,399000.0
3.0,2.5,3030,1.5,0,0,3030,0,1992,766950.0
4.0,2.75,2940,2.0,0,0,2940,0,2004,710000.0
3.0,1.0,1190,1.0,0,0,1190,0,1929,320000.0
3.0,2.5,1800,2.0,0,0,1800,0,2001,300000.0
3.0,1.75,1580,1.0,0,0,1180,400,1993,263000.0
3.0,2.5,1730,2.0,0,0,1730,0,1996,445000.0
3.0,2.0,1910,1.0,0,0,1910,0,1957,554000.0
2.0,1.75,1000,1.0,0,0,940,60,1906,335000.0
4.0,2.75,2520,1.0,0,0,1260,1260,1987,307000.0
3.0,1.0,1420,1.0,0,0,970,450,1947,404000.0
4.0,3.5,3080,2.0,0,0,3080,0,2003,775000.0
3.0,1.0,1060,1.0,0,2,1060,0,1956,220000.0
4.0,2.5,2160,2.0,0,0,2160,0,1983,518000.0
4.0,3.5,4060,2.0,0,0,4060,0,2005,1600000.0
1.0,2.25,1940,2.0,0,0,1100,840,1979,315000.0
4.0,2.5,2250,2.0,0,0,2250,0,1991,572650.0
2.0,1.0,1620,1.0,0,0,850,770,1921,350000.0
2.0,1.0,920,1.0,0,0,920,0,1900,285000.0
3.0,2.5,1370,2.0,0,0,1370,0,1995,231000.0
3.0,1.0,920,1.0,0,0,920,0,1969,179000.0
3.0,1.5,1360,1.0,0,0,1360,0,1963,244000.0
3.0,1.5,1630,1.0,0,0,1630,0,1943,185850.0
6.0,2.5,3610,2.0,0,0,3210,400,1970,610000.0
4.0,2.5,3010,2.0,0,0,3010,0,2005,419000.0
3.0,1.75,2320,1.0,0,2,1420,900,1957,779000.0
5.0,3.0,3290,1.0,0,0,1870,1420,2004,695000.0
3.0,2.5,2040,2.0,0,2,2040,0,1998,319900.0
3.0,2.75,1920,1.0,0,0,1320,600,1978,329000.0
3.0,2.5,2120,2.0,0,0,2120,0,1988,475226.0
3.0,2.5,2170,2.0,0,0,2170,0,2003,638000.0
2.0,1.5,1330,1.0,0,0,900,430,1984,440000.0
3.0,2.0,1580,1.0,0,0,800,780,1942,214000.0
3.0,2.75,3580,2.0,0,3,2210,1370,1989,600000.0
4.0,2.0,2580,2.0,0,0,1850,730,1905,935000.0
4.0,1.75,1930,1.5,0,2,1670,260,1941,630000.0
3.0,2.5,2120,2.0,0,0,2120,0,2004,575000.0
3.0,2.5,1990,1.5,0,0,1410,580,1987,345000.0
4.0,1.75,1310,1.0,0,0,1310,0,1967,323000.0
3.0,2.5,2670,1.0,0,0,2670,0,1988,425000.0
2.0,2.25,1910,1.0,0,0,1010,900,1972,411000.0
4.0,1.5,1530,1.0,0,0,1530,0,1976,299800.0
6.0,1.75,2920,2.5,0,0,2780,140,1908,823000.0
3.0,1.0,1010,1.0,0,0,1010,0,1955,200000.0
4.0,1.75,2450,1.0,0,2,1630,820,1987,760000.0
4.0,2.5,1820,2.0,0,0,1820,0,1999,359950.0
4.0,2.5,2090,1.0,0,0,1470,620,1983,375000.0
2.0,1.75,2200,1.0,0,0,1100,1100,1973,295000.0
4.0,3.0,2250,2.0,0,0,1570,680,1986,250000.0
3.0,2.25,1450,3.0,0,0,1450,0,2000,497000.0
4.0,2.5,2280,2.0,0,0,2280,0,1987,520000.0
4.0,3.5,2720,2.0,0,0,2100,620,1999,365000.0
3.0,2.25,2250,1.0,0,0,1460,790,1976,459900.0
3.0,2.0,1090,1.0,0,0,940,150,1940,158000.0
3.0,2.0,1970,1.0,0,0,1300,670,1967,294700.0
4.0,2.25,2780,2.0,0,0,2780,0,1985,439950.0
4.0,2.25,2290,1.0,0,3,1550,740,1960,899000.0
3.0,1.75,2330,1.0,0,0,1390,940,1983,535000.0
4.0,4.5,4060,2.0,0,0,4060,0,2007,530000.0
4.0,2.0,1470,1.0,0,0,1470,0,1967,215000.0
2.0,1.0,1620,1.0,0,0,920,700,1926,290000.0
5.0,2.75,3220,2.0,0,0,3220,0,2006,798000.0
4.0,2.5,3270,2.0,0,0,3270,0,1993,785000.0
3.0,1.75,2160,1.0,0,0,1730,430,1971,433000.0
2.0,1.0,1150,1.0,0,1,1010,140,1922,425000.0
4.0,2.5,2240,1.0,0,0,1540,700,1962,654000.0
3.0,1.5,1280,2.0,0,0,1280,0,1983,215000.0
3.0,1.0,840,1.0,0,0,840,0,1970,232000.0
3.0,1.75,1680,1.0,0,0,1680,0,1959,675000.0
5.0,2.75,2330,1.0,0,0,1550,780,1972,665000.0
4.0,2.5,3030,2.0,0,0,3030,0,1998,835000.0
6.0,3.0,2880,2.0,0,0,2880,0,1980,525000.0
3.0,2.75,2910,2.0,0,2,2010,900,1939,780000.0
4.0,3.25,3090,2.0,0,0,3090,0,1988,844000.0
4.0,2.75,2720,2.0,0,0,2720,0,1985,680000.0
3.0,1.5,1310,1.0,0,0,1310,0,1965,290000.0
2.0,1.0,1790,1.0,0,0,1360,430,1959,560000.0
3.0,2.5,2830,2.0,0,0,2830,0,1989,605500.0
4.0,2.5,3150,2.0,0,0,3150,0,2005,762500.0
5.0,3.25,3930,2.0,0,0,2910,1020,2014,1740000.0
6.0,2.75,2840,1.0,0,0,1420,1420,1961,665000.0
5.0,1.0,2480,1.5,0,0,1640,840,1919,540000.0
3.0,2.5,1930,1.0,0,0,1330,600,1961,375000.0
3.0,1.0,1260,1.0,0,0,720,540,1944,342000.0
3.0,1.0,670,1.0,0,0,670,0,1968,340000.0
5.0,3.25,3930,2.0,0,2,2540,1390,1974,1250000.0
4.0,2.5,3160,2.0,0,0,3160,0,1999,693000.0
4.0,1.75,1770,1.0,0,2,1770,0,1962,638500.0
5.0,3.0,2240,2.0,0,0,2240,0,1963,805000.0
3.0,1.0,990,1.0,0,0,990,0,1960,250000.0
3.0,2.5,1580,2.0,0,0,1580,0,1998,325000.0
4.0,1.75,1560,2.0,0,0,1560,0,1994,270000.0
6.0,2.5,2640,2.0,0,0,1760,880,1922,880000.0
2.0,1.75,2120,1.0,0,0,1440,680,1924,300000.0
2.0,1.0,1200,1.0,0,0,1200,0,1948,290000.0
4.0,4.0,5040,1.0,0,0,2870,2170,1976,2850000.0
3.0,1.0,1460,1.0,0,0,1260,200,1942,259950.0
4.0,3.25,4890,2.0,0,0,4890,0,2004,1780000.0
3.0,1.0,1580,1.0,0,0,1580,0,1954,299950.0
3.0,2.25,2100,1.0,0,0,1330,770,1977,483000.0
3.0,2.25,2060,1.0,0,0,2060,0,1966,890000.0
3.0,2.5,1690,1.5,0,1,1690,0,1928,719000.0
4.0,3.0,3370,1.0,0,0,1920,1450,1977,785000.0
3.0,2.5,2330,2.0,0,0,2330,0,2006,660000.0
4.0,1.75,1820,1.0,0,0,1080,740,1980,264000.0
3.0,1.75,1890,1.0,0,0,1890,0,1968,575000.0
4.0,3.75,3820,1.0,0,0,3820,0,1994,1215000.0
3.0,2.5,2770,2.0,0,0,2770,0,1991,475000.0
4.0,3.5,3020,2.0,0,0,3020,0,1990,845800.0
3.0,1.75,1170,1.0,0,0,1170,0,1962,352500.0
3.0,1.0,1270,1.0,0,0,1270,0,1955,347000.0
4.0,2.75,1950,2.0,0,0,1950,0,1992,560000.0
4.0,2.75,2230,1.0,0,2,1330,900,1977,323000.0
3.0,1.75,2220,1.5,0,0,2220,0,1922,595000.0
4.0,2.0,2060,1.0,0,0,1170,890,1977,257500.0
3.0,1.0,1100,1.0,0,0,1100,0,1917,450000.0
4.0,1.0,1140,1.0,0,0,900,240,1970,410000.0
3.0,1.75,1980,1.0,0,2,1320,660,1952,810000.0
5.0,3.0,2480,1.0,0,0,1300,1180,2004,372500.0
3.0,1.0,1050,1.0,0,0,1050,0,1951,325000.0
3.0,1.0,1260,1.0,0,0,1260,0,1947,280000.0
3.0,2.0,1680,1.0,0,0,880,800,1948,258000.0
4.0,1.0,1360,1.5,0,0,1360,0,1949,329950.0
4.0,2.5,2450,1.0,0,0,2030,420,1980,836000.0
5.0,2.5,2260,2.0,0,0,2260,0,1999,365000.0
2.0,1.0,1060,1.0,0,0,1060,0,1908,111300.0
4.0,2.5,3720,2.0,0,0,3720,0,1984,864000.0
3.0,1.75,1610,1.0,0,0,1610,0,1962,725000.0
4.0,2.5,3350,2.0,0,0,2670,680,1990,550000.0
2.0,1.0,790,1.0,0,0,790,0,1951,130000.0
2.0,1.75,1660,1.0,0,0,990,670,1940,765000.0
3.0,1.5,1420,1.0,0,0,1420,0,1963,255000.0
3.0,2.5,2050,1.0,0,0,1570,480,1977,439500.0
3.0,1.75,1250,1.0,0,0,1250,0,1987,268000.0
3.0,1.75,1700,1.0,0,0,1700,0,1953,985000.0
4.0,2.5,2660,2.0,0,0,2660,0,1994,751305.0
3.0,1.0,1350,1.5,0,0,1350,0,1914,280000.0
4.0,2.0,1810,1.0,0,0,1110,700,1967,304000.0
4.0,2.75,2210,2.0,0,0,1730,480,1988,200000.0
3.0,1.5,2120,1.0,0,0,1420,700,1973,325000.0
3.0,2.25,2470,2.0,0,2,1540,930,1988,736000.0
4.0,2.5,2700,2.0,0,0,2700,0,1998,426500.0
2.0,1.75,1760,1.0,0,0,880,880,1930,640000.0
5.0,2.0,1930,1.5,0,0,1930,0,1941,230000.0
4.0,1.0,1680,1.5,0,0,1680,0,1911,366350.0
2.0,1.0,1390,1.0,0,0,910,480,1946,365000.0
4.0,2.25,2240,2.0,0,0,2240,0,1979,482000.0
4.0,1.0,1980,1.5,0,0,1980,0,1962,345000.0
3.0,1.75,1830,1.5,0,2,1830,0,1903,682000.0
3.0,1.75,980,1.0,0,0,980,0,1942,657500.0
6.0,2.5,3550,2.0,0,0,3550,0,1925,895000.0
3.0,1.5,1660,1.0,0,0,920,740,1918,425000.0
4.0,2.5,2490,2.0,0,0,2040,450,1976,532500.0
4.0,2.5,2329,2.0,0,0,2329,0,1995,540000.0
3.0,2.25,1790,2.0,0,0,1790,0,1984,578000.0
3.0,3.0,2830,2.0,0,3,1840,990,1915,1086000.0
3.0,1.0,1160,1.0,0,0,1160,0,1968,322500.0
3.0,1.0,1000,1.0,0,0,1000,0,1955,140000.0
3.0,2.5,2540,1.0,0,0,1820,720,1976,485000.0
2.0,1.5,1750,1.5,0,0,1440,310,1978,575000.0
3.0,2.5,2890,2.0,0,0,2890,0,2000,421000.0
4.0,2.0,1870,1.0,0,0,1200,670,1954,355000.0
4.0,2.25,2200,2.0,0,0,2200,0,1986,515000.0
3.0,1.0,1300,1.0,0,0,1300,0,1952,309000.0
5.0,2.25,3410,2.0,0,0,2530,880,1974,815000.0
3.0,1.0,1160,1.0,0,0,1160,0,1953,285000.0
3.0,1.75,2100,1.5,0,0,2100,0,1916,700000.0
3.0,2.5,1490,2.0,0,0,1490,0,1994,289000.0
4.0,3.0,3280,1.5,0,0,3280,0,1979,458000.0
3.0,1.75,1450,1.0,0,0,1450,0,1978,230000.0
3.0,2.5,1930,1.0,0,0,1420,510,1961,432500.0
3.0,1.75,1660,1.0,0,0,1040,620,1978,288000.0
3.0,1.75,1260,1.0,0,0,1260,0,1968,354000.0
3.0,1.0,1170,1.0,0,0,1170,0,1980,119500.0
4.0,3.0,3350,1.0,0,0,2020,1330,1979,805000.0
3.0,2.5,1420,3.0,0,0,1420,0,2004,435000.0
3.0,1.75,2170,1.0,0,0,1630,540,1978,260000.0
4.0,1.75,1800,1.0,0,0,900,900,1950,377000.0
4.0,2.5,2000,2.0,0,0,2000,0,1990,602000.0
3.0,1.75,1660,1.0,0,0,960,700,1941,530000.0
4.0,2.0,1540,1.0,0,0,770,770,1946,525000.0
2.0,1.5,1160,2.0,0,0,890,270,2006,250000.0
3.0,1.0,1700,1.5,0,0,1700,0,1907,681000.0
3.0,1.75,1580,1.0,0,0,1580,0,1970,625000.0
3.0,2.5,2080,2.0,0,0,2080,0,2010,448500.0
3.0,2.0,1030,1.0,0,0,1030,0,1947,260000.0
3.0,1.75,1770,1.0,0,0,1020,750,1963,538000.0
3.0,2.0,1540,1.0,0,0,1120,420,1961,385500.0
4.0,2.5,2650,2.0,0,0,2650,0,2000,428400.0
4.0,2.75,2690,2.0,0,0,2690,0,1998,346290.0
4.0,2.75,2210,2.0,0,0,2210,0,1999,587000.0
4.0,2.5,2390,2.0,0,0,2390,0,2003,355000.0
5.0,2.75,2580,1.0,0,0,1480,1100,1964,650000.0
4.0,2.5,2160,2.0,0,0,2160,0,2003,340000.0
4.0,2.5,2230,1.0,0,0,1430,800,1969,565000.0
4.0,2.0,2000,1.5,0,0,2000,0,1925,630000.0
3.0,1.0,1280,1.0,0,0,1280,0,1916,227000.0
4.0,2.75,2810,1.0,0,0,1640,1170,1978,600000.0
4.0,1.75,1680,1.0,0,0,1680,0,1974,540400.0
3.0,2.5,2150,2.0,0,0,2150,0,1995,569000.0
3.0,2.5,2820,2.0,0,0,2820,0,2004,735000.0
3.0,2.25,1750,1.0,0,0,1210,540,1987,434000.0
2.0,2.0,1060,1.0,0,0,1000,60,1914,578888.0
4.0,2.75,2430,1.0,0,0,2430,0,1967,465425.0
4.0,2.75,2660,1.5,0,0,1590,1070,1986,280500.0
2.0,2.0,1670,1.0,0,0,1670,0,2007,539950.0
3.0,2.0,1380,1.0,0,0,1380,0,1968,406430.0
4.0,3.75,4160,2.0,0,0,4160,0,1991,1150000.0
3.0,2.5,1790,2.0,0,0,1790,0,1992,250000.0
3.0,2.5,1940,1.0,0,0,1460,480,1989,266000.0
3.0,2.0,1390,1.0,0,0,1390,0,1996,258000.0
3.0,2.0,2200,1.0,0,2,1200,1000,1961,472000.0
3.0,2.25,1264,2.0,0,0,1264,0,2003,530000.0
2.0,1.0,1095,1.5,0,0,1095,0,1901,302282.0
2.0,1.0,850,1.0,0,0,750,100,1916,370000.0
4.0,2.0,1760,1.5,0,0,1170,590,1948,625000.0
1.0,1.0,690,1.0,0,0,690,0,1917,142500.0
3.0,1.75,1400,1.0,0,0,1400,0,1961,334000.0
5.0,3.0,1810,2.0,0,0,1810,0,1998,362000.0
2.0,1.0,1310,1.0,0,0,950,360,1942,181000.0
3.0,1.0,1400,1.0,0,0,1400,0,1968,241500.0
3.0,1.75,2350,1.0,0,0,1180,1170,1964,245000.0
3.0,1.0,1150,1.0,0,0,1150,0,1968,227500.0
5.0,1.5,1710,1.5,0,0,1710,0,1961,158550.0
3.0,2.25,1660,1.0,0,0,1130,530,1968,450000.0
3.0,1.75,1950,1.0,0,0,1950,0,1967,485000.0
4.0,1.75,1780,1.0,0,0,1780,0,1967,353000.0
4.0,3.0,2450,2.0,0,0,2450,0,2004,500000.0
1.0,2.25,2060,1.5,0,0,1560,500,1927,360000.0
3.0,1.5,1540,1.0,0,0,1540,0,1966,357500.0
3.0,2.5,1650,2.0,0,0,1650,0,1998,272000.0
3.0,1.0,1160,1.0,0,0,1160,0,1960,422000.0
2.0,2.0,1440,1.0,0,0,1440,0,1985,365000.0
3.0,1.75,2150,1.0,0,0,1610,540,1966,450000.0
2.0,1.0,1060,1.0,0,0,1060,0,1950,275053.0
3.0,2.75,2620,1.0,0,1,2620,0,1949,1880000.0
3.0,1.75,1630,1.0,0,0,960,670,1955,725000.0
3.0,1.75,1840,1.0,0,0,1500,340,1985,235000.0
2.0,1.0,820,1.0,0,0,820,0,1949,510000.0
2.0,1.0,820,1.0,0,0,820,0,1949,489950.0
3.0,2.5,2010,2.0,0,0,2010,0,1998,463000.0
4.0,2.25,1990,2.0,0,0,1990,0,1991,536000.0
4.0,2.5,2990,2.0,0,0,2990,0,2003,375000.0
4.0,2.5,2540,2.0,0,0,2540,0,1999,630000.0
3.0,2.25,1640,1.0,0,0,1140,500,1963,362000.0
4.0,2.75,2500,1.0,0,2,1490,1010,1979,350000.0
4.0,3.5,4020,2.0,0,0,4020,0,2001,1691000.0
3.0,2.0,1500,1.0,0,0,1390,110,1943,255000.0
4.0,2.5,1594,1.0,0,0,1088,506,1975,269000.0
4.0,3.0,2130,1.5,0,0,2130,0,1930,370000.0
3.0,1.0,1130,1.0,0,0,1130,0,1961,270000.0
3.0,2.0,1690,1.0,0,0,1690,0,1997,265000.0
2.0,1.0,1440,1.0,0,0,960,480,1946,487000.0
4.0,3.25,3270,2.0,0,0,3270,0,2001,835000.0
4.0,3.25,4350,1.0,0,0,2200,2150,2006,850000.0
4.0,2.75,1610,1.0,0,0,1020,590,1982,575000.0
3.0,1.0,950,1.0,0,0,950,0,1968,335000.0
3.0,1.0,1010,1.0,0,0,1010,0,1948,318000.0
3.0,2.0,1420,1.0,0,0,1420,0,1980,510000.0
3.0,1.5,1200,1.0,0,0,1200,0,1965,242500.0
5.0,2.25,2020,1.0,0,0,1010,1010,1963,750000.0
5.0,3.5,3390,2.0,0,2,3390,0,2003,439900.0
2.0,1.0,1700,1.5,0,0,1460,240,1914,710000.0
5.0,3.25,3410,2.0,0,3,2760,650,1912,2400000.0
3.0,1.75,2030,1.0,0,0,1630,400,1976,435000.0
4.0,2.75,2860,1.0,0,1,1560,1300,1946,874000.0
4.0,1.75,1690,1.0,0,0,870,820,1984,385000.0
2.0,1.0,760,1.0,0,0,760,0,1930,110000.0
3.0,1.75,1780,1.0,0,0,1210,570,1976,477000.0
3.0,2.0,1550,1.5,0,0,1550,0,1918,500000.0
4.0,2.5,4090,2.0,0,0,4090,0,2005,885000.0
2.0,1.0,880,1.0,0,0,880,0,1955,235000.0
3.0,2.75,1320,1.0,0,0,880,440,1995,210000.0
2.0,1.0,950,1.0,0,0,950,0,1910,320000.0
3.0,1.75,1390,1.0,0,0,1390,0,1985,406000.0
3.0,1.75,1900,1.0,0,0,1220,680,1963,350000.0
2.0,0.75,1392,1.5,0,0,1392,0,1978,350000.0
4.0,2.5,3340,2.0,0,2,3340,0,1999,720000.0
4.0,2.75,2750,1.0,0,3,1720,1030,1981,604700.0
3.0,1.0,1400,1.5,0,0,1400,0,1920,343000.0
3.0,2.25,2220,1.0,0,0,1280,940,1982,558000.0
4.0,1.0,1210,1.5,0,0,1210,0,1922,364000.0
3.0,1.75,2390,1.0,0,0,1290,1100,1959,420000.0
5.0,2.0,1870,1.5,0,0,1870,0,1960,450000.0
2.0,1.5,940,1.0,0,0,810,130,1925,392000.0
4.0,1.0,1120,1.0,0,0,860,260,1939,100000.0
3.0,2.5,1250,3.0,0,2,1250,0,2005,480000.0
3.0,1.5,1060,1.0,0,0,1060,0,1955,212000.0
5.0,2.5,2410,1.0,0,0,1600,810,1978,560000.0
5.0,2.75,2844,2.0,0,0,2844,0,2013,359950.0
4.0,2.5,2200,1.0,0,0,1330,870,1979,535000.0
5.0,4.0,3460,2.0,0,0,2830,630,2012,980000.0
2.0,1.0,1580,2.0,0,2,1580,0,1921,720000.0
2.0,1.0,1520,1.0,0,0,920,600,1951,619950.0
3.0,2.5,2260,2.0,0,0,2260,0,1994,489000.0
4.0,2.0,1800,1.0,0,0,1000,800,1923,415000.0
4.0,2.5,2650,2.0,0,0,2650,0,1987,672500.0
3.0,1.0,1000,1.0,0,0,1000,0,1985,352500.0
4.0,2.0,2300,1.0,0,0,1150,1150,1962,258750.0
3.0,1.0,1080,1.0,0,0,1080,0,1916,350000.0
3.0,1.0,902,1.0,0,0,902,0,1965,152000.0
2.0,1.0,730,1.0,0,0,730,0,1946,378500.0
4.0,1.75,2600,1.5,0,0,2600,0,1965,1017000.0
3.0,1.5,1570,1.0,0,0,1570,0,1956,419000.0
5.0,3.0,2876,1.0,0,2,1970,906,1973,895000.0
4.0,2.25,2290,1.0,0,0,1780,510,1976,668500.0
2.0,2.5,1470,2.0,0,0,1470,0,2005,487000.0
3.0,3.5,2620,2.0,0,0,1970,650,1992,538000.0
5.0,1.5,2680,1.0,0,0,1450,1230,1963,898000.0
4.0,2.0,2020,1.0,0,0,2020,0,1995,315000.0
3.0,2.5,2100,2.0,0,4,2100,0,1945,800000.0
3.0,1.75,1510,1.0,0,0,1510,0,1962,516130.0
3.0,2.5,2850,1.5,1,4,1790,1060,1978,1600000.0
4.0,2.5,4280,2.0,0,0,3400,880,1999,1200000.0
4.0,2.5,3238,1.0,0,2,1678,1560,1979,355425.0
3.0,2.5,2740,2.0,0,2,2740,0,1913,1157400.0
4.0,2.5,2020,2.0,0,0,2020,0,1954,689000.0
3.0,3.25,1520,3.0,0,0,1520,0,2000,500000.0
5.0,2.5,3860,1.0,0,3,2300,1560,1955,430000.0
4.0,2.25,1600,1.0,0,0,1080,520,1979,299500.0
4.0,2.5,2090,2.0,0,0,2090,0,1989,349950.0
5.0,3.25,4020,2.0,0,0,3120,900,2010,1419000.0
4.0,2.25,2910,2.0,0,0,2910,0,1988,998000.0
3.0,1.0,900,1.0,0,0,900,0,1970,329000.0
3.0,1.75,1720,2.0,0,0,1720,0,1981,575000.0
5.0,2.25,3030,2.0,0,0,2600,430,1961,529900.0
4.0,2.5,3030,1.0,0,0,2380,650,2003,1470000.0
4.0,1.75,2190,1.0,0,0,1450,740,1962,725000.0
3.0,2.5,1680,2.0,0,0,1680,0,1987,286000.0
3.0,2.0,1210,1.0,0,0,1210,0,1954,335000.0
3.0,1.5,1120,1.0,0,0,1120,0,1955,395300.0
4.0,2.75,3180,2.0,0,0,3020,160,2004,510000.0
3.0,1.0,920,1.0,0,0,920,0,1970,203000.0
2.0,1.0,700,1.0,0,0,700,0,1953,248000.0
3.0,2.25,2540,2.0,0,0,2540,0,1991,265000.0
4.0,1.5,2100,1.5,0,0,2100,0,1912,1000000.0
3.0,1.0,1540,1.5,0,0,1540,0,1949,1000000.0
3.0,2.0,1420,1.0,0,0,1420,0,1990,241400.0
4.0,1.75,1450,1.0,0,0,1450,0,1966,309950.0
3.0,1.75,1550,1.0,0,0,830,720,1945,294010.0
3.0,2.25,1920,2.0,0,0,1920,0,1984,345000.0
3.0,2.25,1920,2.0,0,0,1920,0,1984,625000.0
4.0,2.5,2510,2.0,0,0,2510,0,2002,660000.0
2.0,2.0,1660,1.0,0,0,1660,0,2003,559000.0
4.0,3.25,3990,2.0,0,0,3990,0,2004,866000.0
3.0,2.0,2350,1.5,0,0,1810,540,1939,770000.0
3.0,1.5,1350,1.0,0,0,1350,0,1968,259950.0
5.0,2.75,2980,1.0,0,0,1710,1270,1968,352000.0
5.0,4.75,6390,2.0,0,0,4560,1830,1940,2466350.0
3.0,2.0,1590,1.0,0,0,1590,0,1966,395000.0
4.0,1.75,1400,1.5,0,0,1400,0,1942,276500.0
3.0,2.25,1880,1.5,0,0,1880,0,1987,530000.0
4.0,3.25,3500,2.0,0,0,3500,0,1987,798000.0
2.0,2.0,1370,1.0,0,0,1370,0,1986,380000.0
4.0,2.5,2810,2.0,0,0,2810,0,2001,350000.0
3.0,2.5,2220,2.0,0,0,2220,0,1990,325000.0
3.0,2.5,2110,2.0,0,0,2110,0,1989,336000.0
3.0,2.25,1720,1.0,0,0,1440,280,1974,286900.0
5.0,2.25,1780,1.0,0,0,1330,450,1976,472000.0
3.0,1.75,1410,2.0,0,0,1410,0,1985,263000.0
3.0,3.0,2110,1.0,0,2,1110,1000,1965,565000.0
3.0,2.5,2700,2.0,0,0,2700,0,1992,765000.0
3.0,2.25,2610,1.0,1,4,2610,0,1963,1517000.0
3.0,2.0,1660,1.0,0,0,830,830,1981,405000.0
4.0,3.5,4570,2.0,0,0,4570,0,2002,1098000.0
3.0,3.0,3760,1.0,0,0,2640,1120,1979,555000.0
3.0,2.5,1610,2.0,0,0,1610,0,2006,305000.0
3.0,2.25,1740,1.0,0,0,1390,350,1992,289950.0
5.0,3.5,3530,2.0,0,0,2380,1150,1999,487500.0
3.0,1.0,840,1.0,0,0,840,0,1959,96500.0
3.0,1.0,840,1.0,0,0,840,0,1959,185000.0
4.0,1.0,1470,1.5,0,0,1470,0,1945,150550.0
4.0,2.0,2470,1.5,0,0,1970,500,1948,339000.0
4.0,1.75,2220,1.0,0,1,1280,940,1950,675000.0
3.0,1.75,1720,1.0,0,0,960,760,1924,615000.0
4.0,2.5,2700,2.0,0,0,2700,0,1994,837500.0
2.0,1.0,950,1.0,0,0,950,0,1932,250000.0
3.0,2.5,1790,2.0,0,0,1790,0,1989,583000.0
3.0,2.5,1610,3.0,0,0,1610,0,2000,499000.0
3.0,2.5,2290,2.0,0,0,2290,0,2001,550000.0
4.0,2.5,2170,1.0,0,0,2170,0,1980,400000.0
3.0,2.5,2100,2.0,0,0,2100,0,2008,990400.0
3.0,2.5,2320,1.5,0,0,2320,0,1974,600000.0
2.0,1.0,1120,1.0,0,0,1120,0,1954,325000.0
3.0,2.5,1530,2.0,0,0,1530,0,1991,265000.0
3.0,2.5,3490,1.0,0,3,1770,1720,1960,1620500.0
3.0,1.5,1180,1.0,0,0,1180,0,1960,347500.0
5.0,2.0,2050,1.5,0,0,1470,580,1912,629000.0
2.0,2.0,2360,1.5,0,0,2360,0,1997,1087500.0
4.0,2.5,2570,2.0,0,0,2570,0,1992,397500.0
2.0,1.0,1270,1.5,0,0,1270,0,1909,404500.0
3.0,1.5,1250,1.0,0,0,1250,0,1967,225000.0
3.0,2.25,2510,1.0,0,0,1610,900,1978,267000.0
4.0,3.75,2690,2.0,0,3,2120,570,1909,800000.0
4.0,2.5,2900,2.0,0,0,2900,0,2001,339000.0
4.0,2.5,3830,1.0,1,4,2370,1460,1981,1850000.0
5.0,1.0,1280,1.5,0,0,1280,0,1923,525000.0
5.0,3.5,4350,2.0,0,2,3520,830,2007,1150000.0
1.0,1.0,1370,1.5,0,0,1370,0,1921,565000.0
2.0,2.25,1230,2.0,0,0,960,270,2012,387000.0
4.0,2.5,2440,2.0,0,0,2440,0,1987,720000.0
4.0,3.5,4410,2.0,0,2,3420,990,1996,1500000.0
2.0,1.0,910,1.0,0,0,910,0,1936,235000.0
2.0,1.0,910,1.0,0,0,910,0,1936,365000.0
3.0,2.5,2150,2.0,0,0,2150,0,1988,368250.0
3.0,2.5,2150,2.0,0,0,2150,0,1988,580000.0
4.0,3.25,3190,2.0,1,4,2610,580,1956,1100000.0
4.0,2.5,2130,2.0,0,0,2130,0,2004,215000.0
4.0,2.5,2740,2.0,0,0,2740,0,1989,648000.0
4.0,3.0,3150,2.0,0,0,3150,0,2001,705000.0
3.0,2.25,1450,2.0,0,0,1180,270,2005,465000.0
5.0,2.0,2400,1.5,0,0,1900,500,1911,650000.0
4.0,2.25,2280,1.0,0,0,1140,1140,1963,335000.0
4.0,2.0,2310,1.5,0,0,2310,0,1984,640000.0
4.0,2.5,2460,2.0,0,0,2460,0,1989,638250.0
4.0,3.5,4200,2.0,0,2,3640,560,1996,1460000.0
4.0,2.0,1620,2.0,0,0,1620,0,1909,375000.0
4.0,1.75,2170,1.0,0,0,2170,0,1960,842000.0
3.0,2.25,2880,1.0,0,0,1710,1170,1970,499950.0
4.0,2.5,3280,2.0,0,3,3280,0,1985,810000.0
5.0,2.0,2900,2.0,0,0,2900,0,1969,310000.0
3.0,2.5,2160,1.0,0,0,1540,620,2014,730000.0
4.0,1.75,2250,1.5,0,0,1420,830,1924,637800.0
3.0,1.0,1340,1.5,0,0,1340,0,1903,225000.0
4.0,1.0,1390,1.5,0,0,1390,0,1941,417500.0
4.0,2.0,1600,1.0,0,0,1600,0,1972,265000.0
4.0,2.5,2050,2.0,0,0,2050,0,1987,550000.0
3.0,2.0,2570,1.0,0,0,2570,0,1968,625700.0
3.0,2.5,2660,2.0,0,0,2660,0,1991,595000.0
3.0,1.5,1540,1.0,0,0,1540,0,1972,270000.0
5.0,3.0,2640,2.0,0,0,2140,500,1906,739375.0
2.0,1.75,1210,2.0,0,0,1210,0,2014,357562.0
4.0,2.5,3760,2.0,0,0,3760,0,1987,1010000.0
2.0,1.75,1350,1.0,0,0,1350,0,2004,455000.0
5.0,2.25,2600,1.0,0,2,1810,790,1969,310000.0
3.0,2.75,3900,2.0,0,0,3460,440,1967,415000.0
2.0,1.0,1340,1.0,0,2,1340,0,1950,452000.0
3.0,2.0,1760,1.0,0,0,1760,0,1953,810000.0
3.0,2.0,1840,1.0,0,0,1010,830,1951,730001.0
3.0,2.25,2980,1.0,0,0,2230,750,1989,825000.0
3.0,2.5,1730,2.0,0,0,1730,0,1996,665000.0
4.0,1.75,1650,1.0,0,0,1650,0,1968,327500.0
3.0,2.5,3370,2.0,0,0,3370,0,1988,699950.0
3.0,2.5,2200,2.0,0,0,2200,0,1985,424000.0
4.0,2.5,2180,1.5,0,0,1420,760,1926,657000.0
3.0,1.75,1490,1.0,0,0,1210,280,1974,445000.0
3.0,2.5,1530,2.0,0,0,1050,480,2007,450000.0
3.0,1.0,1180,1.0,0,0,1180,0,1964,350000.0
4.0,2.5,2080,2.0,0,0,2080,0,1996,460000.0
4.0,2.5,3200,1.0,0,0,1610,1590,1970,385000.0
4.0,2.25,1880,2.0,0,0,1880,0,1993,272000.0
3.0,2.5,2510,2.0,0,0,2510,0,2001,535000.0
2.0,1.0,1060,1.0,0,0,1060,0,1969,216500.0
3.0,2.5,2130,2.0,0,0,2130,0,1989,325000.0
3.0,1.75,1320,1.0,0,0,1320,0,1968,420200.0
3.0,1.75,1040,1.0,0,0,1040,0,1951,258000.0
3.0,2.0,1150,1.5,0,0,1150,0,1917,450000.0
4.0,2.25,2120,2.0,0,0,1420,700,1926,720168.0
3.0,2.0,2130,1.5,0,0,1330,800,1925,652000.0
4.0,2.5,2340,2.0,0,0,2340,0,1989,569500.0
4.0,1.75,2250,1.0,0,0,2250,0,1963,411000.0
3.0,1.75,1890,1.0,0,0,1290,600,1974,524950.0
2.0,1.0,1140,1.0,0,0,760,380,1942,153000.0
3.0,2.5,2780,2.0,0,2,2780,0,2000,775000.0
4.0,2.5,2390,2.0,0,0,2390,0,1997,338500.0
3.0,1.75,2390,1.0,0,0,1500,890,1975,570000.0
3.0,2.0,2680,1.0,0,0,1880,800,1950,653000.0
2.0,2.5,1560,2.0,0,0,1080,480,2008,435000.0
2.0,1.0,1130,1.0,0,0,1130,0,1952,207000.0
2.0,1.0,1120,1.0,0,2,1120,0,1971,540000.0
4.0,2.25,2050,2.0,0,2,1770,280,1965,386000.0
5.0,2.25,2600,1.5,0,0,2600,0,1969,265000.0
3.0,2.25,1050,2.0,0,0,740,310,2006,250000.0
3.0,2.0,2600,2.0,0,4,1930,670,1970,1697000.0
4.0,2.5,2811,2.0,0,0,2811,0,2009,455000.0
4.0,3.25,4060,2.0,0,3,4060,0,2000,1795000.0
3.0,2.0,2260,1.0,0,3,1130,1130,1941,759000.0
4.0,2.75,4430,2.0,0,0,4430,0,1990,970000.0
1.0,,600,1.0,0,0,600,0,1950,280000.0
3.0,2.25,2430,1.0,0,0,1430,1000,1978,690000.0
3.0,2.5,3420,1.0,0,0,1750,1670,1987,789900.0
2.0,1.0,1180,1.5,0,0,1180,0,1926,447500.0
4.0,2.25,2010,1.0,0,0,1220,790,1974,440000.0
3.0,2.0,1230,1.0,0,0,1230,0,1994,278000.0
5.0,2.5,2750,1.5,0,0,1750,1000,1904,980000.0
3.0,2.75,1300,1.0,0,0,860,440,1996,245000.0
3.0,1.5,1150,1.0,0,0,1150,0,1971,287000.0
3.0,1.75,2220,1.0,0,0,1110,1110,1988,435000.0
3.0,2.5,2050,2.0,0,0,2050,0,1989,585000.0
4.0,1.75,1700,1.0,0,0,1700,0,1957,616000.0
3.0,1.75,1610,1.0,0,0,1100,510,1978,203000.0
4.0,2.75,2720,2.0,0,0,1790,930,1920,860000.0
4.0,2.5,2190,1.0,0,2,1170,1020,1973,833000.0
4.0,2.75,2730,2.0,0,0,2730,0,2003,565000.0
3.0,2.5,2490,2.0,0,0,2490,0,1991,572500.0
4.0,2.0,1510,1.0,0,0,1510,0,1955,254000.0
4.0,4.25,4720,3.0,0,4,4720,0,1971,1525000.0
4.0,3.0,3810,2.0,0,0,3810,0,2003,900000.0
3.0,2.5,1950,2.0,0,0,1950,0,1996,899000.0
3.0,2.0,1300,1.0,0,0,1300,0,1943,560000.0
3.0,1.75,1610,1.0,0,0,1180,430,1976,512500.0
4.0,2.5,2040,1.5,0,0,1180,860,1924,775000.0
2.0,1.0,700,1.0,0,0,700,0,1953,200000.0
3.0,1.0,970,1.0,0,0,720,250,1943,172000.0
3.0,1.0,910,1.0,0,0,910,0,1956,219900.0
3.0,1.0,1060,1.0,0,0,1060,0,1952,641200.0
5.0,3.25,2180,2.0,0,0,2180,0,1982,473000.0
3.0,1.75,2050,1.0,0,0,1400,650,1984,540000.0
2.0,1.0,750,1.0,0,0,750,0,1945,295000.0
3.0,1.0,800,1.0,0,0,800,0,1908,370000.0
4.0,2.25,3470,1.5,0,1,2360,1110,1906,1727000.0
3.0,1.5,1390,1.0,0,0,1390,0,1922,275000.0
3.0,1.0,900,1.0,0,0,900,0,1969,89000.0
2.0,1.75,1050,1.5,0,0,1050,0,1975,175000.0
3.0,2.5,2410,1.0,0,2,1600,810,1989,490000.0
3.0,2.25,1180,2.0,0,0,1180,0,1986,342400.0
3.0,1.0,1140,2.0,0,0,1140,0,1904,345000.0
2.0,1.0,700,1.0,0,0,700,0,1946,399000.0
4.0,2.5,2060,1.0,0,0,1320,740,1960,550000.0
3.0,2.25,2230,1.0,0,0,1630,600,1974,652450.0
2.0,2.25,1950,1.0,0,0,1350,600,1953,438000.0
3.0,1.75,2100,1.0,0,2,1340,760,1941,605000.0
4.0,2.5,2130,1.0,0,0,1330,800,1969,395000.0
3.0,2.0,1880,2.0,0,0,1880,0,1902,449950.0
4.0,2.5,2310,2.0,0,0,2310,0,2003,651100.0
3.0,1.0,880,1.0,0,0,880,0,1945,241000.0
5.0,5.0,5450,2.0,0,0,5450,0,2014,3418800.0
2.0,1.5,1290,1.0,0,0,660,630,1969,268500.0
2.0,1.0,1010,1.0,0,0,1010,0,1956,200000.0
4.0,1.75,1690,1.0,0,0,890,800,1946,400375.0
2.0,1.75,1350,1.0,0,0,1350,0,2005,429000.0
3.0,1.0,680,1.0,0,0,680,0,1903,230000.0
4.0,2.25,2860,2.0,0,0,2860,0,1982,1200000.0
1.0,1.0,610,1.0,0,0,610,0,1918,314200.0
4.0,2.5,2660,1.0,0,0,1880,780,1967,513000.0
2.0,1.0,1390,1.0,0,0,960,430,1908,535000.0
6.0,3.0,2290,2.0,0,0,2290,0,1980,420000.0
3.0,2.5,2110,2.0,0,0,2110,0,1989,345950.0
3.0,2.0,1200,1.0,0,1,600,600,1931,483500.0
4.0,2.25,2360,2.0,0,3,1520,840,2001,695000.0
4.0,2.5,2350,2.0,0,0,2350,0,1993,295000.0
3.0,2.25,1590,1.0,0,0,1060,530,1976,434975.0
3.0,2.5,1810,2.0,0,0,1810,0,1992,513000.0
3.0,1.75,1900,1.0,0,0,1900,0,1963,360000.0
3.0,1.0,1250,1.0,0,0,1250,0,1956,234900.0
4.0,3.5,3280,2.0,0,0,3280,0,2007,963000.0
2.0,1.5,870,1.0,0,0,870,0,1924,595000.0
4.0,3.25,3570,2.0,0,2,3570,0,2006,942500.0
4.0,3.25,3780,2.0,0,0,3780,0,2002,1029000.0
3.0,1.0,1190,1.5,0,0,1190,0,1904,350000.0
4.0,2.0,2280,2.0,0,0,2280,0,1991,416500.0
3.0,1.0,1030,1.5,0,0,1030,0,1912,209900.0
3.0,1.75,2870,1.5,0,0,1840,1030,1907,802000.0
4.0,1.5,1520,1.0,0,0,1520,0,1960,230000.0
3.0,3.0,3700,2.0,0,0,3700,0,1982,489000.0
3.0,1.5,2240,1.0,0,0,1620,620,1956,497000.0
3.0,2.25,1920,1.0,0,0,1520,400,1965,250000.0
3.0,3.0,2560,2.0,0,0,2110,450,1994,925000.0
4.0,2.5,1840,2.0,0,0,1840,0,1991,390000.0
3.0,2.75,2080,1.0,0,0,2080,0,1988,415000.0
3.0,2.0,1600,1.0,0,0,1600,0,1952,785000.0
3.0,2.0,2168,1.5,0,0,2168,0,1907,575000.0
2.0,1.0,860,1.0,0,0,860,0,1924,170000.0
4.0,1.75,2100,1.0,0,0,1100,1000,1915,750000.0
3.0,1.0,1140,1.0,0,0,1140,0,1967,230000.0
4.0,3.0,3090,2.0,0,0,3090,0,1978,855000.0
3.0,1.0,1330,2.0,0,0,1330,0,1967,235000.0
2.0,1.0,1360,1.0,0,0,1360,0,1937,335000.0
5.0,3.0,3420,2.0,0,0,2540,880,1952,1195000.0
4.0,2.0,2180,1.5,0,0,2060,120,1927,677000.0
3.0,2.0,1800,2.0,0,0,1600,200,1925,575000.0
2.0,1.0,1120,1.0,0,0,1120,0,1924,450000.0
3.0,2.5,2980,2.0,0,0,2980,0,1999,817250.0
4.0,2.25,2600,1.0,0,0,1810,790,1968,440000.0
2.0,2.0,1550,1.5,0,0,1550,0,1900,526000.0
3.0,2.25,3330,2.0,0,0,3330,0,1986,762500.0
4.0,2.5,2200,2.0,0,0,2200,0,2000,325000.0
4.0,3.5,3840,2.0,0,0,3840,0,1998,840000.0
2.0,1.0,840,1.0,0,0,840,0,1939,377500.0
3.0,1.5,1270,1.0,0,0,1270,0,1954,212500.0
4.0,2.5,3240,2.0,0,0,3240,0,1985,749400.0
3.0,2.5,2480,1.5,1,3,2480,0,1974,663000.0
3.0,2.25,4470,2.0,0,2,3240,1230,1953,1476000.0
3.0,1.0,1780,1.0,0,0,1060,720,1957,261000.0
4.0,2.5,1850,2.0,0,0,1850,0,1997,515000.0
3.0,2.25,2200,2.0,0,0,2200,0,1987,410000.0
3.0,2.25,2760,1.0,0,0,2760,0,1969,336000.0
2.0,1.0,1090,1.0,0,0,1090,0,1948,440000.0
4.0,2.75,3090,2.0,0,0,3090,0,2014,908950.0
2.0,1.0,820,1.0,0,0,820,0,1968,554000.0
3.0,2.25,1445,2.0,0,0,1300,145,2003,387000.0
4.0,2.25,1810,2.0,0,0,1810,0,1961,268643.0
3.0,1.75,1620,1.0,0,0,920,700,1954,514000.0
2.0,1.75,1060,2.0,0,0,1060,0,1977,420000.0
3.0,1.75,1050,1.0,0,0,1050,0,1968,199000.0
3.0,1.0,1010,1.0,0,0,1010,0,1949,225000.0
4.0,2.5,2050,2.0,0,0,2050,0,1993,320000.0
2.0,1.0,970,1.0,0,0,970,0,1904,204995.0
3.0,2.0,1540,2.0,0,0,1540,0,2005,376000.0
4.0,2.75,3000,2.0,0,0,3000,0,2004,705000.0
4.0,2.5,3190,2.0,0,2,3190,0,2001,725995.0
4.0,2.5,1870,1.0,0,0,1100,770,1977,285000.0
4.0,2.5,2200,2.0,0,0,2200,0,1987,285000.0
4.0,2.5,3070,2.0,0,0,3070,0,2005,731000.0
4.0,3.75,3730,2.0,0,3,2820,910,1986,1564350.0
4.0,2.5,2440,1.0,0,0,2440,0,1955,510000.0
2.0,1.0,990,1.0,0,0,990,0,1909,620000.0
3.0,4.0,4160,2.0,0,0,4160,0,1989,1110000.0
4.0,3.5,3670,2.0,0,0,2870,800,2005,796000.0
3.0,1.5,910,1.0,0,0,910,0,1943,255000.0
3.0,2.5,1940,2.0,0,0,1940,0,2000,807000.0
4.0,2.5,1780,2.0,0,0,1780,0,2000,315000.0
3.0,2.25,2200,2.0,0,0,2200,0,1986,637000.0
4.0,4.25,6410,2.5,0,2,5610,800,1906,2725000.0
3.0,2.0,2070,1.0,0,0,1220,850,1981,490000.0
3.0,1.75,2040,1.0,0,0,1020,1020,1962,253000.0
4.0,2.5,2320,2.0,0,0,2320,0,2004,325900.0
2.0,2.0,1440,1.0,0,0,870,570,1952,425000.0
4.0,2.5,1700,2.0,0,0,1700,0,1997,215000.0
4.0,2.5,1700,2.0,0,0,1700,0,1997,315000.0
3.0,2.0,2050,1.0,0,0,1180,870,1926,724800.0
2.0,1.0,800,1.0,0,0,800,0,1953,295000.0
3.0,1.75,1800,1.0,0,0,1350,450,1951,509007.0
5.0,2.0,1460,1.5,0,0,1460,0,1910,306000.0
3.0,1.75,1290,1.0,0,0,1290,0,1984,205000.0
3.0,1.5,1900,1.0,0,0,1200,700,1968,275000.0
3.0,1.75,1480,1.0,0,2,1480,0,1963,685000.0
4.0,2.5,2090,1.0,0,0,1220,870,1969,465000.0
4.0,2.25,1950,1.0,0,0,1330,620,1968,560000.0
3.0,1.75,1250,1.0,0,0,1250,0,1964,458500.0
3.0,1.0,990,1.0,0,0,990,0,1959,354000.0
3.0,2.5,2740,2.0,0,0,2740,0,1998,441000.0
3.0,1.75,1260,1.0,0,0,1110,150,1952,194000.0
4.0,2.5,2150,2.0,0,0,2150,0,1991,316500.0
3.0,1.75,1750,1.5,0,0,1230,520,1929,524950.0
3.0,2.25,2880,2.0,0,4,1920,960,1983,1052000.0
4.0,2.25,2590,2.0,0,0,2590,0,1975,925000.0
3.0,1.75,2430,1.5,0,0,1830,600,1924,780000.0
2.0,2.0,1470,2.0,0,0,1470,0,2005,241000.0
3.0,2.75,2020,1.0,0,0,1270,750,1954,519000.0
2.0,1.0,610,1.0,0,0,610,0,1918,286000.0
3.0,2.0,3000,1.0,0,0,1500,1500,1962,400000.0
2.0,1.0,920,1.0,0,0,920,0,1923,255000.0
3.0,1.75,1070,1.0,0,0,1070,0,1953,152000.0
4.0,2.0,3410,2.0,0,0,3410,0,1972,599000.0
4.0,2.5,1820,2.0,0,0,1820,0,2001,330000.0
2.0,1.0,1060,1.0,0,0,1060,0,1926,461000.0
5.0,2.5,3070,2.0,0,0,3070,0,1995,620000.0
4.0,2.5,2300,1.0,0,0,1840,460,1958,352500.0
3.0,2.0,1610,1.0,0,0,1260,350,1988,435000.0
5.0,2.75,2830,2.0,0,0,2830,0,2006,725000.0
3.0,1.0,970,1.0,0,0,970,0,1982,300000.0
3.0,2.5,1680,2.0,0,0,1680,0,1989,252000.0
4.0,2.75,2040,1.0,0,0,1260,780,1974,464625.0
3.0,1.0,1450,2.0,0,0,1450,0,1950,340000.0
4.0,2.25,2870,1.5,0,0,1980,890,1905,1325000.0
5.0,2.0,1870,1.0,0,0,1120,750,1969,455000.0
4.0,3.5,2490,2.0,0,0,2490,0,2003,495000.0
4.0,2.5,3350,2.0,0,0,2640,710,2002,925000.0
4.0,2.75,3190,2.0,0,0,3190,0,2006,587000.0
3.0,1.75,1560,1.0,0,0,780,780,1944,524000.0
4.0,2.5,2750,2.0,0,0,1960,790,1905,1030000.0
2.0,1.0,920,1.0,0,0,920,0,1980,176000.0
2.0,1.0,1140,1.0,0,0,1140,0,1947,249900.0
3.0,2.5,2520,1.5,0,0,2520,0,1988,499500.0
5.0,3.5,3150,1.0,0,0,1620,1530,1974,600000.0
4.0,2.5,2040,2.0,0,0,2040,0,2003,294000.0
4.0,2.0,1780,1.0,0,0,1780,0,1963,272000.0
3.0,2.5,2240,2.0,0,0,2240,0,1996,390000.0
4.0,2.5,3270,1.0,0,3,2320,950,1971,700000.0
5.0,2.75,3110,2.0,0,0,3110,0,2006,635000.0
4.0,1.5,1850,2.0,0,0,1660,190,1929,920000.0
3.0,1.75,1570,1.0,0,0,1190,380,1983,500000.0
2.0,1.0,750,1.0,0,0,750,0,1942,263500.0
4.0,2.25,2240,2.0,0,0,2240,0,1967,975000.0
3.0,2.5,1870,2.0,0,0,1870,0,2001,575000.0
4.0,2.5,2683,2.0,0,0,2683,0,1987,822000.0
3.0,1.0,1490,1.0,0,0,1490,0,1954,300000.0
4.0,2.5,2340,2.0,0,0,2340,0,1999,487600.0
4.0,2.0,1700,1.0,0,0,850,850,1955,500000.0
2.0,2.0,1450,3.0,0,0,1450,0,2014,680000.0
3.0,2.5,3310,2.0,0,2,3310,0,2004,419000.0
4.0,1.75,1520,1.0,0,0,1520,0,1949,450000.0
5.0,1.75,1260,1.5,0,0,1260,0,1926,650000.0
3.0,1.75,1840,1.0,0,0,1840,0,1964,550000.0
4.0,2.0,1750,1.0,0,1,1070,680,1942,330000.0
4.0,1.0,1450,1.5,0,0,1450,0,1932,282510.0
4.0,4.0,6330,2.0,0,2,4900,1430,2000,2385000.0
2.0,2.0,1260,1.0,0,0,1020,240,1983,230000.0
4.0,1.75,2100,2.0,0,0,2100,0,1909,750000.0
4.0,2.5,2430,2.0,0,0,2430,0,2002,321000.0
4.0,3.25,4250,2.0,0,3,3350,900,1980,2196000.0
4.0,2.0,1830,1.0,0,0,1370,460,1958,245000.0
2.0,1.0,1310,1.0,0,0,1310,0,1913,510000.0
4.0,3.25,3090,2.0,0,0,2370,720,2004,751000.0
4.0,2.5,2560,2.0,0,0,2560,0,1987,675000.0
3.0,1.75,1930,1.0,0,0,1930,0,1967,295000.0
2.0,1.0,1460,1.0,0,0,1260,200,1925,312000.0
3.0,3.0,3460,2.0,0,0,2560,900,1988,730000.0
5.0,3.5,3290,2.0,0,0,2670,620,2005,762500.0
3.0,1.0,820,1.5,0,0,820,0,1910,150000.0
3.0,1.0,1480,1.0,0,0,760,720,1954,270000.0
4.0,2.0,1420,1.0,0,0,1420,0,1963,400000.0
3.0,2.5,2790,2.0,0,0,2790,0,2002,650000.0
2.0,1.5,1390,1.0,0,0,970,420,1954,530000.0
3.0,1.0,950,1.0,0,0,950,0,1954,248000.0
4.0,3.5,3000,1.0,0,0,1780,1220,1949,760000.0
4.0,1.0,1280,1.5,0,0,1280,0,1960,199000.0
2.0,1.0,870,1.0,0,0,870,0,1960,240000.0
3.0,1.5,1360,2.0,0,0,1360,0,1945,415000.0
3.0,1.0,1000,1.0,0,0,1000,0,1959,228000.0
4.0,2.5,2740,1.0,0,0,1980,760,1992,525000.0
3.0,1.75,1560,1.0,0,0,810,750,1940,399950.0
4.0,2.5,2590,2.0,0,0,2590,0,1988,781000.0
3.0,2.5,1850,2.5,0,0,1560,290,2004,827000.0
5.0,2.25,2500,1.5,0,0,2500,0,1968,525000.0
4.0,2.5,3280,2.0,0,0,3280,0,2004,671300.0
2.0,1.0,670,1.0,0,0,670,0,1919,175000.0
5.0,2.75,2890,1.0,0,0,2150,740,1963,1100000.0
5.0,2.5,3000,1.0,0,0,1500,1500,1966,800000.0
4.0,2.5,1920,2.0,0,0,1920,0,2002,329950.0
4.0,3.25,1960,2.0,0,0,1960,0,1979,445000.0
3.0,1.75,2000,1.0,0,0,1140,860,1979,237000.0
6.0,4.0,3600,2.0,0,0,2610,990,1945,1112500.0
4.0,2.5,2740,2.0,0,0,2740,0,2006,438900.0
9.0,4.5,3650,2.0,0,0,2530,1120,1915,1280000.0
4.0,2.5,2310,2.0,0,0,2310,0,2005,600000.0
4.0,2.5,2095,2.0,0,0,2095,0,2002,670000.0
2.0,2.0,1560,1.0,0,0,1560,0,2004,519000.0
3.0,2.25,1880,1.0,0,0,1390,490,1984,320000.0
2.0,1.5,840,2.0,0,0,840,0,2005,270000.0
3.0,2.5,2730,2.0,0,0,2730,0,1998,1000000.0
1.0,1.0,860,1.0,0,0,860,0,1907,330000.0
3.0,2.0,2320,1.0,0,0,1510,810,1956,657500.0
3.0,1.75,1540,1.0,0,0,1540,0,1967,450000.0
3.0,1.0,890,1.5,0,0,890,0,1928,150000.0
4.0,2.5,4290,2.0,0,0,4290,0,2004,792500.0
3.0,2.5,1950,2.0,0,0,1950,0,1978,540000.0
3.0,1.0,1010,1.0,0,0,1010,0,1968,229900.0
4.0,2.5,2830,2.0,0,0,2830,0,2003,533000.0
4.0,1.75,1500,1.0,0,0,1000,500,1977,239000.0
3.0,2.5,3370,1.0,0,0,3370,0,2000,713900.0
4.0,2.5,3160,2.0,0,0,3160,0,1999,427500.0
3.0,1.0,1110,1.5,0,0,1110,0,1955,302000.0
3.0,2.5,3830,2.0,0,0,3830,0,1991,1150000.0
3.0,2.5,3160,2.0,0,0,2650,510,2006,555000.0
3.0,2.25,2100,2.0,0,0,2100,0,1996,495000.0
3.0,1.5,2240,1.0,0,0,2240,0,1953,495000.0
2.0,0.75,1060,1.0,1,2,560,500,1947,340000.0
4.0,2.25,2350,1.0,0,0,2350,0,1983,464950.0
4.0,2.5,1940,2.0,0,0,1940,0,1998,320000.0
1.0,1.0,1160,1.0,0,0,1160,0,2009,440000.0
3.0,1.5,1840,2.0,0,0,1840,0,1961,686000.0
4.0,1.75,2260,1.0,0,0,1620,640,1976,555000.0
2.0,1.0,840,1.0,0,0,840,0,1909,361500.0
5.0,3.0,2830,2.0,0,0,2460,370,1923,1240000.0
4.0,1.0,1600,1.0,0,0,1600,0,1966,154950.0
3.0,1.75,1370,1.0,0,0,1370,0,1982,247200.0
3.0,2.25,1960,1.0,0,0,1490,470,1984,250000.0
3.0,1.5,1470,2.0,0,0,1470,0,1907,590300.0
5.0,2.75,2740,1.0,0,0,1370,1370,1960,541125.0
2.0,2.5,1090,2.0,0,0,1090,0,2004,310000.0
4.0,2.75,2460,1.0,0,1,1680,780,1976,704111.0
3.0,2.25,1820,1.0,0,0,1820,0,1964,277500.0
4.0,2.75,1960,1.0,0,0,980,980,1954,325000.0
3.0,2.25,1760,2.0,0,0,1760,0,1995,289200.0
1.0,1.0,720,1.0,0,0,720,0,1908,185000.0
4.0,3.5,3470,2.0,0,0,2500,970,2007,1445000.0
4.0,2.0,1370,1.0,0,0,1370,0,1947,420550.0
4.0,2.25,2370,1.0,0,0,1550,820,1968,603000.0
3.0,1.0,1390,1.5,0,0,1230,160,1903,345000.0
3.0,2.0,1840,1.0,0,0,920,920,1928,650000.0
5.0,3.0,2790,1.0,0,3,1500,1290,1973,589950.0
2.0,2.25,1460,2.0,0,0,1460,0,2007,309950.0
3.0,2.5,2620,1.5,0,0,2620,0,1998,775000.0
4.0,1.5,2230,1.5,0,0,1330,900,1918,590000.0
4.0,3.0,3250,2.5,0,0,2420,830,1905,863500.0
3.0,1.0,1190,1.0,0,0,1190,0,1943,517500.0
3.0,3.0,2090,1.5,0,0,1290,800,1922,700000.0
3.0,2.5,2580,1.0,0,0,2090,490,1956,699000.0
3.0,2.5,2100,2.0,0,0,1690,410,2005,350000.0
4.0,2.5,3160,2.0,0,0,3160,0,1987,795000.0
3.0,2.5,2090,1.0,0,0,1360,730,1962,543000.0
3.0,2.5,1570,2.0,0,0,1570,0,2001,325000.0
3.0,1.0,1020,1.5,0,0,1020,0,1900,337500.0
2.0,1.0,1300,1.0,0,0,1300,0,1955,425000.0
3.0,2.5,2110,1.0,0,0,2110,0,1986,780000.0
2.0,1.0,1210,1.0,0,0,1210,0,1948,259000.0
4.0,1.75,1990,1.0,0,0,1850,140,1968,524400.0
3.0,2.0,1630,1.0,0,0,1630,0,2003,260000.0
2.0,2.0,1384,2.0,0,0,1384,0,1990,273000.0
4.0,2.5,3380,2.0,0,0,3380,0,1997,639900.0
4.0,2.5,2480,2.0,0,0,2480,0,2001,420000.0
3.0,1.0,1270,1.0,0,0,1270,0,1957,510500.0
4.0,1.0,1010,1.5,0,0,1010,0,1947,290000.0
3.0,1.75,1490,1.0,0,0,990,500,1944,226000.0
2.0,1.0,820,1.0,0,0,820,0,1916,300000.0
3.0,2.0,1810,1.0,0,0,1810,0,1967,407450.0
4.0,2.25,3060,1.0,0,0,1530,1530,1965,390000.0
6.0,2.75,2980,1.0,0,4,2130,850,1965,1058800.0
3.0,2.5,3440,2.0,0,0,3440,0,1991,610000.0
3.0,2.5,1820,1.0,0,0,1220,600,1959,239975.0
3.0,2.5,2320,1.0,0,0,1480,840,1987,375000.0
4.0,2.5,2620,2.0,0,0,2620,0,2004,742500.0
4.0,1.75,2190,1.0,0,0,2020,170,1956,450000.0
3.0,2.25,1780,1.0,0,0,1780,0,1967,300000.0
3.0,1.75,2200,1.0,0,0,1240,960,1975,216600.0
3.0,1.75,1600,1.5,0,0,1600,0,1924,525000.0
4.0,2.25,2450,1.0,0,2,1650,800,1954,455000.0
4.0,2.25,2680,2.0,0,0,2680,0,1986,390000.0
3.0,1.75,1850,1.0,0,0,880,970,1982,450000.0
4.0,1.0,1740,1.5,0,0,1740,0,1924,382000.0
3.0,2.25,1490,1.0,0,0,1170,320,1987,287000.0
4.0,2.0,1960,1.0,0,3,1960,0,1971,460000.0
3.0,2.25,1380,2.0,0,0,1380,0,2009,435000.0
2.0,1.0,1510,1.5,0,0,1310,200,1935,575000.0
3.0,1.5,1410,1.0,0,0,1410,0,1906,626700.0
4.0,1.5,1440,1.5,0,0,1440,0,1922,352000.0
3.0,1.0,920,1.0,0,0,920,0,1951,650000.0
3.0,1.0,1090,1.0,0,0,1090,0,1962,197000.0
8.0,2.75,2790,1.0,0,0,1470,1320,1977,340000.0
3.0,2.0,1840,1.0,0,0,1840,0,1968,560000.0
3.0,1.75,1340,1.0,0,0,1340,0,1972,354000.0
4.0,2.5,2570,2.0,0,0,2570,0,1999,670000.0
4.0,3.5,3010,2.0,0,0,3010,0,2005,769000.0
4.0,2.5,2160,1.0,0,0,1080,1080,1940,650000.0
3.0,1.75,2140,1.0,0,0,1290,850,1953,650000.0
4.0,1.75,2090,1.0,0,0,1050,1040,1970,289950.0
3.0,1.75,1810,1.0,0,0,1240,570,1977,300000.0
4.0,1.75,1760,1.0,0,2,1070,690,1962,471000.0
4.0,2.5,2500,2.0,0,0,2500,0,1990,639000.0
2.0,1.0,930,1.0,0,2,930,0,1952,287000.0
4.0,2.5,3030,2.0,0,0,3030,0,1992,740000.0
3.0,2.0,1460,1.0,0,0,940,520,1990,499922.0
4.0,2.5,2940,2.0,0,0,2940,0,1986,675000.0
5.0,2.75,3360,2.0,0,0,3360,0,2014,738515.0
3.0,1.75,2110,1.0,0,0,1210,900,1956,445000.0
4.0,2.25,2740,1.0,0,2,1980,760,1953,1039000.0
2.0,1.0,1070,1.0,0,0,880,190,1917,346000.0
3.0,2.0,1680,2.0,0,0,1180,500,1940,450000.0
4.0,2.5,2260,1.0,0,0,2260,0,1975,350000.0
4.0,3.5,5860,2.0,0,0,3690,2170,1907,2400000.0
4.0,2.25,2380,1.0,0,0,2380,0,1977,594950.0
5.0,3.0,3320,2.0,0,0,3320,0,2004,1695000.0
2.0,1.0,1050,1.5,0,0,1050,0,1984,219000.0
4.0,2.5,2070,2.0,0,0,2070,0,2004,450000.0
4.0,2.25,1790,2.0,0,0,1790,0,1992,402000.0
2.0,1.0,840,1.0,0,0,840,0,1942,275000.0
3.0,1.5,990,1.0,0,0,990,0,1948,421500.0
3.0,3.0,4120,2.0,0,2,3180,940,1994,560000.0
3.0,1.75,1620,1.0,0,0,1620,0,1966,314000.0
4.0,2.0,1340,1.0,0,0,1340,0,1942,287000.0
4.0,1.0,1500,1.5,0,0,1500,0,1925,277000.0
2.0,1.0,1300,1.0,0,0,1300,0,1950,337500.0
4.0,2.75,3100,2.0,0,0,3100,0,1999,792000.0
3.0,2.5,3380,2.0,0,0,2200,1180,1999,435000.0
4.0,2.5,2660,1.0,0,0,1450,1210,1977,313100.0
3.0,2.25,1700,1.5,0,0,1100,600,1924,575000.0
4.0,2.5,1840,1.0,0,2,1240,600,1972,510000.0
2.0,1.0,890,1.0,0,0,890,0,1941,299950.0
3.0,3.0,2800,1.0,0,0,1580,1220,1953,1028000.0
4.0,1.75,2010,1.0,0,0,1340,670,1957,364000.0
3.0,1.0,1380,1.0,0,0,1380,0,1965,335000.0
3.0,1.0,1210,1.0,0,0,1210,0,1954,219950.0
3.0,2.0,1280,1.0,0,0,1280,0,1991,215000.0
4.0,2.5,4090,2.0,0,0,3670,420,1979,640000.0
3.0,1.0,1580,1.0,0,0,1180,400,1925,535000.0
4.0,2.0,1910,1.0,0,0,1140,770,1973,253000.0
2.0,2.5,1740,2.0,0,2,1210,530,1994,650000.0
3.0,2.25,1130,1.5,0,0,1130,0,1930,672000.0
3.0,1.75,1970,1.0,0,3,1130,840,1950,606000.0
3.0,2.25,1780,1.0,0,0,1280,500,1981,292000.0
3.0,2.0,1670,1.0,0,0,1670,0,1992,289950.0
4.0,1.5,1360,1.0,0,0,1360,0,1968,257500.0
3.0,2.5,1840,1.0,0,0,1290,550,1971,380000.0
3.0,1.75,1255,3.0,0,0,1255,0,2010,360000.0
3.0,1.75,1840,1.0,0,0,1240,600,1976,269500.0
4.0,2.5,2960,2.0,0,0,2960,0,2005,449000.0
4.0,1.5,1430,1.5,0,0,1430,0,1948,375000.0
5.0,4.75,5990,2.0,1,4,4050,1940,2002,2200000.0
4.0,2.5,3480,2.0,0,0,3480,0,1988,810000.0
5.0,3.25,4260,2.0,0,0,4260,0,2005,994000.0
5.0,2.25,1820,1.0,0,0,1080,740,1979,275000.0
2.0,1.0,1290,2.0,0,0,1290,0,2008,300000.0
5.0,2.5,2130,2.0,0,0,2130,0,2013,380000.0
3.0,2.0,1170,1.0,0,0,1170,0,1957,200000.0
3.0,3.5,1730,3.0,0,0,1350,380,2009,635000.0
2.0,1.0,880,1.0,0,0,880,0,1939,280000.0
3.0,2.5,2380,2.0,0,0,2380,0,2002,574000.0
4.0,1.0,1330,1.0,0,0,1330,0,1952,1050000.0
3.0,2.25,1780,2.0,0,2,1780,0,1988,545000.0
3.0,1.5,1220,1.0,0,0,1220,0,1962,271950.0
5.0,1.75,2490,1.0,0,2,1540,950,1959,630000.0
2.0,1.0,1180,1.0,0,0,1180,0,1984,400000.0
4.0,2.5,2310,2.0,0,0,2310,0,1998,334000.0
4.0,2.0,1440,2.0,0,0,1440,0,1972,332500.0
2.0,1.5,1620,2.0,0,0,1080,540,2007,525000.0
3.0,2.5,2620,2.0,0,0,2620,0,1991,408000.0
4.0,2.5,3710,2.0,0,0,3710,0,2003,846450.0
3.0,1.5,1040,1.0,0,0,1040,0,1958,411100.0
5.0,3.25,3320,2.0,0,0,2480,840,1999,409124.0
2.0,1.5,800,1.0,0,0,800,0,1951,335950.0
5.0,2.5,2040,1.0,0,0,1240,800,1963,480000.0
2.0,1.75,1960,1.0,0,0,980,980,1957,280000.0
4.0,2.5,2670,2.0,0,0,2670,0,1999,668000.0
4.0,2.5,2930,2.0,0,0,2930,0,2010,750000.0
2.0,1.0,830,1.0,0,0,830,0,1955,394475.0
5.0,1.75,2290,2.0,0,0,1980,310,1928,848000.0
3.0,1.5,2510,2.5,0,0,2510,0,1907,675000.0
3.0,1.0,1280,1.0,0,0,1280,0,1958,175000.0
4.0,1.5,1810,1.0,0,1,1350,460,1952,560000.0
5.0,2.75,2080,2.0,0,0,2080,0,1987,538888.0
4.0,1.75,1680,2.0,0,0,1680,0,1991,359000.0
3.0,2.25,1660,2.0,0,0,1660,0,2001,300000.0
3.0,2.5,1650,2.0,0,0,1650,0,1989,273000.0
3.0,2.5,1420,2.0,0,0,1280,140,2003,670000.0
4.0,2.25,2240,1.0,0,0,1740,500,1984,530000.0
3.0,1.5,1230,1.0,0,0,910,320,1927,625000.0
3.0,1.0,1260,1.0,0,0,1260,0,1954,248000.0
3.0,2.5,2060,2.0,0,0,2060,0,1990,533000.0
4.0,3.5,3090,1.0,0,0,2190,900,1991,549950.0
4.0,1.75,3220,1.0,0,0,2010,1210,1959,485000.0
3.0,2.5,2020,2.0,0,0,2020,0,2001,353500.0
2.0,1.75,1910,1.0,0,0,1910,0,1976,435000.0
3.0,1.0,1150,1.0,0,0,1000,150,1951,241000.0
4.0,2.75,2730,1.5,0,0,1550,1180,1921,885000.0
6.0,3.0,2890,2.5,0,0,2290,600,1906,799200.0
3.0,2.5,2280,1.0,0,0,1490,790,1973,760000.0
2.0,1.0,1040,1.0,0,0,1040,0,1922,270000.0
4.0,1.75,2440,1.0,0,0,2040,400,1969,675000.0
3.0,2.5,1720,1.0,0,0,1000,720,1977,499000.0
3.0,2.5,3430,1.5,0,0,3430,0,1984,1202500.0
4.0,2.5,2570,2.0,0,0,2570,0,2005,320000.0
4.0,3.25,4360,1.0,0,0,2320,2040,2000,890000.0
4.0,2.75,2060,1.0,0,0,1210,850,1978,275000.0
4.0,2.5,3020,2.0,0,0,3020,0,1994,490000.0
3.0,2.5,2340,1.5,0,0,1540,800,1906,550000.0
5.0,2.0,2400,1.0,0,0,1210,1190,1959,390000.0
3.0,2.25,1610,1.0,0,0,1110,500,1968,277000.0
3.0,1.75,1090,1.0,0,0,1090,0,1994,236000.0
3.0,1.75,1470,1.0,0,0,1470,0,1975,265953.0
3.0,2.25,1670,1.0,0,0,1240,430,1974,545000.0
3.0,2.5,1850,2.0,0,0,1850,0,1991,535000.0
3.0,2.75,3940,1.0,0,4,2140,1800,1967,1450000.0
4.0,3.0,2330,2.0,0,0,1920,410,2003,490000.0
4.0,2.5,2020,1.5,0,0,2020,0,1954,319950.0
3.0,1.5,1300,1.0,0,0,1300,0,1960,625000.0
3.0,1.0,1180,1.0,0,0,1180,0,1968,248000.0
3.0,1.75,1320,1.0,0,0,1320,0,1966,475000.0
6.0,2.75,2520,1.0,0,0,1320,1200,1962,410000.0
3.0,2.5,1680,3.0,0,0,1680,0,1909,670000.0
3.0,2.5,2000,2.0,0,0,2000,0,1968,430000.0
2.0,1.0,1180,1.0,0,0,1180,0,1954,313000.0
3.0,3.25,3330,2.5,0,0,3330,0,1988,950000.0
2.0,2.0,1880,1.5,0,0,1880,0,1902,751750.0
4.0,2.5,2990,2.0,0,0,2210,780,2003,760000.0
3.0,1.75,1510,1.0,0,0,1510,0,1969,310650.0
4.0,3.0,3110,2.0,0,0,3110,0,1997,367500.0
4.0,2.5,2150,2.0,0,0,2150,0,2001,580000.0
3.0,2.25,1900,1.5,0,0,1200,700,1905,580000.0
4.0,2.5,2720,2.0,0,0,2720,0,1987,665000.0
3.0,2.25,1560,2.0,0,0,1560,0,1979,239950.0
4.0,2.5,1990,2.0,0,0,1990,0,1998,470000.0
3.0,1.75,1740,1.0,0,0,950,790,1930,733000.0
4.0,2.0,2130,1.0,0,0,1350,780,1962,250000.0
4.0,1.75,1510,1.0,0,0,1510,0,1957,402000.0
5.0,3.5,2100,2.0,0,0,1410,690,1999,295000.0
5.0,2.5,2344,1.0,0,0,1560,784,1976,355000.0
3.0,1.5,1970,1.0,0,0,1970,0,1968,289000.0
3.0,2.25,1470,2.0,0,2,1470,0,1982,376000.0
2.0,1.0,940,1.0,0,0,940,0,1926,212700.0
3.0,1.75,1780,1.0,0,0,1780,0,1983,325000.0
4.0,2.5,2230,2.0,0,0,2230,0,2002,415000.0
3.0,2.5,3570,1.0,0,0,2400,1170,1981,935000.0
3.0,2.5,1920,2.0,0,0,1920,0,1990,372000.0
3.0,1.5,1290,1.0,0,0,1020,270,1957,240000.0
3.0,1.75,1880,1.0,0,0,1880,0,1980,334950.0
4.0,2.5,2960,2.0,0,0,2960,0,2005,426500.0
2.0,1.75,1840,1.0,0,2,1300,540,1952,430000.0
3.0,1.5,1890,1.0,0,0,1090,800,1967,400000.0
3.0,2.25,1820,1.0,0,0,1120,700,1964,455850.0
4.0,3.5,4370,2.0,0,1,3610,760,2003,1965220.0
3.0,1.75,1530,1.0,0,0,1530,0,1986,400000.0
3.0,1.0,1030,1.0,0,0,1030,0,1954,397500.0
3.0,2.5,2000,3.0,0,0,2000,0,2005,755000.0
5.0,1.5,1730,1.0,0,0,1010,720,1962,287000.0
4.0,2.5,3620,2.0,0,0,3620,0,1976,480000.0
3.0,2.5,2040,2.0,0,0,2040,0,1995,490000.0
3.0,2.5,2640,2.0,0,0,1680,960,1991,365000.0
3.0,2.5,1600,2.0,0,0,1600,0,2005,260000.0
4.0,1.0,1480,1.5,0,0,1480,0,1929,505000.0
2.0,1.0,700,1.0,0,0,700,0,1922,260000.0
2.0,1.0,700,1.0,0,0,700,0,1922,430000.0
4.0,2.5,3520,2.0,0,0,3520,0,1993,905000.0
3.0,2.0,1650,2.0,0,0,1650,0,1977,440000.0
4.0,1.0,1360,1.5,0,0,1360,0,1950,439500.0
3.0,2.0,1350,1.0,0,0,680,670,1944,270000.0
3.0,2.5,1970,2.0,0,0,1970,0,1998,306500.0
3.0,2.0,1470,2.0,0,0,1310,160,2003,380000.0
4.0,1.75,1610,1.0,0,0,1610,0,1969,215000.0
2.0,1.0,810,1.0,0,0,810,0,1950,299900.0
4.0,3.5,2820,2.0,0,0,2820,0,1995,1450000.0
3.0,1.0,1900,1.5,0,0,1900,0,1942,239950.0
4.0,2.5,1830,1.0,0,0,1540,290,1973,494000.0
4.0,1.5,1730,1.0,0,0,1010,720,1963,317500.0
4.0,2.5,2110,2.0,0,0,2110,0,1977,670000.0
3.0,2.5,3060,2.0,0,2,3060,0,2004,650000.0
4.0,2.5,2620,2.0,0,0,2620,0,1983,852000.0
2.0,1.5,1088,2.0,0,0,1088,0,1983,250000.0
3.0,1.5,1400,1.0,0,0,1400,0,1964,264950.0
2.0,2.0,1540,1.0,0,0,1020,520,1942,582500.0
3.0,2.5,1540,2.0,0,0,1300,240,1998,384000.0
3.0,1.5,2310,1.5,0,0,1790,520,1926,817000.0
4.0,1.75,1730,1.0,0,0,1730,0,1971,320000.0
4.0,2.25,2070,1.0,0,0,1470,600,1977,445800.0
2.0,1.0,900,1.0,0,0,900,0,1951,263300.0
3.0,1.0,860,1.0,0,0,860,0,1952,215000.0
5.0,4.0,2980,1.5,0,0,2070,910,1921,842500.0
5.0,4.0,2980,1.5,0,0,2070,910,1921,850000.0
5.0,2.5,2740,2.0,0,0,2740,0,1990,386000.0
4.0,2.5,1790,2.0,0,0,1790,0,1996,251100.0
3.0,1.75,1750,1.0,0,0,1330,420,1978,435000.0
4.0,4.0,3610,2.0,0,0,3610,0,2000,870000.0
6.0,1.0,1430,2.0,0,0,1430,0,1954,800000.0
3.0,1.75,1570,1.0,0,0,1570,0,1968,555000.0
2.0,1.0,2280,2.0,0,0,2280,0,1932,280000.0
3.0,1.0,940,1.0,0,0,940,0,1916,356000.0
4.0,2.5,2920,2.0,0,4,2920,0,2004,675000.0
4.0,2.25,2260,2.0,0,0,2260,0,1976,605000.0
5.0,2.0,2000,1.5,0,2,1280,720,1908,690500.0
2.0,1.75,1440,1.0,0,0,1440,0,2005,437000.0
5.0,2.0,2310,1.5,0,0,2310,0,1966,850000.0
4.0,2.25,2300,1.5,0,0,1340,960,1904,350000.0
2.0,2.25,1490,1.5,0,0,1490,0,1926,480000.0
3.0,2.25,1830,2.0,0,0,1830,0,1989,379500.0
5.0,4.5,4440,2.0,0,0,4440,0,2012,600000.0
4.0,3.5,4970,2.0,0,3,3930,1040,1992,1436000.0
2.0,1.5,1000,2.0,0,0,840,160,2007,303000.0
4.0,2.5,4940,1.0,0,4,3450,1490,1953,800000.0
2.0,2.0,1980,1.5,0,0,1220,760,1906,549000.0
3.0,2.5,1560,1.0,0,0,1210,350,1964,324950.0
2.0,1.0,870,1.0,0,0,870,0,1948,170000.0
3.0,1.0,840,1.0,0,0,840,0,1969,178000.0
3.0,1.0,1250,1.0,0,0,1250,0,1958,144000.0
4.0,2.75,3120,1.0,0,2,1980,1140,1954,1580000.0
2.0,1.0,750,1.0,0,0,750,0,1932,258000.0
3.0,1.75,710,1.0,0,0,710,0,1950,345000.0
3.0,1.75,2290,1.0,0,0,1620,670,1965,470000.0
5.0,2.5,3750,2.0,1,4,3750,0,1925,2903000.0
3.0,1.5,980,1.0,0,0,980,0,1969,350000.0
2.0,1.75,1590,1.0,0,0,1590,0,1972,225500.0
2.0,1.0,940,1.0,0,0,720,220,1942,473000.0
3.0,1.75,1750,1.0,0,0,1150,600,1962,279000.0
3.0,1.0,1460,1.0,0,0,880,580,1948,470000.0
3.0,1.75,1540,1.0,0,0,770,770,1925,565000.0
3.0,2.0,2560,1.0,0,1,1380,1180,1952,695000.0
3.0,1.75,1660,1.0,0,0,1660,0,1991,315000.0
3.0,2.5,1880,2.0,0,0,1880,0,1993,529000.0
5.0,3.75,3500,1.5,0,0,3500,0,1967,750000.0
3.0,2.25,1840,2.0,0,0,1840,0,1993,481500.0
3.0,2.0,1060,1.0,0,0,1060,0,1987,211000.0
3.0,2.25,1790,1.0,0,0,1390,400,1973,455000.0
2.0,1.0,810,1.0,0,0,810,0,1938,238950.0
4.0,3.5,2600,2.0,0,0,1820,780,2003,722500.0
4.0,2.5,3230,1.0,0,3,2000,1230,1973,795000.0
4.0,2.25,2240,2.0,0,0,2240,0,1971,327500.0
4.0,3.0,3400,2.0,0,0,3400,0,2006,585000.0
4.0,2.0,3140,1.0,0,1,1940,1200,1939,775000.0
4.0,2.5,2780,2.0,0,0,2780,0,2001,645000.0
4.0,2.75,2320,1.0,0,0,1670,650,1968,445000.0
3.0,1.75,1370,1.0,0,0,1370,0,1987,257950.0
5.0,1.75,2230,1.0,0,0,1230,1000,1959,375000.0
3.0,2.5,1610,2.0,0,0,1610,0,1994,245000.0
3.0,2.5,3410,2.0,0,0,3410,0,1990,725000.0
4.0,2.5,2810,2.0,0,0,2810,0,2005,702000.0
3.0,1.75,1850,2.0,0,0,1850,0,1943,330000.0
3.0,1.5,1790,1.5,0,0,1790,0,1912,940000.0
3.0,1.0,1150,1.5,0,0,1150,0,1950,354500.0
4.0,2.75,2420,1.5,0,0,2420,0,1914,279950.0
3.0,2.25,1580,1.0,0,0,1180,400,1989,284000.0
5.0,2.0,1760,1.0,0,1,1560,200,1959,480000.0
5.0,2.0,1760,1.0,0,1,1560,200,1959,647500.0
3.0,2.5,2750,2.0,0,0,2750,0,1993,625000.0
3.0,1.0,920,1.0,0,0,920,0,1978,152000.0
3.0,1.0,960,1.0,0,0,960,0,1961,322000.0
3.0,1.75,1120,1.0,0,0,870,250,1916,445000.0
3.0,1.0,1560,1.5,0,0,1560,0,1907,595000.0
3.0,1.0,1380,1.0,0,0,980,400,1981,165000.0
4.0,2.5,1940,2.0,0,0,1940,0,1990,278500.0
3.0,1.75,1810,1.0,0,0,1370,440,1973,517500.0
2.0,1.0,1100,1.0,0,0,1100,0,1954,343566.0
4.0,2.25,1980,1.0,0,0,1170,810,1977,286285.0
4.0,1.5,1340,1.0,0,0,1340,0,1959,474905.0
3.0,1.75,1680,1.0,0,0,1400,280,1960,550000.0
4.0,2.5,2060,2.0,0,0,2060,0,1993,286000.0
3.0,3.25,2620,1.0,0,0,1770,850,1980,900000.0
3.0,2.25,1610,2.0,0,0,1610,0,1985,449950.0
4.0,1.5,1490,2.0,0,0,1490,0,1966,259000.0
3.0,2.25,1900,1.0,0,0,1540,360,1969,340000.0
4.0,2.5,3440,2.0,0,0,3440,0,1994,785000.0
2.0,1.0,1840,1.5,0,0,1130,710,1910,490000.0
4.0,2.0,2330,1.0,0,0,1400,930,1941,344950.0
3.0,2.0,2250,2.0,0,0,1880,370,1905,950000.0
4.0,1.75,2000,1.0,0,4,1000,1000,1958,810000.0
2.0,2.5,3010,1.0,0,3,1260,1750,1976,998160.0
3.0,1.75,1680,1.0,0,0,1150,530,1979,377000.0
3.0,2.0,1530,1.0,0,0,1530,0,1984,595000.0
2.0,1.0,970,1.0,0,0,970,0,1911,313300.0
5.0,1.75,1550,1.5,0,0,1550,0,1941,360000.0
3.0,1.75,1660,1.0,0,0,1660,0,1979,188000.0
3.0,2.5,3680,1.5,0,0,3680,0,1994,755000.0
5.0,3.5,3210,2.0,0,2,2290,920,1917,1289000.0
3.0,1.0,1480,2.5,0,0,1480,0,1940,455000.0
5.0,3.5,3600,2.0,0,3,2680,920,2005,817500.0
3.0,2.25,1700,3.0,0,0,1700,0,2002,550000.0
3.0,1.75,1680,1.0,0,0,1240,440,1978,260000.0
3.0,2.0,1550,1.5,0,0,1550,0,1999,320000.0
3.0,3.25,3780,1.0,0,1,2650,1130,1999,1153000.0
4.0,2.5,2360,1.0,0,0,1460,900,1985,362000.0
3.0,2.5,1810,2.0,0,0,1350,460,1997,503500.0
3.0,2.5,2290,2.0,0,0,2290,0,2006,653000.0
4.0,2.75,3370,2.0,0,0,3370,0,1991,760000.0
4.0,1.75,2090,1.0,0,0,1090,1000,1916,775000.0
4.0,3.75,2130,1.5,1,4,2130,0,1955,1339000.0
5.0,1.75,2060,1.0,0,0,1360,700,1954,417500.0
3.0,1.5,1560,1.0,0,0,1220,340,1969,525000.0
2.0,1.0,730,1.0,0,1,730,0,1934,217000.0
4.0,2.75,2910,1.0,0,0,1640,1270,1985,525000.0
4.0,2.25,2490,1.0,0,0,1890,600,1976,442500.0
4.0,1.75,1710,1.0,0,0,1710,0,1955,525000.0
4.0,1.75,1520,1.0,0,0,1520,0,1967,425500.0
3.0,2.75,2930,2.0,0,2,2930,0,1990,710000.0
4.0,3.0,3160,1.0,0,3,1930,1230,1991,545000.0
5.0,2.75,2910,1.5,0,0,2910,0,1967,410000.0
3.0,2.25,1700,1.0,0,0,1200,500,1980,245000.0
2.0,1.0,810,1.0,0,0,810,0,1923,194900.0
4.0,2.5,2000,2.0,0,0,2000,0,2003,284000.0
2.0,1.75,1894,1.5,0,0,1520,374,1936,280000.0
3.0,1.75,2080,1.0,0,0,1040,1040,1970,280000.0
4.0,2.0,1730,1.0,0,0,1010,720,1943,360000.0
2.0,1.0,720,1.0,0,0,720,0,1942,405000.0
4.0,2.5,3560,2.0,0,0,3560,0,2000,865000.0
4.0,2.0,1210,1.0,0,0,1210,0,1955,483300.0
4.0,2.5,2130,2.0,0,0,2130,0,1985,355000.0
3.0,2.25,1570,1.0,0,0,1180,390,1990,274950.0
3.0,4.5,3950,2.0,0,3,2880,1070,1998,1925000.0
3.0,3.25,3450,2.0,0,0,2690,760,1989,755000.0
4.0,5.75,7220,2.0,0,4,6220,1000,2000,1940000.0
3.0,1.75,1150,1.0,0,0,1150,0,1979,309212.0
3.0,2.25,1500,1.0,0,0,1150,350,1984,219950.0
3.0,2.5,1300,1.5,0,0,1300,0,1920,690000.0
3.0,1.75,1290,1.0,0,0,1170,120,1943,250800.0
3.0,2.0,2510,1.0,0,2,2510,0,1994,557500.0
4.0,1.75,2320,1.5,0,0,1820,500,1926,941000.0
6.0,4.75,5480,1.5,1,4,3910,1570,1936,3650000.0
4.0,2.75,2030,1.0,0,0,1230,800,1977,305000.0
4.0,1.5,2060,1.0,0,0,2060,0,1949,815000.0
3.0,2.5,2920,1.0,0,4,1800,1120,1954,1015000.0
4.0,3.0,3330,1.5,0,3,2330,1000,1928,1240000.0
3.0,2.5,2110,2.0,0,0,2110,0,1990,535000.0
3.0,1.0,1175,1.0,0,0,1175,0,1949,775000.0
3.0,2.0,1590,1.0,0,0,1590,0,1994,255000.0
2.0,1.0,1070,1.0,0,0,1070,0,1947,327000.0
4.0,2.0,2720,2.0,0,3,2240,480,1976,560000.0
4.0,3.5,2980,2.0,0,3,2980,0,1998,1339000.0
3.0,1.75,1160,1.0,0,0,1160,0,1977,199500.0
4.0,2.5,3580,2.0,0,0,3580,0,2004,760000.0
3.0,2.25,3020,3.0,0,2,1980,1040,1994,439000.0
4.0,2.25,2380,1.0,0,0,1410,970,1961,527000.0
3.0,2.75,2270,1.5,0,0,1300,970,1948,199950.0
3.0,2.25,1660,2.0,0,0,1660,0,1988,254000.0
2.0,1.0,830,1.0,0,0,830,0,1921,393000.0
5.0,2.25,2480,1.0,0,0,1860,620,1979,585000.0
2.0,2.0,1900,1.0,0,0,1150,750,1923,450000.0
2.0,1.75,1670,1.0,0,0,1670,0,2005,565000.0
5.0,2.25,2000,1.0,0,0,1300,700,1986,330000.0
3.0,2.0,2320,1.5,0,0,2320,0,1992,870000.0
4.0,2.5,1860,1.0,0,0,1460,400,1966,585000.0
3.0,2.5,2110,2.0,0,3,2110,0,1977,500000.0
3.0,2.0,1400,1.0,0,0,1150,250,1979,225000.0
3.0,2.0,1400,1.0,0,0,1150,250,1979,295000.0
3.0,2.75,2850,1.0,0,0,1920,930,1976,775000.0
3.0,1.0,1370,1.0,0,0,1370,0,1981,280000.0
3.0,2.5,2170,1.5,0,0,1280,890,1923,539000.0
3.0,1.75,2570,1.0,0,2,2570,0,1953,567500.0
4.0,2.25,1970,1.0,0,0,1310,660,1960,442500.0
5.0,3.75,2980,3.0,0,0,2980,0,1997,598200.0
4.0,2.5,2300,2.0,0,0,2300,0,1955,610000.0
3.0,2.5,1990,2.0,0,0,1990,0,2004,544900.0
4.0,2.5,2390,2.0,0,0,2390,0,2001,557500.0
3.0,2.5,2160,1.0,0,1,1430,730,1979,532500.0
4.0,3.25,3300,2.0,0,0,3300,0,1985,1350000.0
3.0,2.0,1840,1.0,0,0,1040,800,1920,750000.0
3.0,2.5,2030,2.0,0,0,2030,0,1983,530000.0
3.0,2.5,1400,2.0,0,0,1400,0,2003,346100.0
4.0,2.25,2320,2.0,0,0,2320,0,1977,260000.0
3.0,1.75,1410,1.0,0,0,1410,0,1959,365000.0
3.0,2.0,1860,1.0,0,0,930,930,1983,615000.0
4.0,2.5,1820,2.0,0,0,1820,0,1994,318400.0
4.0,2.5,1910,2.0,0,0,1910,0,1993,498500.0
3.0,1.75,1540,1.0,0,0,1540,0,1971,450000.0
3.0,2.0,1430,1.0,0,0,1430,0,1988,200000.0
3.0,1.0,1010,1.0,0,0,1010,0,1968,234000.0
2.0,1.0,940,1.0,0,0,940,0,1947,121800.0
3.0,2.75,2600,1.5,0,2,1600,1000,1929,805000.0
4.0,2.25,2060,1.0,0,0,1220,840,1963,410000.0
3.0,2.5,1920,2.0,0,0,1920,0,1986,475000.0
4.0,2.5,2900,2.0,0,0,2900,0,1986,1337500.0
1.0,1.0,1020,1.0,0,0,1020,0,1947,269000.0
4.0,2.25,2150,2.0,0,0,2150,0,1979,573000.0
3.0,2.5,1660,2.0,0,0,1660,0,2001,330000.0
4.0,1.0,1230,1.5,0,0,1230,0,1944,252750.0
2.0,2.5,2170,1.0,0,0,2170,0,2007,745000.0
3.0,2.0,1280,1.0,0,0,1280,0,1991,280000.0
4.0,2.5,2240,1.0,0,0,1380,860,1974,535000.0
4.0,1.5,1780,1.0,0,0,1320,460,1953,580000.0
3.0,1.75,1840,1.0,0,0,1220,620,1968,301000.0
4.0,1.75,1740,1.0,0,0,1740,0,1968,600000.0
5.0,3.0,3040,2.0,0,0,3040,0,2005,538900.0
3.0,2.5,2370,2.0,0,0,2370,0,2006,366000.0
4.0,2.5,2100,2.0,0,0,2100,0,2003,303000.0
3.0,2.25,1470,2.0,0,0,1090,380,2007,432000.0
2.0,1.5,1300,1.0,0,0,820,480,1945,300000.0
3.0,3.0,3420,2.0,0,0,2430,990,1939,908800.0
3.0,1.5,1190,1.0,0,0,970,220,1940,500000.0
5.0,2.0,2080,1.0,0,0,1740,340,1959,254000.0
5.0,1.5,2180,1.5,0,0,1340,840,1924,470000.0
3.0,2.0,1460,1.0,0,0,1460,0,1967,480000.0
3.0,1.75,1530,1.0,0,0,1150,380,1983,536000.0
4.0,3.5,4740,2.0,0,3,3640,1100,2006,1349000.0
3.0,2.25,1980,1.0,0,0,1980,0,1980,550000.0
3.0,1.75,1710,1.0,0,0,1240,470,1976,260000.0
2.0,1.5,1160,2.0,0,0,890,270,2006,284900.0
3.0,2.5,2200,2.0,0,0,1530,670,2002,740000.0
2.0,1.0,1170,1.0,0,0,1030,140,1920,425000.0
3.0,1.0,1120,1.0,0,0,1120,0,1965,230000.0
3.0,1.5,1710,2.0,0,0,1710,0,1926,675000.0
3.0,1.75,1650,1.0,0,0,1650,0,1986,267500.0
4.0,2.5,2840,1.0,0,2,1420,1420,1952,814000.0
4.0,3.0,3310,1.5,0,0,3310,0,1989,1250000.0
3.0,2.0,1860,1.0,0,0,1320,540,1985,460000.0
3.0,2.5,2250,2.0,0,0,2250,0,1994,445000.0
3.0,2.5,2890,2.0,0,0,2890,0,2004,715000.0
3.0,1.75,2120,1.0,0,0,1060,1060,1947,425000.0
4.0,2.5,2130,2.0,0,0,2130,0,2009,370000.0
2.0,1.75,1170,1.0,0,0,780,390,1937,302000.0
4.0,1.75,2120,1.0,0,0,1060,1060,1956,453000.0
3.0,1.75,1280,1.0,0,0,1280,0,1969,290000.0
4.0,2.5,3170,2.0,0,0,3170,0,1988,1035000.0
4.0,2.25,2260,1.0,0,0,2260,0,1967,925000.0
3.0,1.75,2930,1.0,0,0,2030,900,1993,600000.0
3.0,1.5,1060,1.0,0,2,1060,0,1981,354000.0
4.0,1.75,1740,1.0,0,0,1180,560,1978,204950.0
4.0,2.5,2990,2.0,0,0,2990,0,2005,675000.0
4.0,3.25,3530,2.0,0,0,3530,0,1986,995000.0
5.0,2.0,2960,1.0,0,0,1500,1460,1957,800000.0
3.0,2.5,1650,2.0,0,0,1650,0,1996,472500.0
4.0,2.5,2720,1.0,0,0,1510,1210,1969,549950.0
3.0,1.75,1516,1.0,0,0,998,518,1925,575575.0
4.0,3.25,4386,1.0,0,0,2356,2030,2006,545000.0
3.0,2.25,2580,1.0,0,0,1630,950,1963,340000.0
3.0,1.0,960,1.0,0,0,960,0,1963,225000.0
2.0,1.75,1460,1.0,0,0,1460,0,1983,299950.0
4.0,3.5,3840,2.0,0,0,2640,1200,2001,829900.0
4.0,2.5,2090,2.0,0,0,2090,0,2007,340000.0
4.0,2.25,2470,1.0,0,0,1470,1000,1975,515000.0
4.0,2.5,2090,2.0,0,0,2090,0,1992,601000.0
3.0,2.5,2070,2.0,0,0,2070,0,1994,470000.0
3.0,1.0,1650,1.0,0,0,980,670,1954,371500.0
3.0,1.75,1880,1.0,0,0,1410,470,1980,550000.0
4.0,2.5,2060,2.0,0,0,2060,0,1995,242550.0
3.0,1.5,1410,1.0,0,0,1410,0,1961,367500.0
4.0,3.5,2770,2.0,0,0,2100,670,1996,359000.0
3.0,2.0,1390,1.0,0,0,1390,0,1984,204900.0
4.0,2.75,5440,1.0,0,0,2720,2720,1969,850000.0
3.0,1.5,1280,2.0,0,0,1280,0,1985,187000.0
3.0,2.75,1720,1.0,0,0,1720,0,1958,326000.0
3.0,2.75,1720,1.0,0,0,1720,0,1958,340000.0
6.0,2.25,3040,1.0,0,0,1890,1150,1951,330000.0
4.0,3.5,3780,2.0,0,0,3110,670,2001,782000.0
4.0,2.5,2670,2.0,0,0,2670,0,1999,612000.0
3.0,2.0,1350,1.0,0,0,1350,0,1964,400000.0
5.0,3.5,3490,2.0,0,4,2460,1030,1980,941500.0
2.0,1.5,870,2.0,0,0,800,70,2004,313000.0
4.0,2.25,2410,1.5,0,0,1460,950,1929,735000.0
3.0,1.75,1640,1.0,0,0,1340,300,1977,471000.0
3.0,1.0,1540,1.0,0,0,1540,0,1950,350000.0
4.0,2.5,2370,1.0,0,0,1570,800,1976,530000.0
4.0,3.0,1830,2.0,0,0,1830,0,1991,415000.0
4.0,2.25,2330,2.0,0,0,2330,0,1986,639500.0
4.0,2.75,2240,1.5,0,0,2240,0,1976,580379.0
2.0,2.5,1700,2.0,0,0,1700,0,2009,378000.0
3.0,2.25,1750,1.0,0,0,1410,340,1969,265000.0
3.0,1.75,1100,1.0,0,0,1100,0,1967,212000.0
4.0,3.0,2320,2.0,0,2,2320,0,1998,400000.0
4.0,2.5,2540,2.0,0,0,2540,0,1997,750000.0
5.0,2.5,3090,1.0,0,0,1750,1340,1968,384900.0
2.0,1.0,770,1.0,0,0,770,0,1969,176000.0
3.0,2.75,2370,2.0,0,0,2370,0,2002,350000.0
3.0,1.0,1200,1.0,0,0,1200,0,1977,168000.0
4.0,2.0,2200,1.0,0,0,1100,1100,1908,358000.0
3.0,2.75,2660,1.0,0,0,2660,0,1975,580000.0
3.0,1.75,1600,1.0,0,0,1050,550,1977,442500.0
2.0,2.5,1330,3.0,0,0,1330,0,2004,515000.0
5.0,2.5,3440,1.0,0,2,1720,1720,1958,554000.0
3.0,2.5,2510,2.0,0,0,2510,0,1996,659000.0
4.0,2.5,2150,1.0,0,0,1090,1060,1963,414999.0
3.0,1.5,1180,1.0,0,0,1180,0,1983,275000.0
2.0,1.0,680,1.0,0,0,680,0,1951,193000.0
4.0,2.5,2840,2.0,0,0,2840,0,2002,525000.0
3.0,2.5,1820,2.0,0,0,1820,0,1985,424000.0
2.0,1.0,1070,1.0,0,0,870,200,1908,455000.0
2.0,1.0,1250,2.0,0,1,1250,0,1943,463000.0
4.0,2.5,2190,1.0,0,3,1240,950,1960,1100000.0
3.0,1.75,3000,2.0,0,0,1900,1100,1963,523000.0
4.0,1.75,2270,1.0,0,0,2270,0,1959,615000.0
4.0,4.0,4500,2.0,0,0,4500,0,1991,1515000.0
5.0,4.0,3400,2.0,0,0,2320,1080,1900,870000.0
3.0,2.5,2830,2.0,0,0,2830,0,1991,710000.0
3.0,1.0,960,1.0,0,0,960,0,1967,215000.0
2.0,1.0,1530,1.0,0,0,1530,0,1920,590000.0
5.0,2.5,2500,1.0,0,0,1300,1200,1962,323000.0
4.0,2.0,1560,1.5,0,0,1560,0,1966,279000.0
3.0,2.25,2070,1.0,0,0,1720,350,1973,535100.0
5.0,2.25,2710,1.0,0,0,1910,800,1959,830000.0
4.0,2.5,3150,2.0,0,0,3150,0,2002,815000.0
3.0,2.25,1880,1.0,0,0,1480,400,1975,535900.0
3.0,1.0,1250,1.0,0,0,1250,0,1955,230000.0
4.0,1.75,2290,1.0,0,0,1490,800,1969,325500.0
3.0,2.25,1990,2.0,0,0,1990,0,1997,359000.0
3.0,2.5,2100,2.0,0,2,2100,0,1999,505000.0
3.0,1.0,940,1.0,0,0,940,0,1958,253905.0
3.0,1.75,1640,1.0,0,0,1200,440,1965,369950.0
3.0,2.25,1860,2.0,0,0,1860,0,1995,350000.0
4.0,2.25,2100,3.0,0,0,2100,0,2001,650000.0
3.0,1.75,1500,1.0,0,0,1500,0,1925,295000.0
3.0,1.75,1680,1.0,0,3,1180,500,1948,620000.0
2.0,2.5,3900,2.0,0,0,3900,0,2009,1998000.0
3.0,1.0,1400,1.0,0,0,1400,0,1944,246000.0
3.0,2.75,2600,1.0,0,0,1350,1250,1965,430000.0
3.0,2.0,1440,2.0,0,0,1440,0,1921,509990.0
4.0,1.75,1870,1.0,0,0,1090,780,1962,490000.0
4.0,2.75,2960,1.0,0,1,2360,600,1979,385000.0
4.0,2.5,2440,2.0,0,0,2440,0,1999,769000.0
2.0,1.0,1122,1.0,0,0,1122,0,1960,185000.0
3.0,1.5,1060,1.0,0,0,1060,0,1973,303500.0
4.0,2.5,2150,1.0,0,0,1430,720,1957,468000.0
4.0,2.5,3100,2.0,0,0,3100,0,1978,449950.0
2.0,1.5,880,2.0,0,0,880,0,1999,235000.0
4.0,2.5,2490,2.0,0,0,2150,340,1985,520000.0
2.0,1.0,1080,1.0,0,0,1080,0,1951,203000.0
5.0,2.5,2530,1.0,0,0,1290,1240,1960,657000.0
3.0,1.0,1200,1.0,0,0,1200,0,1954,275000.0
4.0,2.25,2850,2.0,0,0,2850,0,1991,540000.0
4.0,2.5,2950,2.0,0,0,2950,0,2005,455000.0
2.0,1.75,1160,1.0,0,0,860,300,1941,458500.0
4.0,3.5,3420,2.0,0,0,3420,0,2003,549900.0
3.0,1.75,2240,2.0,0,0,1550,690,1923,750000.0
4.0,1.75,1450,1.5,0,0,1180,270,1962,235000.0
4.0,2.5,1820,2.0,0,0,1820,0,1989,286000.0
4.0,3.5,4700,2.0,0,3,3500,1200,1958,2650000.0
4.0,1.75,2430,1.0,0,0,1580,850,1963,602000.0
3.0,1.5,1960,1.5,0,0,1960,0,1915,640000.0
3.0,1.75,1440,1.0,0,0,1440,0,1977,267000.0
4.0,2.5,2730,2.0,0,0,2730,0,2001,712000.0
2.0,1.0,910,1.0,0,0,910,0,1923,244500.0
2.0,1.0,910,1.0,0,0,910,0,1923,301000.0
4.0,2.5,2430,2.0,0,0,2020,410,1919,990000.0
4.0,2.75,3350,2.0,0,0,3350,0,1999,739999.0
4.0,1.75,2320,1.0,0,0,1140,1180,1910,480000.0
3.0,2.5,1260,3.0,0,0,1260,0,2009,305000.0
3.0,2.0,1980,1.5,0,0,1590,390,1932,703300.0
4.0,1.5,1580,2.0,0,0,1580,0,1971,265000.0
4.0,2.5,2710,2.0,0,2,2710,0,1992,600000.0
3.0,1.0,1400,1.0,0,0,1400,0,1968,253000.0
4.0,2.5,2410,2.0,0,0,2410,0,1997,617950.0
4.0,3.25,1790,2.0,0,0,1100,690,2000,385000.0
3.0,2.0,1640,1.0,0,0,1060,580,1967,319000.0
3.0,2.5,1670,1.0,0,0,1170,500,1960,696000.0
2.0,1.0,970,1.0,0,0,970,0,1932,345000.0
3.0,2.5,1610,3.0,0,0,1610,0,2002,380000.0
4.0,1.75,2060,1.0,0,0,1160,900,1947,647500.0
3.0,2.5,3570,2.0,0,0,3570,0,1997,725000.0
3.0,1.75,1400,1.0,0,0,1400,0,1989,269950.0
4.0,2.5,3470,2.0,0,0,3470,0,1995,875000.0
3.0,1.0,1210,1.0,0,0,1210,0,1955,299950.0
4.0,3.25,3930,2.0,0,0,3930,0,2006,1875000.0
2.0,1.0,990,1.0,0,0,990,0,1947,430000.0
5.0,2.5,2200,2.0,0,0,2200,0,1989,495000.0
3.0,1.5,1510,1.0,0,0,1510,0,1970,275000.0
3.0,1.0,1620,1.0,0,0,1120,500,1964,333000.0
3.0,2.25,1580,2.0,0,0,1580,0,1986,247000.0
3.0,1.75,1260,1.5,0,0,1260,0,1983,204555.0
3.0,2.0,2190,1.0,0,0,2190,0,1994,432000.0
3.0,1.75,1230,1.0,0,0,1230,0,1962,175000.0
4.0,2.5,2030,1.0,0,0,1400,630,1968,556300.0
2.0,1.0,780,1.0,0,0,780,0,1930,286000.0
2.0,1.5,1110,3.0,0,0,1110,0,2000,320000.0
3.0,2.5,2790,2.0,0,0,2790,0,1991,815000.0
4.0,1.75,1660,1.0,0,0,1000,660,1980,385000.0
4.0,1.0,3410,2.0,0,0,2190,1220,1910,1039000.0
4.0,2.25,2390,2.0,0,0,2390,0,1987,350000.0
4.0,2.5,1850,2.0,0,0,1850,0,1998,277000.0
6.0,2.0,2500,1.0,0,0,1250,1250,1966,415000.0
3.0,1.0,1000,1.0,0,0,1000,0,1951,295000.0
4.0,2.0,2450,2.0,0,4,2200,250,1919,969000.0
4.0,1.75,1440,1.0,0,0,720,720,1947,339888.0
3.0,2.25,1660,2.0,0,0,1660,0,1996,269950.0
3.0,2.5,2510,2.0,0,2,2510,0,2006,1185000.0
4.0,2.5,3090,2.0,0,0,3090,0,1998,780000.0
3.0,1.0,860,1.0,0,0,860,0,1968,198000.0
2.0,1.0,1220,1.0,0,0,1220,0,1953,350000.0
3.0,1.0,1010,1.0,0,0,1010,0,1967,350000.0
4.0,2.25,2390,2.0,0,0,2390,0,1990,319000.0
4.0,2.25,3340,2.0,0,0,3340,0,1973,311000.0
5.0,3.25,3620,2.0,0,0,2790,830,2004,394000.0
5.0,2.25,4200,2.5,0,0,2910,1290,1906,1335000.0
5.0,2.75,3831,2.0,1,4,3831,0,1959,2700000.0
3.0,1.0,1980,1.0,0,0,1080,900,1949,396000.0
4.0,1.75,1790,1.0,0,0,1340,450,1976,809000.0
3.0,2.0,1580,1.0,0,0,1050,530,1977,480000.0
6.0,1.75,2460,1.0,0,0,1230,1230,1913,535000.0
5.0,2.75,2110,2.0,0,0,1870,240,1947,425000.0
3.0,2.5,1470,3.0,0,0,1470,0,2006,408000.0
4.0,2.5,3510,2.0,0,0,3510,0,1966,1255000.0
1.0,0.75,520,1.0,0,0,520,0,1947,310000.0
3.0,2.5,1950,2.0,0,0,1950,0,1996,292000.0
2.0,1.0,770,1.0,0,0,770,0,1942,217000.0
4.0,2.5,2250,2.0,0,0,2250,0,2005,398500.0
3.0,3.0,4040,1.5,0,2,3340,700,1930,2250000.0
4.0,1.75,2360,1.0,0,0,1280,1080,1955,700000.0
4.0,2.5,2330,2.0,0,0,2330,0,1989,585000.0
3.0,1.0,1720,1.0,0,0,1720,0,1954,399950.0
3.0,1.75,1900,1.0,0,0,950,950,1980,235000.0
3.0,1.0,1040,1.0,0,0,1040,0,1951,212000.0
3.0,2.0,2070,1.0,0,0,1220,850,1982,310000.0
3.0,2.0,2070,1.0,0,0,1220,850,1982,539000.0
3.0,3.0,1550,2.0,0,0,1280,270,2001,390000.0
3.0,2.5,2020,1.0,0,0,2020,0,1976,560000.0
5.0,2.5,3320,2.0,0,0,3320,0,1999,800000.0
4.0,3.25,4130,2.0,0,0,4130,0,1978,1900000.0
5.0,2.0,2030,1.0,0,0,1110,920,1963,472000.0
3.0,1.75,1770,1.0,0,0,1170,600,1958,502550.0
4.0,3.25,3330,2.0,0,0,3330,0,2004,830000.0
4.0,2.5,2260,1.0,0,0,1520,740,1965,224950.0
3.0,2.5,1950,2.0,0,0,1950,0,1997,375000.0
3.0,2.5,2930,1.5,0,0,2930,0,1983,645000.0
3.0,2.75,1960,1.5,0,0,1410,550,1926,599000.0
4.0,2.5,2980,2.0,0,0,2980,0,1996,515000.0
2.0,1.0,780,1.0,0,0,780,0,1948,135000.0
3.0,2.5,1650,2.0,0,0,1650,0,2000,485000.0
3.0,3.25,4030,2.0,0,0,2800,1230,1975,890000.0
3.0,1.0,1010,1.0,0,0,1010,0,1972,215000.0
3.0,1.0,1190,1.0,0,0,1190,0,1981,299500.0
2.0,1.0,1050,1.0,0,0,1050,0,1951,800000.0
3.0,2.5,1560,2.0,0,0,1560,0,2002,275000.0
3.0,1.5,1490,1.0,0,0,1010,480,1963,256400.0
2.0,1.0,770,1.0,0,0,770,0,1948,310000.0
1.0,1.0,620,1.0,0,0,620,0,1954,385000.0
3.0,1.5,1200,1.0,0,0,1000,200,1963,203000.0
4.0,2.0,2120,1.0,0,0,1060,1060,1954,285000.0
3.0,2.5,2330,2.0,0,0,2330,0,1999,473975.0
3.0,1.75,2000,1.0,0,0,1400,600,1978,320000.0
5.0,2.75,2820,1.0,0,0,1450,1370,1967,599000.0
3.0,2.0,2040,1.0,0,0,1020,1020,1925,580000.0
4.0,2.25,1700,2.0,0,0,1700,0,1999,269500.0
2.0,1.0,820,1.0,0,0,820,0,1954,274000.0
2.0,1.75,1315,2.0,0,0,1315,0,1974,347000.0
3.0,1.75,1390,1.0,0,0,860,530,1957,270000.0
3.0,2.0,1890,1.0,0,2,1890,0,1949,1430000.0
3.0,1.75,1460,1.0,0,0,1460,0,1993,220000.0
3.0,1.0,1480,1.0,0,2,1480,0,1955,243000.0
3.0,1.75,1840,1.0,0,0,1050,790,1925,457500.0
2.0,1.75,1880,1.0,0,0,940,940,1951,340000.0
4.0,1.5,1910,1.5,0,0,1610,300,1912,657500.0
4.0,2.5,2220,2.0,0,0,2220,0,1998,332500.0
3.0,2.0,1410,1.0,0,3,1410,0,1993,340000.0
4.0,3.0,3380,1.0,0,1,2330,1050,1959,350000.0
4.0,2.5,1950,1.0,0,0,1120,830,1966,428000.0
4.0,2.5,2400,2.0,0,0,2400,0,1999,515055.0
3.0,1.75,1560,1.0,0,0,1560,0,1972,450000.0
3.0,1.0,1040,1.0,0,0,1040,0,1943,190000.0
4.0,2.75,3090,3.0,0,0,2590,500,1919,1000000.0
3.0,2.5,1850,2.0,0,0,1850,0,2005,299000.0
2.0,1.0,1200,2.0,0,2,1090,110,1927,508000.0
4.0,2.25,2190,2.0,0,0,2190,0,2005,294000.0
2.0,1.0,1380,1.0,0,0,1380,0,1918,320000.0
5.0,2.75,3710,2.0,0,0,3710,0,1996,641000.0
3.0,2.5,2320,1.0,0,0,1380,940,1978,675000.0
3.0,1.5,1110,1.0,0,0,1110,0,1964,255000.0
3.0,2.5,1830,2.0,0,0,1830,0,2004,286651.0
4.0,2.5,2460,1.0,0,0,1650,810,1969,607500.0
3.0,1.0,1270,1.0,0,0,1270,0,1956,765000.0
4.0,1.75,1700,1.0,0,0,1700,0,1961,334950.0
3.0,1.0,1130,1.0,0,0,1130,0,1952,426000.0
3.0,1.75,1640,1.5,0,0,1640,0,1946,775000.0
2.0,1.5,1040,1.0,0,0,1040,0,1953,343000.0
4.0,2.5,2320,2.0,0,0,2320,0,1986,470101.0
3.0,1.5,1200,1.0,0,0,1200,0,1958,195000.0
4.0,1.0,1720,1.5,0,2,1720,0,1928,772500.0
3.0,1.5,2330,1.0,0,0,1330,1000,1954,450000.0
4.0,3.75,4410,3.0,0,3,4410,0,2001,1437500.0
4.0,1.75,1650,1.0,0,0,1650,0,1970,525000.0
3.0,1.5,1370,2.0,0,0,1370,0,1980,280000.0
3.0,2.5,1770,1.0,0,0,1420,350,1986,270000.0
3.0,2.25,1410,3.0,0,0,1410,0,2005,406100.0
2.0,1.75,1710,1.0,0,0,1710,0,1987,332544.0
2.0,1.0,790,1.0,0,0,790,0,1947,110000.0
6.0,2.25,2770,1.5,0,0,2120,650,1921,685000.0
4.0,1.0,1260,1.5,0,0,1260,0,1951,461000.0
3.0,2.25,2300,1.0,0,0,1300,1000,1979,615000.0
2.0,1.0,1070,1.0,0,0,870,200,1926,550000.0
4.0,3.5,3850,2.0,0,1,2430,1420,1995,1060000.0
3.0,2.5,2320,2.0,0,0,2320,0,1993,685000.0
5.0,2.5,2870,2.0,0,0,2870,0,1962,1555000.0
4.0,2.5,1830,2.0,0,0,1830,0,2003,312000.0
3.0,1.75,1990,1.0,0,0,1190,800,1977,507500.0
3.0,1.0,1110,1.0,0,0,1110,0,1966,217000.0
3.0,2.25,1830,1.0,0,3,1170,660,1981,439000.0
6.0,3.5,3600,2.0,0,0,2740,860,2004,620000.0
4.0,2.5,3210,2.0,0,0,3210,0,1998,915000.0
4.0,2.0,1490,1.0,0,0,1110,380,1977,425000.0
2.0,1.0,990,1.0,0,0,870,120,1947,435000.0
3.0,2.25,1646,2.0,0,0,1646,0,1996,305000.0
2.0,1.0,720,1.0,0,0,720,0,1918,276000.0
3.0,2.25,2310,2.0,0,0,2310,0,1990,327500.0
3.0,2.5,2670,2.0,0,0,2670,0,2003,810000.0
3.0,3.25,3060,2.0,0,0,2460,600,1994,715000.0
3.0,1.5,1380,1.0,0,0,1380,0,1963,272000.0
2.0,1.0,700,1.0,0,0,700,0,1949,266000.0
3.0,1.5,1710,2.0,0,2,1710,0,1944,543000.0
3.0,2.5,1450,1.0,0,0,1450,0,1984,400000.0
5.0,2.25,2060,1.0,0,0,1320,740,1961,509500.0
3.0,3.5,2380,2.0,0,3,1670,710,1997,495000.0
4.0,2.5,2760,2.0,0,0,2760,0,2001,424950.0
3.0,1.0,940,1.0,0,0,940,0,1957,230000.0
4.0,1.5,1760,1.5,0,0,1760,0,1951,235000.0
3.0,2.0,1360,1.0,0,2,1360,0,1942,763000.0
3.0,1.75,2010,2.0,0,0,2010,0,1939,350000.0
3.0,1.5,2160,2.0,0,2,1620,540,1917,900000.0
3.0,1.0,930,1.0,0,0,930,0,1973,250000.0
3.0,2.5,1020,2.0,0,0,720,300,2004,225000.0
2.0,2.0,1360,1.0,0,0,1360,0,1974,255000.0
4.0,1.75,1720,1.0,0,0,1220,500,1974,161700.0
3.0,3.0,1790,1.0,0,0,1190,600,1988,336000.0
3.0,1.0,1150,1.0,0,0,1150,0,1954,410500.0
4.0,3.5,2710,2.0,0,0,2710,0,1968,502700.0
3.0,2.5,2400,1.0,0,0,1390,1010,1977,505000.0
3.0,1.0,1660,1.5,0,0,1350,310,1910,250000.0
3.0,1.0,1660,1.5,0,0,1350,310,1910,570000.0
4.0,2.5,2290,2.0,0,0,2290,0,1994,349900.0
3.0,2.5,2870,2.0,0,0,2870,0,1988,465000.0
4.0,3.25,4240,2.0,0,3,3550,690,1989,625000.0
3.0,1.75,1800,1.0,0,0,1170,630,1952,655000.0
4.0,1.75,2960,1.0,0,0,1570,1390,1946,469000.0
3.0,2.25,1980,1.0,0,0,1300,680,1964,355000.0
3.0,2.5,1730,2.0,0,0,1730,0,2001,596000.0
4.0,2.5,3020,2.0,0,0,3020,0,1986,790000.0
4.0,2.25,4470,2.0,0,0,4470,0,1991,885000.0
4.0,3.25,2830,2.0,0,0,1910,920,1912,1030000.0
4.0,1.75,2120,1.0,0,0,1060,1060,1941,710000.0
3.0,2.5,2150,2.0,0,0,2150,0,1988,428040.0
5.0,2.25,3510,1.0,0,2,1850,1660,1959,1370000.0
2.0,1.0,970,1.0,0,0,970,0,1924,546000.0
4.0,1.0,1360,1.5,0,0,1360,0,1951,540000.0
3.0,2.5,1470,1.0,0,0,930,540,1985,435000.0
4.0,2.25,3040,1.0,0,0,1430,1610,1984,540000.0
2.0,1.0,860,1.0,0,0,860,0,1918,284000.0
2.0,1.0,820,1.0,0,0,820,0,1942,208000.0
3.0,1.75,1900,1.0,0,0,1130,770,1977,315000.0
2.0,1.0,1330,1.0,0,0,850,480,1910,417500.0
3.0,1.75,1240,1.0,0,0,1240,0,1978,345000.0
3.0,2.5,1330,3.0,0,0,1330,0,2004,375000.0
3.0,1.75,1880,1.0,0,0,1880,0,1959,389800.0
3.0,1.75,1890,1.0,0,0,1430,460,1973,475000.0
4.0,2.25,2250,2.0,0,0,2250,0,1980,569000.0
5.0,4.25,4650,2.0,0,0,3260,1390,1999,985000.0
3.0,2.5,1830,2.0,0,0,1830,0,1987,532000.0
2.0,1.0,720,1.0,0,0,720,0,1951,280000.0
4.0,2.0,1960,1.0,0,0,1050,910,1963,435000.0
3.0,1.0,1220,1.0,0,0,1220,0,1952,223000.0
2.0,1.0,1800,1.0,0,0,1200,600,1947,390000.0
3.0,1.75,1340,1.0,0,0,880,460,1981,315000.0
3.0,3.0,1740,1.0,0,0,1740,0,1982,612000.0
3.0,1.75,1680,1.0,0,0,870,810,1922,591000.0
4.0,2.25,3220,2.0,0,0,3220,0,1968,800000.0
3.0,2.0,1610,1.0,0,0,1610,0,1990,225000.0
2.0,3.0,3160,2.0,0,0,3160,0,1993,589900.0
4.0,2.5,2520,1.0,0,0,1520,1000,1979,565000.0
3.0,1.5,2120,1.0,0,0,1060,1060,1940,650000.0
3.0,2.5,2090,2.0,0,0,2090,0,1951,499000.0
3.0,1.0,1330,1.5,0,0,1330,0,1959,280000.0
3.0,2.5,2420,1.0,0,2,1210,1210,1944,649950.0
3.0,1.75,1510,1.0,0,0,1510,0,1954,420000.0
4.0,2.5,2120,2.0,0,0,2120,0,2003,319990.0
3.0,2.0,1850,1.0,0,0,1850,0,1992,265000.0
3.0,1.75,2300,1.0,0,0,1220,1080,1984,482000.0
3.0,2.25,2600,1.0,0,2,1490,1110,1956,452000.0
4.0,4.25,5180,2.0,0,3,4280,900,1998,1488000.0
2.0,1.0,1810,1.5,0,0,1810,0,1943,375000.0
5.0,3.0,2190,2.0,0,0,1490,700,1940,588000.0
4.0,2.5,2500,2.0,0,0,2500,0,1998,635000.0
4.0,2.5,1890,2.0,0,0,1890,0,1997,280500.0
2.0,1.75,2040,1.0,0,0,1430,610,1985,210500.0
3.0,2.0,1310,1.0,0,0,1310,0,1979,196500.0
5.0,3.5,4010,2.0,0,1,2850,1160,1971,1395000.0
3.0,1.75,1780,1.0,0,0,1210,570,1977,475000.0
3.0,2.5,1980,2.0,0,0,1980,0,1987,550000.0
3.0,3.25,3690,2.0,0,0,3690,0,2007,1580000.0
3.0,1.75,1540,1.0,0,0,1200,340,1991,240000.0
3.0,1.0,1130,1.5,0,0,1130,0,1934,272000.0
3.0,2.75,2480,1.5,0,0,1870,610,2000,408506.0
3.0,2.5,2580,2.0,0,0,2580,0,1991,640000.0
4.0,2.5,2010,2.0,0,0,2010,0,1995,316000.0
4.0,2.0,2320,1.0,0,0,1720,600,1943,299000.0
2.0,2.25,1180,2.0,0,0,1180,0,2004,447500.0
4.0,2.5,3180,2.0,0,3,3180,0,2000,736500.0
4.0,2.0,2970,2.0,0,0,2970,0,1924,665000.0
5.0,2.5,3050,1.0,0,0,1590,1460,1975,707000.0
4.0,1.75,1630,1.0,0,0,1630,0,1959,215000.0
3.0,2.25,1620,2.0,0,0,1620,0,1989,275000.0
4.0,2.25,2170,2.0,0,1,2170,0,1983,648000.0
4.0,2.5,2150,2.0,0,0,2150,0,1987,415000.0
3.0,2.0,1770,3.0,0,0,1770,0,1999,690000.0
4.0,2.75,2110,1.0,0,0,1290,820,1979,320000.0
3.0,1.75,1590,1.0,0,0,1590,0,1956,750000.0
3.0,2.25,1370,3.0,0,0,1370,0,2005,355000.0
3.0,1.75,1390,1.0,0,0,1390,0,1975,246000.0
3.0,1.75,1640,1.0,0,2,1640,0,1968,1155000.0
3.0,2.5,2670,2.0,0,0,2670,0,1986,744000.0
3.0,3.75,5400,2.0,0,0,5400,0,1997,1210000.0
3.0,2.0,1690,1.0,0,0,1210,480,1977,217000.0
3.0,2.5,2600,2.0,0,1,2600,0,1998,583000.0
2.0,1.5,1400,1.0,0,0,1150,250,1904,515000.0
4.0,1.75,2140,1.0,0,0,1410,730,1965,594000.0
3.0,1.5,1640,1.0,0,0,1640,0,1952,303100.0
3.0,1.75,1720,1.0,0,0,1020,700,1970,430000.0
5.0,3.25,3060,2.0,0,0,3060,0,2004,708000.0
3.0,1.0,1150,1.0,0,0,1150,0,1959,221000.0
3.0,2.5,2000,2.0,0,0,2000,0,1998,325000.0
,,4810,2.0,0,0,4810,0,1990,1295650.0
3.0,1.75,1560,1.0,0,0,780,780,1944,385000.0
3.0,2.5,2070,2.0,0,0,2070,0,2013,359500.0
3.0,2.0,1920,1.0,0,0,1300,620,1984,433000.0
2.0,1.0,1000,1.0,0,0,800,200,1948,525000.0
3.0,2.0,1690,1.0,0,2,940,750,1928,356200.0
4.0,2.0,3090,1.0,0,0,1590,1500,1974,595000.0
4.0,1.5,1790,1.0,0,0,1020,770,1923,560000.0
4.0,3.0,4750,1.5,0,0,4750,0,1976,2175000.0
4.0,2.0,2090,1.0,0,0,1480,610,1951,513000.0
2.0,1.0,680,1.0,0,0,680,0,1901,365000.0
4.0,1.75,2100,1.0,0,0,1030,1070,1964,368000.0
4.0,2.75,2840,1.5,0,0,1960,880,1912,870000.0
3.0,2.25,1470,1.0,0,0,1160,310,1984,225000.0
4.0,4.5,4490,2.0,0,2,3800,690,1998,1387000.0
3.0,1.75,1150,1.0,0,0,1150,0,1983,177000.0
3.0,1.5,1460,1.0,0,0,1460,0,1956,465000.0
4.0,2.75,3150,1.0,0,3,1810,1340,1976,750000.0
3.0,1.0,1090,1.0,0,0,1090,0,1969,149000.0
3.0,2.5,2670,2.0,0,3,2670,0,1981,605000.0
3.0,2.0,2110,1.5,0,0,1990,120,1927,725000.0
4.0,2.25,1770,2.0,0,0,1770,0,2007,413900.0
3.0,1.5,1510,1.0,0,0,1510,0,1938,199950.0
1.0,1.0,530,1.0,0,0,530,0,1949,400000.0
3.0,1.5,2420,2.0,0,0,2200,220,1925,870000.0
5.0,2.5,2490,1.0,0,0,1490,1000,1989,292000.0
3.0,1.0,990,1.0,0,0,990,0,1966,225000.0
4.0,2.0,1730,2.0,0,0,1730,0,1957,466750.0
2.0,1.5,1440,1.0,0,0,1440,0,1978,330000.0
7.0,2.25,3260,2.0,0,0,3260,0,1967,770000.0
4.0,2.25,1950,1.0,0,1,1450,500,1957,802500.0
5.0,2.5,2740,2.0,0,0,2740,0,2005,378800.0
3.0,2.75,2940,2.0,0,0,2940,0,1997,795000.0
3.0,2.0,1200,1.0,0,0,1200,0,1955,460000.0
3.0,2.5,2070,2.0,0,0,2070,0,1986,567000.0
3.0,1.75,1570,1.0,0,0,1570,0,1981,209950.0
2.0,1.0,1050,1.0,0,0,1050,0,1943,415000.0
4.0,1.5,1830,1.0,0,0,1080,750,1967,424500.0
2.0,1.0,970,1.0,0,0,970,0,1941,261000.0
3.0,2.5,2200,2.0,0,0,2200,0,1987,365000.0
4.0,2.0,1930,1.5,0,0,1930,0,1911,631000.0
5.0,5.5,7050,1.0,0,2,4320,2730,1978,3800000.0
3.0,2.5,1790,2.0,0,0,1790,0,1992,584000.0
3.0,1.75,1560,1.0,0,0,1560,0,1974,310000.0
4.0,2.5,2780,2.0,0,0,2780,0,1992,717000.0
3.0,1.5,1720,2.0,0,0,1720,0,1907,667000.0
3.0,1.0,1640,1.0,0,0,1040,600,1939,190000.0
3.0,2.0,1730,1.0,0,0,1370,360,1978,430000.0
2.0,1.0,740,1.0,0,0,740,0,1951,213000.0
3.0,2.5,2280,1.0,0,0,1550,730,1990,475000.0
2.0,2.75,2090,2.0,0,3,2090,0,1988,649000.0
3.0,2.5,2550,2.0,0,0,2550,0,1990,715000.0
4.0,3.5,3350,1.0,0,0,2460,890,1992,845000.0
3.0,2.5,2770,1.0,0,0,1900,870,1980,390000.0
4.0,3.0,2860,1.0,0,0,1730,1130,1983,390000.0
4.0,1.75,1990,1.0,0,0,1400,590,1978,328000.0
3.0,2.75,1740,1.0,0,0,1140,600,1967,239999.0
3.0,2.0,1460,1.0,0,0,1460,0,1968,225000.0
3.0,1.75,3670,1.0,0,2,1950,1720,1979,920000.0
4.0,2.75,3270,2.0,0,0,3270,0,1995,940000.0
3.0,1.0,1210,1.0,0,0,1210,0,1949,465000.0
3.0,2.0,1770,1.0,0,0,1770,0,1986,241000.0
4.0,2.5,1980,2.0,0,0,1980,0,2003,307550.0
4.0,2.5,2650,1.0,0,3,1610,1040,1976,490000.0
4.0,2.5,3040,2.0,0,0,3040,0,1999,647000.0
4.0,2.75,3640,1.5,0,0,3640,0,1999,780000.0
3.0,2.5,1810,2.0,0,0,1810,0,1992,517500.0
3.0,2.0,1380,1.0,0,0,1380,0,1966,295000.0
4.0,1.5,1810,2.0,0,0,1810,0,1926,560000.0
5.0,2.0,2250,1.5,0,0,1750,500,1930,319450.0
4.0,3.25,3860,2.0,0,1,2870,990,2005,1500000.0
4.0,3.0,2380,1.0,0,0,1500,880,1999,340000.0
3.0,1.0,1370,1.0,0,0,1370,0,1958,249950.0
3.0,1.0,1830,1.5,0,0,1430,400,1926,499950.0
4.0,1.75,1440,1.0,0,0,1440,0,1967,1038000.0
4.0,2.5,2510,1.0,0,2,1540,970,1977,750000.0
4.0,2.5,3230,2.0,0,0,3230,0,2006,875000.0
3.0,1.75,1670,1.0,0,0,1670,0,1967,678000.0
2.0,1.0,780,1.0,0,0,780,0,1920,360000.0
3.0,1.0,1720,1.0,0,0,1720,0,1971,354900.0
5.0,2.5,2260,1.0,0,0,1520,740,1967,632000.0
3.0,1.75,1480,1.0,0,0,1480,0,1957,350000.0
3.0,4.0,2550,2.0,0,2,2050,500,1940,990000.0
4.0,3.25,3920,3.0,0,3,3920,0,2002,1650000.0
4.0,2.5,2286,2.0,0,0,2286,0,2002,481000.0
3.0,2.5,1500,1.0,0,0,900,600,1920,485000.0
3.0,2.5,1740,2.0,0,0,1740,0,1992,477000.0
5.0,2.5,2880,1.0,0,0,1440,1440,1966,560000.0
6.0,3.0,2600,1.0,0,0,1340,1260,1963,600000.0
5.0,2.75,3320,2.0,0,0,2190,1130,1975,622500.0
2.0,2.25,1660,2.0,0,0,1660,0,1974,410000.0
3.0,2.5,1990,2.0,0,0,1990,0,2010,318200.0
3.0,2.0,1680,1.0,0,0,1680,0,1993,289000.0
3.0,1.75,1570,2.0,0,0,1570,0,1982,263000.0
3.0,1.0,1150,1.0,0,0,1150,0,1957,240000.0
3.0,1.0,1270,1.0,0,0,1270,0,1953,281500.0
3.0,3.5,1890,2.0,0,0,1640,250,1999,587206.0
2.0,2.25,1350,2.0,0,0,1180,170,2000,482000.0
3.0,1.75,1650,1.0,0,0,1650,0,1967,485000.0
3.0,2.5,1450,2.0,0,0,1450,0,1990,309000.0
3.0,2.25,1640,1.0,0,0,1140,500,1984,221000.0
3.0,2.5,2030,2.0,0,0,2030,0,1975,700000.0
5.0,3.0,2420,1.0,0,0,1360,1060,1929,411500.0
4.0,3.5,2770,2.0,0,0,2770,0,1940,285000.0
4.0,3.0,1980,1.0,0,0,1160,820,1983,395000.0
2.0,1.75,1460,1.0,0,0,1460,0,1987,237950.0
3.0,2.5,1610,1.0,0,2,1160,450,1981,680000.0
2.0,1.0,1010,1.0,0,0,1010,0,1961,199950.0
4.0,3.5,2760,2.0,0,2,2000,760,1926,765000.0
2.0,1.0,1060,1.0,0,0,1060,0,1926,515000.0
3.0,1.5,1510,1.0,0,0,1510,0,1956,470000.0
2.0,1.0,880,1.0,0,0,780,100,1937,330000.0
3.0,2.5,2150,1.0,0,0,1550,600,1968,284000.0
3.0,2.5,1660,1.0,0,0,1150,510,1999,295000.0
4.0,2.5,2160,1.0,0,0,1440,720,1981,555000.0
3.0,1.0,1370,1.5,0,0,1370,0,1949,350000.0
3.0,2.25,1460,1.0,0,0,1140,320,1986,240000.0
3.0,1.5,1450,1.0,0,0,1450,0,1955,419900.0
3.0,2.0,1560,1.0,0,0,1560,0,1924,528000.0
4.0,2.5,2480,1.0,0,0,1240,1240,1963,481000.0
2.0,1.0,740,1.0,0,0,740,0,1949,304700.0
4.0,2.5,2927,2.0,0,0,2927,0,1998,715000.0
4.0,2.75,2260,1.0,0,0,2260,0,1956,738950.0
3.0,1.5,1240,1.0,0,0,1240,0,1966,215000.0
6.0,2.0,2040,1.0,0,0,2040,0,1943,300000.0
3.0,1.75,1270,1.0,0,0,880,390,1950,346000.0
4.0,3.5,4370,2.0,0,3,2780,1590,1996,473000.0
3.0,1.75,1700,1.0,0,0,1700,0,1952,500000.0
2.0,1.5,1300,1.0,0,2,1300,0,1943,750000.0
4.0,2.0,1820,1.0,0,0,1820,0,1967,519900.0
2.0,1.0,880,1.0,0,0,880,0,1949,378500.0
3.0,1.75,1870,1.0,0,0,1870,0,1957,314500.0
3.0,1.5,1350,1.0,0,0,1350,0,1968,499950.0
5.0,3.5,4870,2.5,0,3,3650,1220,1929,1735000.0
3.0,2.5,2460,2.0,0,0,2460,0,1999,630000.0
4.0,1.5,1720,1.0,0,0,1720,0,1953,360000.0
2.0,1.5,2730,1.0,0,0,1570,1160,1976,460000.0
3.0,1.0,1100,1.5,0,4,1100,0,1922,361000.0
3.0,2.25,1810,1.0,0,0,1810,0,1959,713400.0
2.0,1.0,930,1.0,0,0,930,0,1918,445000.0
4.0,1.5,1590,1.0,0,3,1590,0,1966,305000.0
3.0,2.75,2710,1.5,0,4,1480,1230,1975,1430000.0
3.0,1.0,1460,1.0,0,0,1460,0,1962,222000.0
5.0,3.25,3400,2.0,0,0,2740,660,2005,510000.0
5.0,3.0,2920,2.0,0,0,2920,0,2003,500000.0
2.0,1.0,910,1.0,0,0,910,0,1909,605000.0
3.0,2.0,1320,2.0,0,0,1320,0,1981,393000.0
4.0,2.5,2490,2.0,0,0,2490,0,2000,725000.0
3.0,1.75,2220,1.0,0,0,1270,950,1950,320000.0
4.0,1.5,1130,1.0,0,0,1130,0,1970,210000.0
4.0,2.5,2750,2.0,0,0,2750,0,2005,419900.0
4.0,2.5,2240,2.0,0,0,2240,0,2006,410000.0
3.0,2.25,2680,1.0,0,1,1540,1140,1963,721000.0
2.0,2.0,1270,1.5,0,0,1270,0,1921,605000.0
3.0,1.75,1520,1.5,0,0,1520,0,1936,738000.0
6.0,3.0,2480,2.0,0,0,2480,0,1972,725000.0
2.0,1.0,960,1.0,0,0,960,0,1977,255000.0
3.0,2.25,1340,3.0,0,0,1340,0,2009,303000.0
3.0,2.5,1090,1.0,0,0,1090,0,1957,394950.0
4.0,3.0,2240,2.0,0,0,1830,410,1949,530000.0
4.0,2.5,3740,1.0,0,0,2260,1480,2004,475000.0
4.0,2.5,1800,2.0,0,0,1800,0,1998,250000.0
3.0,1.0,780,1.0,0,0,780,0,1920,180000.0
2.0,1.0,1330,1.0,0,0,930,400,1919,443500.0
4.0,2.0,1900,1.0,0,0,1900,0,2004,390000.0
4.0,1.75,1570,1.0,0,0,1100,470,1975,430000.0
5.0,4.5,3100,2.0,0,0,3100,0,1963,460000.0
3.0,3.5,2740,2.0,0,0,2190,550,2001,660000.0
3.0,1.75,1570,1.0,0,0,1200,370,1974,515000.0
3.0,2.0,1330,1.0,0,0,1330,0,1954,482500.0
2.0,1.5,1140,2.0,0,0,1140,0,1988,305000.0
4.0,2.75,1550,1.5,0,0,1550,0,1930,835000.0
3.0,2.0,1290,1.0,0,0,1290,0,1998,237000.0
2.0,1.5,1510,2.0,0,0,1510,0,1985,445000.0
4.0,2.5,2720,1.0,0,0,1360,1360,1955,710000.0
3.0,1.0,840,1.0,0,0,840,0,1945,180000.0
3.0,2.5,1850,2.0,0,0,1850,0,1996,280017.0
4.0,2.5,2290,2.0,0,0,2290,0,1988,436500.0
4.0,2.5,3200,2.0,0,0,3200,0,2006,1255000.0
3.0,2.25,1800,1.0,0,0,1300,500,1959,420000.0
3.0,1.0,860,1.0,0,0,860,0,1944,205000.0
3.0,1.5,1980,1.0,0,0,1680,300,1946,570000.0
4.0,1.75,2140,1.0,0,0,1070,1070,1948,565000.0
2.0,2.5,2410,1.0,0,0,1550,860,1978,287000.0
4.0,1.75,1650,1.0,0,0,1010,640,1977,260000.0
4.0,1.75,1650,1.0,0,0,1010,640,1977,470000.0
3.0,2.5,2410,2.0,0,0,2410,0,1989,700000.0
3.0,1.75,1520,1.0,0,0,1520,0,1985,249000.0
3.0,1.75,2050,1.0,0,0,1070,980,1977,568000.0
4.0,1.0,1720,1.5,0,0,1720,0,1904,500000.0
5.0,2.5,2390,1.0,0,0,1270,1120,1980,358000.0
3.0,2.5,1680,2.0,0,0,1680,0,1994,225000.0
3.0,1.0,1060,1.0,0,0,1060,0,1981,275500.0
3.0,2.5,1860,2.0,0,0,1860,0,2001,495000.0
5.0,2.25,1750,1.0,0,0,960,790,1940,758800.0
3.0,1.75,1480,1.0,0,0,1480,0,1985,280000.0
3.0,2.5,1900,2.0,0,0,1900,0,1994,380500.0
7.0,4.5,6210,2.5,0,2,4760,1450,1910,3200000.0
3.0,1.75,1440,1.0,0,2,1090,350,1958,260000.0
4.0,2.5,1910,3.0,0,0,1910,0,2014,630000.0
3.0,2.0,2010,1.0,0,0,1210,800,1915,875000.0
3.0,1.0,960,1.5,0,0,960,0,1927,457500.0
2.0,1.0,1240,1.0,0,0,1240,0,1954,900000.0
2.0,2.0,870,1.0,0,0,740,130,1954,235000.0
3.0,2.0,1400,2.0,0,0,1400,0,1981,410000.0
3.0,3.0,1850,1.0,0,0,1230,620,1981,355000.0
4.0,4.0,4270,2.0,0,3,3180,1090,2004,1300000.0
3.0,1.75,2260,1.0,0,0,1130,1130,1948,467500.0
4.0,4.5,2690,1.5,0,0,2690,0,1949,500000.0
4.0,3.5,2780,2.0,0,4,2530,250,1978,995000.0
3.0,1.0,1140,1.0,0,0,1140,0,1956,277000.0
4.0,2.25,2900,2.0,0,0,1990,910,1947,630000.0
5.0,2.75,2830,1.0,0,0,1710,1120,1960,628000.0
5.0,2.5,2560,2.0,0,0,2560,0,1995,655000.0
2.0,1.0,1240,1.0,0,0,940,300,1950,170000.0
4.0,2.5,2100,1.0,0,2,2100,0,1967,352500.0
4.0,2.75,3120,2.0,0,0,3120,0,1997,615000.0
3.0,1.0,970,1.0,0,0,970,0,1965,165000.0
4.0,2.5,2300,2.0,0,0,2300,0,1966,243500.0
2.0,1.5,950,2.0,0,0,850,100,2003,304000.0
3.0,1.5,2110,1.0,0,0,1210,900,1959,369000.0
4.0,2.75,2990,2.0,0,0,2990,0,2014,779950.0
4.0,2.25,2940,1.0,0,0,1520,1420,1961,605000.0
4.0,2.5,1860,2.0,0,0,1860,0,1994,292500.0
2.0,1.75,1820,1.0,0,0,910,910,1950,500007.0
4.0,2.5,1950,2.0,0,0,1950,0,2000,449999.0
4.0,2.5,1890,2.0,0,0,1890,0,1996,355000.0
4.0,3.0,2710,1.0,0,0,1710,1000,1967,258000.0
4.0,2.25,2150,1.0,0,0,1090,1060,1963,380000.0
4.0,3.0,3720,1.0,0,0,1880,1840,2003,650000.0
4.0,2.5,2580,2.0,0,0,2580,0,2003,456500.0
4.0,2.0,1540,1.5,0,0,1540,0,1948,259950.0
2.0,1.0,1050,1.5,0,0,1050,0,1964,123000.0
3.0,2.25,1210,3.0,0,0,1210,0,2014,520000.0
4.0,2.25,2040,1.0,0,0,1300,740,1963,506000.0
3.0,1.0,980,1.5,0,0,980,0,1926,425000.0
5.0,2.5,1990,2.0,0,0,1990,0,1974,438000.0
4.0,2.5,2420,1.0,0,0,2420,0,1967,1490000.0
4.0,2.0,1240,1.0,0,0,1040,200,1908,375000.0
3.0,2.25,1530,1.0,0,0,1240,290,1968,337500.0
4.0,2.25,2080,1.0,0,0,1450,630,1968,300000.0
5.0,3.25,3570,2.0,0,0,3570,0,2005,627000.0
5.0,4.25,4230,2.0,0,0,3450,780,2008,1400000.0
4.0,2.5,2700,2.0,0,0,2700,0,1988,674725.0
3.0,2.75,2200,1.0,0,0,1280,920,1977,325000.0
5.0,2.0,1210,2.0,0,0,1210,0,1982,230000.0
5.0,1.75,2140,1.0,0,2,1220,920,1962,485000.0
4.0,2.5,2740,1.5,0,2,2740,0,1993,315000.0
3.0,2.75,1370,3.0,0,0,1370,0,2003,560000.0
4.0,3.0,2800,2.0,0,0,2800,0,2002,444000.0
3.0,1.5,1060,1.0,0,0,1060,0,1977,325000.0
2.0,1.0,790,1.0,0,0,790,0,1944,118125.0
2.0,1.0,790,1.0,0,0,790,0,1944,212000.0
4.0,2.5,2820,2.0,0,0,2820,0,2006,428900.0
3.0,2.0,1850,1.0,0,0,1850,0,1968,510000.0
3.0,1.5,1110,1.0,0,0,1110,0,1963,416000.0
4.0,3.0,3230,2.0,0,0,3230,0,1999,950000.0
3.0,1.5,1460,1.0,0,0,980,480,1980,204000.0
6.0,8.0,12050,2.5,0,3,8570,3480,1910,7700000.0
4.0,2.5,3480,2.0,0,0,3480,0,1995,878000.0
4.0,3.0,3560,3.0,0,2,2970,590,1996,1045000.0
2.0,1.0,840,1.0,0,0,840,0,1952,350000.0
3.0,1.75,1820,1.0,0,0,1620,200,1957,659500.0
3.0,2.5,1630,1.0,0,0,1120,510,1988,395000.0
4.0,2.5,1920,2.0,0,2,1920,0,1994,308950.0
3.0,2.0,1750,1.0,0,0,1750,0,1955,410000.0
4.0,3.0,2750,1.0,0,0,1630,1120,1966,710000.0
1.0,1.0,620,1.0,0,0,620,0,1976,175000.0
3.0,2.0,1720,1.0,0,0,1140,580,1981,508800.0
3.0,3.0,1800,1.5,0,2,1500,300,1929,606400.0
3.0,1.75,1300,1.0,0,0,1300,0,1996,245100.0
3.0,2.5,1970,1.0,0,0,1320,650,1981,540000.0
3.0,1.5,1740,1.0,0,0,1740,0,1956,415000.0
4.0,2.75,1930,1.0,0,0,1180,750,1980,469500.0
3.0,1.75,1190,1.0,0,0,1190,0,1965,195000.0
4.0,3.25,4250,2.0,0,4,3020,1230,1996,1615000.0
4.0,3.5,4360,2.0,0,0,4360,0,1998,1450000.0
3.0,2.5,3420,1.0,0,4,2410,1010,1991,1200000.0
4.0,3.75,4260,2.0,0,0,4260,0,2008,1065000.0
2.0,1.0,920,1.0,0,0,920,0,1981,555500.0
3.0,1.0,1040,1.0,0,0,1040,0,1950,440000.0
3.0,1.0,1260,1.0,0,2,960,300,1940,485000.0
3.0,2.5,2460,2.0,0,0,2460,0,1996,693000.0
3.0,1.0,830,1.0,0,0,830,0,1942,295000.0
3.0,2.5,2060,1.0,0,0,1050,1010,1976,700000.0
2.0,1.75,2210,1.0,0,3,1560,650,1951,767500.0
6.0,4.25,5480,2.0,0,0,5140,340,1991,800000.0
3.0,2.0,1860,2.0,0,2,1860,0,1998,440000.0
3.0,2.5,1350,1.0,0,0,1350,0,1997,600000.0
4.0,2.5,2790,2.0,0,0,1930,860,1925,1160000.0
2.0,1.0,1570,1.0,0,0,1150,420,1952,506000.0
4.0,1.75,2030,1.0,0,1,1130,900,1975,474950.0
3.0,2.5,2570,1.0,0,0,1320,1250,1961,654000.0
2.0,1.0,1210,1.0,0,0,1000,210,1942,710000.0
4.0,2.25,1530,1.0,0,0,1030,500,1981,620000.0
3.0,2.0,1510,2.0,0,0,1510,0,1984,390000.0
3.0,2.25,1720,1.0,0,0,1220,500,1967,550000.0
3.0,1.75,2190,1.0,0,2,1390,800,1953,353000.0
4.0,2.5,3030,1.0,0,0,1660,1370,1980,465000.0
3.0,2.0,1410,1.0,0,0,1410,0,1990,279900.0
2.0,1.75,1679,2.0,0,0,1679,0,2001,700000.0
4.0,1.0,1980,1.0,0,0,1430,550,1968,395000.0
4.0,2.5,1900,2.0,0,0,1900,0,1978,375000.0
4.0,1.0,1720,1.5,0,0,1200,520,1926,547000.0
5.0,3.25,2480,2.0,0,0,1640,840,1993,525000.0
3.0,1.0,1210,1.5,0,0,1210,0,1901,285000.0
2.0,1.75,1540,1.0,0,0,1190,350,1908,570000.0
3.0,2.5,2740,2.0,0,0,2740,0,1991,409000.0
4.0,2.5,1811,2.0,0,0,1811,0,2007,260000.0
4.0,2.5,2720,1.0,0,0,2120,600,1987,348000.0
4.0,1.0,1520,1.5,0,0,1520,0,1971,389000.0
4.0,2.75,2160,1.0,0,0,1220,940,1976,445000.0
3.0,1.75,1390,1.0,0,0,930,460,1981,400000.0
4.0,2.5,1740,2.0,0,0,1740,0,1999,302000.0
3.0,2.5,2849,2.0,0,0,2849,0,2001,798000.0
2.0,1.0,1440,1.0,0,0,840,600,1950,335000.0
4.0,2.5,3000,2.0,0,0,3000,0,2005,585000.0
4.0,4.0,3330,1.0,0,0,3330,0,1961,2500000.0
4.0,2.25,1720,1.0,0,0,860,860,1940,555000.0
3.0,3.0,3920,2.0,1,4,3920,0,1996,3100000.0
3.0,2.5,1500,2.0,0,0,1500,0,1994,295000.0
4.0,1.5,2050,1.0,0,0,1050,1000,1963,265000.0
4.0,2.0,1180,1.0,0,0,1180,0,1965,330000.0
4.0,1.5,1600,2.0,0,0,1600,0,1902,286000.0
3.0,2.5,1260,3.0,0,0,1160,100,2009,305000.0
2.0,1.0,1290,1.0,0,0,1290,0,1945,970000.0
4.0,2.0,2680,1.0,0,0,1460,1220,1966,525000.0
3.0,1.75,2370,1.0,0,0,1280,1090,1979,355000.0
5.0,2.5,2310,1.0,0,0,1300,1010,1975,469950.0
4.0,1.0,1450,1.0,0,0,1450,0,1954,435000.0
4.0,2.5,2680,2.0,0,0,2680,0,1990,363500.0
2.0,1.5,1030,1.0,0,0,830,200,1924,595000.0
3.0,1.0,1320,1.0,0,0,1320,0,1955,275000.0
2.0,1.0,670,1.0,0,0,670,0,1942,295000.0
3.0,2.25,2670,2.0,0,0,2670,0,1990,345000.0
3.0,2.25,2440,2.0,0,0,2090,350,1991,485000.0
5.0,2.5,3370,2.0,0,0,3370,0,2005,1245000.0
2.0,1.0,940,1.0,0,0,940,0,1923,340500.0
3.0,1.0,1100,1.0,0,0,840,260,1948,280000.0
3.0,2.25,2520,2.0,0,0,2520,0,1988,449888.0
2.0,1.75,1400,1.0,0,0,820,580,1927,483000.0
3.0,1.75,1880,1.0,0,0,940,940,1941,445500.0
5.0,3.5,2800,2.0,0,0,2800,0,1995,379900.0
4.0,3.5,2500,2.0,0,0,1810,690,2008,599950.0
3.0,1.0,810,1.0,0,0,810,0,1942,215000.0
3.0,2.5,1720,2.0,0,0,1720,0,1987,263000.0
4.0,1.0,2170,1.0,0,0,2170,0,1961,565000.0
5.0,3.0,4530,1.5,0,0,3200,1330,2003,950000.0
4.0,1.0,1440,1.5,0,0,1440,0,1946,395000.0
4.0,3.25,2850,2.0,0,3,1820,1030,1908,1535000.0
4.0,2.5,2620,1.0,0,4,1620,1000,1941,922000.0
3.0,2.5,1676,2.0,0,0,1676,0,1997,330000.0
4.0,3.75,5850,2.0,0,0,4410,1440,1990,1525000.0
3.0,1.75,1910,1.0,0,0,1910,0,2004,323000.0
2.0,2.0,1670,1.0,0,0,1670,0,2004,554000.0
3.0,2.0,2050,1.0,0,0,2050,0,1987,500000.0
5.0,3.5,3730,1.0,0,0,2760,970,1990,775000.0
4.0,1.75,1800,1.0,0,0,1080,720,1979,340000.0
4.0,1.75,2230,1.0,0,0,1320,910,1985,560000.0
3.0,2.5,1670,2.0,0,0,1670,0,2002,304000.0
3.0,1.0,1400,1.0,0,0,1400,0,1962,279900.0
5.0,3.0,2110,2.0,0,0,2110,0,2005,315000.0
4.0,2.0,2160,1.5,0,1,2160,0,1928,849000.0
3.0,1.75,2420,1.0,0,0,1380,1040,1977,325000.0
4.0,3.5,3320,2.0,0,0,3320,0,2005,786000.0
5.0,2.75,3220,2.0,0,0,3220,0,1999,384000.0
3.0,1.5,1340,1.5,0,1,1340,0,1927,907000.0
3.0,2.5,2490,2.0,0,0,2490,0,1993,700000.0
3.0,2.0,1640,1.0,0,0,1640,0,1991,269500.0
3.0,2.25,1420,1.0,0,0,1130,290,1984,269000.0
4.0,2.5,3340,2.0,0,0,3340,0,2005,749950.0
3.0,2.75,1580,2.0,0,0,1580,0,2001,325000.0
3.0,1.5,2170,1.0,1,2,1130,1040,1979,1150000.0
3.0,1.5,1370,1.0,0,0,1370,0,1962,406000.0
4.0,2.5,2840,2.0,0,0,2840,0,1990,650000.0
3.0,1.75,1940,1.5,0,0,1940,0,1918,295000.0
4.0,2.0,1757,1.0,0,2,1757,0,1955,375000.0
2.0,1.0,980,1.0,0,0,980,0,1907,395000.0
6.0,3.0,2470,2.0,0,0,2470,0,1982,609000.0
3.0,1.75,1610,1.0,0,2,1210,400,1984,510000.0
3.0,2.25,1590,1.0,0,0,1090,500,1978,190000.0
1.0,1.0,780,1.0,0,0,780,0,1922,250000.0
3.0,1.5,720,1.0,0,1,720,0,1924,295000.0
3.0,1.5,1630,1.5,0,0,1630,0,1927,740000.0
3.0,1.0,1590,2.0,0,0,1590,0,1912,323000.0
3.0,2.75,2310,2.0,0,0,2020,290,2011,713000.0
3.0,1.75,2320,2.0,0,3,2040,280,1939,1070000.0
3.0,1.75,1660,2.0,0,0,1660,0,1978,460000.0
3.0,1.75,2070,1.5,0,0,2070,0,1920,880000.0
4.0,1.75,2500,1.0,0,0,1250,1250,1947,585000.0
2.0,1.0,940,1.0,0,0,940,0,1959,249950.0
3.0,2.5,1990,2.0,0,0,1520,470,1990,450000.0
3.0,2.5,2620,2.0,0,0,2620,0,1989,450000.0
4.0,3.25,3730,3.0,0,2,3730,0,1985,1775000.0
3.0,3.25,1600,3.0,0,0,1600,0,1999,350000.0
3.0,2.5,2095,2.0,0,0,2095,0,2008,292500.0
4.0,2.75,4230,2.0,0,0,4230,0,1985,879000.0
4.0,2.5,3200,1.5,0,1,1860,1340,1948,1184000.0
4.0,2.75,2050,1.0,0,0,1300,750,1967,584999.0
4.0,2.75,2020,1.0,0,0,1300,720,1961,366000.0
4.0,2.25,3270,1.0,0,0,2000,1270,1974,987500.0
3.0,1.0,1320,1.0,0,0,1320,0,1959,300000.0
2.0,1.75,1270,1.0,0,0,890,380,1981,299000.0
4.0,1.75,1980,1.5,0,0,1210,770,1931,560000.0
3.0,2.5,2620,2.0,0,0,2620,0,1998,695000.0
4.0,1.75,1750,1.0,0,0,1220,530,1977,360000.0
3.0,1.0,1040,1.0,0,0,800,240,1958,183500.0
3.0,1.75,1900,1.5,0,0,1070,830,1903,311000.0
3.0,1.75,1660,1.0,0,0,1660,0,1977,263000.0
3.0,1.75,1530,1.0,0,0,1530,0,1986,269000.0
4.0,3.5,4280,2.0,0,0,4280,0,2005,1600000.0
4.0,2.5,2870,2.0,0,0,2870,0,2004,564000.0
3.0,2.5,2540,2.0,0,0,2540,0,1999,425000.0
4.0,2.75,2100,1.5,0,0,1780,320,1928,679000.0
3.0,2.0,1740,1.0,0,0,1740,0,1952,410000.0
4.0,2.5,2441,2.0,0,0,2441,0,2007,340000.0
3.0,1.75,1810,1.0,0,0,1030,780,1959,360000.0
3.0,1.5,2060,1.0,0,0,2060,0,1953,450000.0
4.0,2.75,3160,1.0,0,3,1620,1540,1982,552000.0
4.0,2.0,2930,1.5,0,0,2930,0,1965,294000.0
2.0,1.0,1310,1.0,0,0,910,400,1946,663500.0
6.0,4.5,4800,2.0,0,0,3580,1220,2007,1975000.0
4.0,1.5,1450,1.0,0,0,1450,0,1969,175409.0
4.0,3.0,1900,2.0,0,0,1900,0,1954,459000.0
3.0,1.0,1050,1.5,0,0,1050,0,1906,339950.0
5.0,1.75,1610,1.0,0,0,1610,0,1936,393000.0
2.0,1.0,720,1.0,0,0,720,0,1951,275500.0
3.0,1.0,1020,1.0,0,0,1020,0,1955,485000.0
3.0,1.0,1250,1.0,0,0,1250,0,1960,250000.0
4.0,3.5,3200,1.0,0,0,2700,500,1980,935100.0
3.0,1.0,990,1.0,0,0,990,0,1959,245000.0
4.0,2.5,2850,2.0,0,0,2850,0,1989,670000.0
3.0,3.5,4240,2.0,0,0,3500,740,1994,1393000.0
4.0,1.75,2800,1.0,0,0,1400,1400,1978,440000.0
2.0,2.5,2310,2.0,0,0,2310,0,2006,1248000.0
3.0,1.75,1490,1.0,0,0,1200,290,1978,203000.0
4.0,2.5,1840,2.0,0,0,1840,0,2005,583000.0
3.0,1.0,1740,1.0,0,0,1740,0,1954,575000.0
4.0,3.5,3280,2.0,0,0,2880,400,2011,2575000.0
5.0,3.5,4050,2.0,0,3,3020,1030,1973,1600000.0
4.0,2.5,2160,2.0,0,0,2160,0,1993,312500.0
3.0,2.75,2720,3.0,0,2,2720,0,1986,455000.0
5.0,3.0,3650,1.0,0,3,1860,1790,1978,1310000.0
4.0,2.25,1750,1.0,0,0,1150,600,1962,605000.0
3.0,2.25,2450,1.0,0,0,1770,680,1978,325000.0
3.0,1.75,1940,1.0,0,0,1470,470,1982,630000.0
4.0,3.75,3280,2.0,0,0,3280,0,2014,928950.0
3.0,1.75,2480,1.0,0,0,1800,680,1976,489950.0
3.0,2.25,2120,1.0,0,0,1590,530,1984,550000.0
3.0,2.0,1710,1.0,0,0,1260,450,1968,237000.0
3.0,2.5,1690,1.0,0,0,1310,380,1991,390000.0
3.0,2.5,2190,2.0,0,0,2190,0,1987,665000.0
4.0,3.0,1960,1.0,0,0,1170,790,2001,277000.0
3.0,1.0,1510,1.5,0,0,1510,0,1909,545000.0
3.0,2.5,1490,2.0,0,0,1300,190,2008,615000.0
3.0,1.75,2210,1.0,0,0,1400,810,1966,343000.0
4.0,2.5,2340,2.0,0,0,2340,0,2004,597000.0
3.0,1.0,940,1.0,0,0,940,0,1945,600000.0
3.0,1.75,1470,1.0,0,0,1470,0,1987,479000.0
3.0,1.75,1650,1.0,0,0,1650,0,1958,292000.0
3.0,1.5,1400,1.0,0,0,1110,290,1957,265000.0
4.0,2.5,2710,2.0,0,0,2710,0,1988,623000.0
4.0,2.5,2150,1.0,0,0,1420,730,1978,486000.0
3.0,2.0,1900,1.0,0,0,950,950,1940,520500.0
4.0,3.5,4380,1.0,0,0,4380,0,2001,1300000.0
4.0,1.0,2290,1.5,0,4,2150,140,1921,825000.0
3.0,1.75,1690,1.0,0,0,1690,0,1986,259900.0
5.0,2.75,3090,1.0,0,0,1600,1490,1968,1170000.0
2.0,1.0,1120,1.0,0,1,720,400,1904,245000.0
3.0,2.5,2680,1.0,0,0,1440,1240,1951,830200.0
4.0,2.5,2400,2.0,0,0,2400,0,1990,650000.0
4.0,2.0,1610,1.0,0,0,1610,0,1952,305000.0
5.0,2.5,3470,2.0,0,0,3470,0,1978,599000.0
4.0,2.5,2070,2.0,0,0,2070,0,1993,272000.0
3.0,2.5,2420,2.0,0,0,2420,0,1996,415000.0
4.0,2.25,2380,1.0,0,0,1760,620,1979,319000.0
4.0,1.75,2120,1.0,0,0,1060,1060,1960,425000.0
4.0,2.5,2190,1.0,0,0,1250,940,1978,297500.0
4.0,2.5,2740,2.0,0,0,2740,0,1990,725000.0
3.0,2.5,1830,2.0,0,0,1830,0,1995,325000.0
3.0,1.75,1370,1.0,0,0,970,400,1972,460000.0
3.0,1.0,1000,1.0,0,0,1000,0,1959,396480.0
3.0,1.0,2050,2.0,0,0,1950,100,1922,1025000.0
3.0,2.75,1750,1.0,0,0,1170,580,1979,370000.0
3.0,1.0,1620,1.0,0,0,1620,0,1969,260656.0
3.0,2.5,1710,2.0,0,0,1710,0,1996,431000.0
3.0,1.0,1060,1.0,0,0,1060,0,1958,320000.0
3.0,2.75,2170,1.0,0,0,1380,790,1978,296500.0
4.0,2.5,3080,1.0,0,0,1540,1540,1969,679000.0
3.0,3.0,1320,2.0,0,0,1080,240,2003,359000.0
4.0,3.0,1920,1.0,0,0,1920,0,1962,330000.0
4.0,2.5,2440,2.0,0,0,2440,0,2009,350000.0
3.0,1.5,1640,1.0,0,0,1640,0,1963,242000.0
3.0,2.5,2420,2.0,0,0,2420,0,1997,692500.0
2.0,1.5,1190,1.0,0,0,990,200,1919,441000.0
4.0,2.5,2910,2.0,0,0,2910,0,1990,765000.0
2.0,1.0,1010,1.0,0,0,1010,0,1950,375000.0
3.0,1.75,2080,1.0,0,0,1220,860,1955,365000.0
2.0,1.5,1990,1.0,0,0,1430,560,1944,580000.0
4.0,3.5,3920,1.0,0,1,2240,1680,2005,1605000.0
4.0,2.5,3080,2.0,0,0,3080,0,1981,841000.0
5.0,3.0,2670,1.0,0,0,1370,1300,1981,515000.0
5.0,2.5,4320,1.0,0,0,2160,2160,1967,565000.0
2.0,1.5,1200,1.0,0,0,1200,0,1929,365000.0
3.0,1.5,1640,2.0,0,0,1640,0,1908,295000.0
2.0,1.0,870,1.0,0,0,870,0,1947,406500.0
3.0,2.5,2410,2.0,0,0,2410,0,1991,614905.0
5.0,2.25,2640,1.0,0,0,1770,870,1929,1398000.0
2.0,1.0,990,2.0,0,0,990,0,1981,250000.0
5.0,1.0,1500,2.0,0,0,1500,0,1929,549000.0
4.0,2.5,1790,2.0,0,0,1790,0,2005,397000.0
3.0,1.75,1490,1.0,0,0,1490,0,1962,184000.0
4.0,3.25,3960,2.0,0,2,3100,860,1938,2500000.0
3.0,1.5,1620,1.0,0,0,1620,0,1954,499100.0
4.0,1.5,2270,1.0,0,0,1290,980,1954,676101.0
3.0,1.0,1150,1.0,0,0,990,160,1932,290000.0
4.0,1.75,2180,1.0,0,0,1560,620,1962,390000.0
3.0,1.0,910,1.0,0,0,910,0,1948,465000.0
3.0,2.75,2770,1.5,0,0,2370,400,1938,470000.0
3.0,1.0,940,1.0,0,0,940,0,1959,435000.0
3.0,1.75,2410,1.0,0,0,1860,550,1967,415000.0
3.0,2.0,1010,1.5,0,0,1010,0,1905,450000.0
3.0,2.5,2120,1.0,0,1,2120,0,1997,645000.0
4.0,2.0,1530,2.0,0,0,1530,0,1942,231000.0
3.0,1.5,1810,1.0,0,0,1810,0,1969,358000.0
3.0,1.0,1040,1.0,0,0,1040,0,1972,330000.0
2.0,1.5,1160,2.0,0,0,1160,0,1972,229950.0
2.0,1.5,1430,1.0,0,0,1130,300,1934,403250.0
3.0,2.5,2280,2.0,0,0,2280,0,2004,470000.0
3.0,1.0,1200,1.0,0,0,1200,0,1967,239000.0
4.0,1.5,2480,1.0,0,0,1520,960,1955,579000.0
3.0,2.0,1270,3.0,0,0,1270,0,2003,380500.0
5.0,2.75,2730,2.0,0,0,2730,0,2015,614285.0
2.0,2.0,1340,2.0,0,0,1340,0,2003,376000.0
3.0,1.0,1240,1.0,0,0,1240,0,1954,290000.0
4.0,2.25,2400,1.0,0,0,1800,600,1965,487000.0
4.0,2.0,1220,2.0,0,0,1220,0,1903,935000.0
4.0,2.5,2163,2.0,0,0,2163,0,2006,255000.0
2.0,2.5,1860,2.0,0,0,1860,0,2000,380000.0
2.0,1.0,810,1.0,0,0,810,0,1958,450000.0
3.0,2.5,1950,2.0,0,0,1950,0,1987,622000.0
3.0,2.25,1390,2.0,0,0,1390,0,1993,292500.0
4.0,3.0,2120,2.0,0,3,1830,290,1908,1320000.0
4.0,2.0,1510,1.0,0,0,870,640,1901,410000.0
3.0,1.75,1010,1.0,0,0,1010,0,1950,160000.0
4.0,1.5,1840,2.0,0,0,1840,0,1917,809000.0
5.0,2.75,1650,1.0,0,0,1650,0,1970,183750.0
5.0,1.75,2860,1.0,0,0,1430,1430,1947,411000.0
3.0,1.75,2650,2.0,0,0,2250,400,1984,1050000.0
2.0,1.0,1100,1.0,0,0,1100,0,1919,625000.0
3.0,2.25,1646,2.0,0,0,1646,0,1994,305000.0
4.0,4.5,5250,2.0,0,0,5250,0,1998,915000.0
3.0,1.5,1390,1.0,0,0,1390,0,1974,317000.0
2.0,1.0,780,1.0,0,0,780,0,1947,165000.0
2.0,1.0,1490,1.0,0,0,1090,400,1946,575000.0
3.0,1.0,970,1.0,0,0,970,0,1967,219900.0
4.0,3.25,3730,2.0,0,0,2810,920,2006,1485000.0
3.0,1.0,1090,1.0,0,0,1090,0,1955,300000.0
3.0,1.75,1940,1.0,0,0,1940,0,1991,520000.0
4.0,2.25,1780,1.0,0,0,1480,300,1966,310000.0
3.0,2.0,1190,1.0,0,0,1190,0,1996,322500.0
4.0,2.25,2000,2.0,0,1,2000,0,1967,320000.0
3.0,2.5,1390,2.0,0,0,1390,0,2004,440000.0
3.0,1.0,1500,1.0,0,0,1120,380,1938,578000.0
2.0,1.5,1070,3.0,0,0,1070,0,2005,382000.0
3.0,2.5,1720,2.0,0,0,1720,0,1994,535000.0
4.0,2.5,3680,2.0,0,0,3680,0,2006,679000.0
3.0,2.25,1400,1.0,0,0,1040,360,1985,258900.0
3.0,1.5,1730,2.0,0,0,1270,460,1955,563000.0
5.0,3.0,2795,2.0,0,0,2795,0,1996,562000.0
4.0,1.75,2000,1.0,0,0,1120,880,1950,725000.0
3.0,2.5,1830,2.0,0,0,1830,0,1987,236775.0
4.0,3.5,3380,1.0,0,1,1690,1690,1952,860000.0
3.0,1.5,1500,1.0,0,0,1500,0,1953,270000.0
4.0,2.75,1950,1.0,0,2,1250,700,1960,621000.0
3.0,2.5,2490,2.0,0,2,2490,0,1998,527900.0
4.0,2.25,1780,2.0,0,0,1780,0,1964,395000.0
3.0,2.0,1110,1.0,0,0,1110,0,1978,320000.0
4.0,2.5,2500,2.0,0,0,2500,0,2003,300000.0
3.0,1.75,1480,1.0,0,0,1480,0,1965,320000.0
3.0,2.25,2570,1.0,0,0,2570,0,1979,625000.0
2.0,1.0,810,1.0,0,0,810,0,1941,505000.0
4.0,2.5,2700,1.0,0,0,1560,1140,1966,300000.0
4.0,2.5,2180,2.0,0,0,2180,0,2004,363000.0
4.0,3.5,4330,2.0,0,0,3230,1100,1988,1700000.0
4.0,3.5,4210,2.0,0,0,4210,0,2006,1146800.0
4.0,2.5,2880,1.0,0,0,1780,1100,1977,680000.0
5.0,2.25,2610,2.0,0,0,1750,860,1909,678940.0
3.0,1.75,2010,1.0,0,0,1090,920,1984,299000.0
4.0,1.75,1500,1.0,0,0,1000,500,1955,379900.0
3.0,1.0,1290,1.0,0,0,1290,0,1976,205000.0
4.0,1.0,1320,1.5,0,0,1320,0,1929,387500.0
3.0,1.0,1290,1.0,0,0,790,500,1948,256000.0
4.0,2.5,2440,2.0,0,0,2440,0,1994,548000.0
3.0,1.75,1290,1.0,0,0,1290,0,1996,163000.0
2.0,2.0,1030,2.0,0,0,680,350,2004,367500.0
3.0,2.25,1640,2.0,0,0,1240,400,1983,390000.0
4.0,2.5,1160,1.0,0,0,1160,0,1989,415000.0
4.0,2.25,2230,2.0,0,0,2230,0,1968,449000.0
5.0,2.0,1910,1.0,0,0,1010,900,1963,460000.0
4.0,2.0,1980,1.0,0,0,1980,0,1977,395000.0
3.0,2.0,1470,1.0,0,0,1470,0,1961,300000.0
3.0,1.75,1520,1.0,0,0,1520,0,1969,345000.0
3.0,1.75,1930,1.0,0,0,1930,0,1953,825000.0
3.0,2.5,1330,3.0,0,0,1330,0,2014,539950.0
4.0,2.0,1580,1.0,0,0,1580,0,1953,410000.0
3.0,1.0,1370,1.0,0,0,1370,0,1955,245000.0
4.0,2.75,3010,1.0,0,0,1560,1450,1973,482000.0
3.0,1.75,1390,1.0,0,0,1390,0,1978,270000.0
3.0,1.75,1330,1.0,0,0,1330,0,1983,475000.0
3.0,2.0,1320,1.0,0,0,1320,0,1947,445800.0
4.0,3.0,2430,1.0,0,0,1330,1100,1978,518000.0
2.0,0.75,1260,1.5,0,2,1080,180,1942,785000.0
3.0,2.5,1690,2.0,0,0,1140,550,2004,430000.0
4.0,1.75,3420,1.0,0,3,1770,1650,1947,715000.0
3.0,1.5,2790,1.0,0,2,1700,1090,1955,560000.0
3.0,1.75,1270,1.5,0,0,1270,0,1903,449000.0
4.0,2.5,2910,2.0,0,0,2910,0,1989,805000.0
3.0,2.5,1560,2.0,0,0,1560,0,2003,296000.0
2.0,1.0,770,1.0,0,0,770,0,1927,275000.0
3.0,1.75,1770,1.0,0,0,1770,0,1977,419950.0
3.0,1.75,1100,2.0,0,0,780,320,2008,285000.0
3.0,2.5,2890,2.0,0,0,2890,0,1996,775000.0
3.0,1.75,2110,1.0,0,0,1380,730,1963,288250.0
2.0,1.75,1220,1.0,0,0,610,610,1909,257000.0
1.0,1.0,950,1.5,0,0,950,0,1929,377000.0
2.0,1.0,1420,1.0,0,0,820,600,1924,550000.0
3.0,1.0,1100,1.0,0,0,720,380,1942,339000.0
3.0,1.75,2140,1.0,0,0,1070,1070,1948,481500.0
3.0,1.75,1300,1.0,0,0,1300,0,1980,224500.0
3.0,1.0,1790,1.0,0,0,1790,0,1951,260000.0
2.0,1.0,1470,1.5,0,0,1470,0,1912,865000.0
5.0,3.0,2500,1.0,0,0,1550,950,1971,730000.0
2.0,1.0,980,1.5,0,0,980,0,1910,550000.0
3.0,2.0,2130,2.0,0,0,2130,0,1908,645000.0
3.0,1.75,1360,1.0,0,0,1360,0,1978,250000.0
3.0,3.5,1630,2.0,0,0,1360,270,2000,507200.0
4.0,2.5,2500,1.0,0,2,1300,1200,1964,380000.0
4.0,1.75,2260,1.0,0,2,1450,810,1971,540000.0
3.0,2.5,2300,1.0,0,0,2300,0,2005,738500.0
3.0,1.0,1060,1.0,0,0,1060,0,1980,206000.0
2.0,1.0,940,1.0,0,0,940,0,1948,265000.0
1.0,0.75,780,1.0,0,0,780,0,1945,190000.0
3.0,1.0,1200,1.0,0,0,1200,0,1969,339900.0
6.0,2.5,2590,1.0,0,0,1340,1250,1970,250000.0
3.0,1.0,1100,1.0,0,0,1100,0,1965,416500.0
4.0,2.5,2890,2.0,0,2,2890,0,2004,575000.0
3.0,1.75,1230,1.0,0,0,1230,0,1987,385000.0
3.0,1.0,1030,1.0,0,0,1030,0,1960,253000.0
3.0,1.0,1140,1.0,0,0,1140,0,1942,460000.0
4.0,2.5,3200,3.0,0,3,2600,600,1997,1445000.0
2.0,1.0,950,1.0,0,0,950,0,1942,492000.0
4.0,2.0,1960,1.0,0,2,1060,900,1972,275000.0
5.0,3.25,3010,1.5,0,0,2010,1000,1931,542500.0
2.0,1.0,1080,1.0,0,0,1080,0,1955,345000.0
4.0,2.75,2730,1.0,0,0,1530,1200,1979,575000.0
5.0,2.5,2570,1.0,0,0,1300,1270,1959,275000.0
6.0,4.5,3300,2.0,0,0,3300,0,1980,510000.0
4.0,3.5,4350,2.0,0,0,2970,1380,1908,2538000.0
3.0,3.5,3820,2.0,0,3,2870,950,1999,830000.0
4.0,2.5,2260,2.0,0,0,2260,0,2004,640000.0
4.0,2.75,3880,2.0,0,0,3880,0,2004,702000.0
3.0,2.5,2010,1.0,0,0,1450,560,1955,960000.0
3.0,1.0,950,1.0,0,0,950,0,1983,190000.0
3.0,2.25,1730,1.0,0,0,1290,440,1988,500000.0
3.0,2.5,3070,2.0,0,0,3070,0,1995,529000.0
3.0,1.75,1500,1.0,0,0,1500,0,1997,435000.0
3.0,1.75,2160,1.0,0,0,1260,900,1954,670000.0
3.0,2.25,1960,2.0,0,0,1750,210,2003,365000.0
5.0,3.0,3950,1.0,0,0,2250,1700,1953,1270000.0
3.0,1.0,1100,1.5,0,0,1100,0,1915,465000.0
3.0,1.5,1400,1.0,0,0,1400,0,1956,285000.0
3.0,1.0,1020,1.5,0,0,920,100,1926,219950.0
3.0,1.5,1600,1.0,0,0,1600,0,1962,220000.0
6.0,4.5,4230,2.0,0,3,2360,1870,1916,1465000.0
5.0,3.5,3090,2.0,0,0,2060,1030,2000,1112750.0
2.0,2.5,2320,1.0,0,0,2320,0,2007,694000.0
3.0,2.5,2440,2.0,0,0,2440,0,1988,620000.0
3.0,1.0,2020,1.0,0,0,1760,260,1949,415000.0
3.0,3.0,3270,2.0,0,0,3270,0,1992,765000.0
4.0,1.75,2260,1.0,0,0,1220,1040,1948,864000.0
5.0,2.0,2020,2.0,0,0,2020,0,1950,385000.0
3.0,1.0,1000,1.0,0,0,1000,0,1951,725000.0
4.0,2.25,2030,1.0,0,0,1590,440,1967,545000.0
3.0,1.75,1730,1.0,0,0,1730,0,1988,299900.0
3.0,1.75,2010,1.0,0,0,2010,0,1974,639500.0
4.0,1.5,1540,1.0,0,0,1160,380,1964,345000.0
6.0,4.0,5330,2.0,0,0,3950,1380,2000,1125000.0
2.0,1.0,960,1.0,0,0,780,180,1904,345000.0
3.0,2.0,1460,1.0,0,0,730,730,1921,600000.0
4.0,1.75,2160,1.0,0,0,1360,800,1983,355000.0
3.0,2.75,2640,1.5,0,0,2260,380,1978,698000.0
4.0,2.25,2170,2.0,0,0,2170,0,1987,566000.0
3.0,2.5,1530,2.0,0,0,1530,0,1994,449950.0
3.0,1.0,1570,1.0,0,2,1270,300,1958,404600.0
3.0,1.0,1490,1.0,0,0,1120,370,1969,258000.0
4.0,2.0,1960,2.0,0,0,1960,0,1955,415000.0
4.0,2.25,2190,2.0,0,0,2190,0,1978,320000.0
3.0,2.5,1690,2.0,0,0,1690,0,2003,295000.0
5.0,2.0,2330,1.0,0,0,1190,1140,1962,389000.0
3.0,1.75,1470,1.0,0,0,1470,0,1958,299900.0
3.0,2.5,2550,2.0,0,0,2550,0,2004,394000.0
4.0,2.0,2130,1.5,0,0,2130,0,1939,762000.0
4.0,2.75,3650,1.5,0,0,3650,0,1978,697000.0
3.0,2.5,3340,2.0,0,0,2420,920,1994,485000.0
2.0,1.0,800,1.0,0,0,800,0,1955,189900.0
3.0,2.75,3470,3.0,1,4,3470,0,1989,2150000.0
3.0,1.5,1030,1.0,0,0,1030,0,1921,345000.0
3.0,2.0,1630,1.0,0,0,1630,0,1950,376500.0
3.0,2.0,2010,2.0,0,3,2010,0,1951,775000.0
3.0,1.0,1360,1.5,0,0,1360,0,1910,450000.0
4.0,2.25,2040,1.0,0,0,1480,560,1958,760000.0
4.0,2.5,2830,2.0,0,0,2830,0,2003,569000.0
3.0,1.5,2040,1.0,0,0,1280,760,1950,500000.0
2.0,2.0,1340,1.5,0,0,1340,0,1941,592500.0
4.0,2.5,2130,2.0,0,0,2130,0,1988,620000.0
5.0,4.25,3920,2.0,0,0,2900,1020,1990,1000000.0
3.0,2.5,2415,2.0,0,1,2415,0,1981,815000.0
5.0,2.75,3750,2.0,0,4,3750,0,2005,775000.0
3.0,1.0,1010,1.0,0,0,1010,0,1975,340000.0
2.0,1.75,990,1.0,0,0,990,0,1942,458000.0
2.0,1.5,1200,2.0,0,0,1200,0,1985,250000.0
2.0,1.0,1060,1.0,0,0,1060,0,1954,151600.0
4.0,2.5,3200,2.0,0,0,3200,0,2005,515000.0
2.0,1.0,1810,1.0,0,0,1010,800,1946,216000.0
3.0,1.75,1670,1.0,0,0,1670,0,1974,245000.0
3.0,2.75,1850,1.0,0,2,1850,0,1953,645000.0
3.0,1.0,1100,1.0,0,0,1100,0,1960,249900.0
3.0,1.75,1660,1.0,0,0,830,830,1980,410000.0
6.0,1.75,2400,1.5,0,0,1400,1000,1975,499000.0
5.0,3.25,2900,1.0,0,0,1890,1010,1967,790000.0
1.0,2.25,2140,1.0,0,0,1470,670,1976,458000.0
4.0,2.5,2670,2.0,0,0,1940,730,1929,925000.0
3.0,1.0,1090,1.0,0,0,1090,0,1969,152000.0
3.0,2.5,1970,2.0,0,0,1970,0,1990,402000.0
2.0,2.0,1250,2.0,0,0,980,270,1996,340000.0
4.0,2.5,4040,2.0,0,2,3690,350,1984,1250000.0
4.0,2.5,3220,2.0,0,0,3220,0,1993,775000.0
2.0,1.0,1310,1.0,0,0,810,500,1944,299800.0
4.0,2.25,2060,1.0,0,0,1300,760,1960,340000.0
3.0,2.25,1750,2.5,0,0,1470,280,2005,626000.0
2.0,1.0,1150,1.0,0,0,1150,0,1946,324950.0
3.0,2.5,2050,2.0,0,0,2050,0,1994,535500.0
3.0,3.25,3230,2.0,0,0,3230,0,1999,817500.0
4.0,3.5,4170,2.0,0,0,2940,1230,2005,810000.0
5.0,1.5,1940,1.5,0,0,1220,720,1926,565000.0
3.0,1.5,2390,1.5,0,0,1690,700,1936,978000.0
3.0,1.0,1440,1.0,0,0,1440,0,1951,530000.0
4.0,2.5,2230,2.0,0,0,2230,0,2003,305000.0
3.0,2.5,1210,3.0,0,0,1210,0,2008,345000.0
2.0,2.0,750,1.5,0,2,750,0,1945,258000.0
4.0,1.0,1770,1.5,0,0,1770,0,1966,275000.0
3.0,1.0,1020,1.0,0,0,1020,0,1961,310000.0
3.0,2.0,2050,1.0,0,0,2050,0,1951,713250.0
3.0,1.0,2000,1.0,0,0,1480,520,1978,500000.0
3.0,1.75,2180,1.0,0,3,1090,1090,1954,472000.0
3.0,1.0,920,1.0,0,0,920,0,1952,250000.0
4.0,2.25,3440,2.0,0,0,3440,0,1982,725000.0
3.0,2.0,1610,1.0,0,0,1610,0,1986,345000.0
3.0,1.5,1870,1.0,0,0,1470,400,1936,460000.0
2.0,1.0,1110,1.0,0,0,1000,110,1947,440150.0
3.0,1.75,2200,1.0,0,0,1270,930,1978,390000.0
2.0,1.0,790,1.0,0,0,790,0,1950,375000.0
3.0,1.5,1630,1.0,0,0,1630,0,1963,224950.0
3.0,1.5,2100,1.0,0,0,1220,880,1949,480000.0
4.0,2.75,2690,2.0,0,0,2210,480,1940,721000.0
2.0,1.0,600,1.0,0,0,600,0,1922,174000.0
2.0,1.0,810,1.0,0,0,810,0,1944,170000.0
3.0,1.5,1660,1.5,0,0,1660,0,1919,658000.0
3.0,2.0,1880,1.0,0,0,1200,680,1968,860000.0
4.0,1.5,2310,2.0,0,0,2310,0,1968,407450.0
4.0,1.5,2650,2.0,0,0,2650,0,1930,615000.0
4.0,3.0,3130,2.0,0,0,3130,0,1995,920000.0
2.0,1.0,860,1.0,0,0,860,0,1983,195000.0
3.0,1.0,990,1.0,0,0,990,0,1961,269950.0
4.0,3.5,4030,2.0,0,0,4030,0,2006,855000.0
3.0,2.25,1780,3.0,0,0,1570,210,2007,620000.0
2.0,2.0,1480,1.0,0,0,740,740,1919,276000.0
3.0,1.0,1140,1.5,0,0,1140,0,1911,329000.0
3.0,1.5,1230,1.0,0,0,1230,0,1962,270000.0
4.0,2.5,3080,2.0,0,0,3080,0,1993,440000.0
4.0,2.5,1990,2.0,0,0,1990,0,1989,639000.0
1.0,1.0,700,1.0,0,0,700,0,1945,403500.0
3.0,2.5,1700,2.0,0,2,1320,380,2002,585000.0
2.0,1.0,860,1.0,0,0,860,0,1942,216000.0
3.0,2.5,3160,1.0,0,3,2160,1000,1991,1150000.0
3.0,2.0,2500,1.0,0,0,1840,660,1954,575000.0
4.0,2.5,3000,2.0,0,0,3000,0,2001,430000.0
2.0,1.0,1670,1.0,0,0,1670,0,1954,660000.0
2.0,1.0,690,1.0,0,0,690,0,1943,338000.0
4.0,2.75,1240,1.0,0,0,800,440,1987,400000.0
2.0,1.0,900,1.0,0,0,900,0,1930,210000.0
4.0,1.75,2200,1.5,0,0,1400,800,1942,305000.0
2.0,1.0,960,1.0,0,0,960,0,1985,365000.0
5.0,2.75,2130,1.0,0,0,1300,830,1991,325000.0
4.0,1.75,2020,1.0,0,0,2020,0,1969,245000.0
3.0,1.0,1060,1.0,0,0,1060,0,1959,182000.0
2.0,1.0,1230,1.0,0,0,1130,100,1906,440000.0
3.0,2.25,2510,2.0,0,0,2510,0,1988,225000.0
3.0,2.25,2510,2.0,0,0,2510,0,1988,358000.0
5.0,2.5,2720,1.5,0,0,1530,1190,1939,580000.0
3.0,1.5,1070,1.0,0,0,1070,0,1984,240000.0
4.0,3.25,3580,1.0,0,0,3580,0,1990,700000.0
4.0,2.5,2230,2.0,0,0,2230,0,1994,325000.0
4.0,2.25,2500,1.0,0,0,1800,700,1978,488000.0
4.0,1.0,1670,1.5,0,0,1670,0,1906,875000.0
4.0,2.5,2150,2.0,0,0,2150,0,1985,615000.0
3.0,2.5,2020,2.0,0,0,2020,0,2012,321000.0
3.0,2.5,2230,2.0,0,0,2230,0,2003,1035000.0
2.0,1.0,740,1.0,0,0,740,0,1942,299500.0
4.0,1.5,2020,2.0,0,0,2020,0,1963,459000.0
3.0,2.5,1730,2.0,0,0,1730,0,1996,435000.0
3.0,1.75,1370,1.0,0,0,1370,0,1980,222000.0
4.0,1.0,1210,1.5,0,0,1210,0,1936,485000.0
5.0,3.5,2160,3.0,0,0,2160,0,2007,750000.0
3.0,2.25,1550,2.0,0,0,1550,0,1989,266000.0
2.0,1.0,1170,1.0,0,0,970,200,1941,455000.0
3.0,1.75,2020,2.0,0,0,2020,0,1975,490000.0
3.0,1.75,1740,1.0,0,0,1240,500,1978,280000.0
4.0,3.25,3100,2.0,0,2,2090,1010,1923,1450000.0
4.0,1.0,1590,1.5,0,0,1140,450,1942,291000.0
5.0,3.0,2400,2.0,0,3,2400,0,1981,745000.0
3.0,2.5,2290,1.0,0,0,2290,0,1972,685900.0
3.0,1.75,1610,1.0,0,0,1610,0,1964,160000.0
4.0,2.5,2240,1.0,0,0,1490,750,1968,650000.0
2.0,1.0,850,1.0,0,0,850,0,1951,250000.0
2.0,1.5,920,2.0,0,0,920,0,1995,265000.0
5.0,3.25,2590,1.0,0,0,1330,1260,1960,599000.0
3.0,1.0,1340,1.5,0,0,1340,0,1944,199950.0
4.0,2.75,2420,1.0,0,1,1420,1000,1948,712500.0
2.0,1.0,1420,1.0,0,0,920,500,1941,490000.0
4.0,1.0,1360,1.5,0,0,1360,0,1917,511500.0
3.0,1.0,1510,1.0,0,0,1010,500,1955,299000.0
4.0,2.5,2650,1.0,0,2,2330,320,1954,685000.0
4.0,2.0,2120,1.5,0,0,1720,400,1927,597000.0
3.0,1.0,1200,1.0,0,0,1200,0,1977,210000.0
4.0,2.5,3190,1.0,0,0,2210,980,1946,659000.0
3.0,1.0,1050,1.0,0,0,1050,0,1925,540000.0
3.0,2.0,1300,1.0,0,0,1300,0,1998,469000.0
3.0,2.5,3970,1.5,0,0,3970,0,1991,1065000.0
5.0,2.5,2990,1.0,0,2,1800,1190,1972,575000.0
4.0,2.75,2440,1.5,0,2,1640,800,1941,725000.0
4.0,1.0,1170,1.0,0,0,1170,0,1953,299950.0
4.0,2.0,2270,1.0,0,0,2270,0,1961,375000.0
3.0,1.5,1280,1.0,0,0,1280,0,1962,342450.0
4.0,2.5,1950,2.0,0,0,1950,0,2002,315000.0
4.0,2.75,1930,1.0,0,0,1170,760,1997,328000.0
4.0,2.75,1970,1.0,0,0,1170,800,1977,323000.0
4.0,3.0,1820,1.0,0,0,1000,820,1997,320000.0
2.0,1.0,950,1.0,0,0,950,0,1924,550000.0
6.0,3.5,4010,1.0,0,0,2090,1920,1955,1646000.0
4.0,3.5,4560,1.0,0,3,2230,2330,1995,1212500.0
4.0,3.5,4560,1.0,0,3,2230,2330,1995,1200000.0
3.0,1.0,1150,1.0,0,0,1150,0,1943,120000.0
3.0,1.0,1150,1.0,0,0,1150,0,1943,175000.0
3.0,1.0,910,1.5,0,0,910,0,1900,169900.0
6.0,2.75,2890,1.0,0,0,1830,1060,1976,508000.0
2.0,1.0,1070,1.0,0,0,1070,0,1951,335000.0
3.0,2.75,2050,1.5,0,0,1580,470,1927,613200.0
2.0,1.5,1040,1.5,0,0,1040,0,1904,420000.0
4.0,3.25,3320,3.0,0,0,2950,370,2008,1000000.0
2.0,1.0,740,1.0,0,0,740,0,1948,342000.0
4.0,2.0,3380,1.0,0,0,1690,1690,1979,850000.0
2.0,1.75,1210,1.0,0,0,910,300,1942,582000.0
3.0,2.5,2480,2.0,0,0,2480,0,2001,475000.0
3.0,2.25,2010,1.0,0,0,1330,680,1975,570000.0
4.0,3.25,3230,1.5,0,0,1750,1480,1916,826600.0
2.0,2.5,1170,2.0,0,0,1170,0,2001,387000.0
3.0,1.0,1250,1.0,0,0,1250,0,1969,330000.0
3.0,2.5,2070,1.0,0,0,1540,530,1980,653450.0
2.0,1.0,1050,1.0,0,0,1050,0,2005,285000.0
3.0,1.0,1400,1.0,0,0,1400,0,1962,217000.0
3.0,1.0,1120,1.0,0,0,1120,0,1977,615000.0
4.0,2.5,3150,2.0,0,0,3150,0,2014,580135.0
4.0,3.5,4540,2.0,0,0,4200,340,1998,1150000.0
3.0,2.0,1400,1.0,0,0,1400,0,1991,231200.0
4.0,2.75,2500,2.0,0,0,2500,0,2010,680000.0
3.0,1.5,1390,2.0,0,0,1390,0,2001,267500.0
4.0,2.75,3160,2.0,0,3,2310,850,1939,942000.0
3.0,1.75,1310,1.0,0,0,1310,0,1948,435000.0
2.0,1.0,1740,1.0,0,0,950,790,1924,315000.0
3.0,2.5,1490,3.0,0,0,1490,0,2004,354901.0
2.0,2.0,1300,1.0,0,0,1300,0,2005,439888.0
4.0,1.0,1460,1.5,0,0,1340,120,1928,360000.0
4.0,1.0,1030,1.0,0,0,1030,0,1955,205000.0
3.0,2.5,1970,2.0,0,0,1970,0,1988,299995.0
2.0,1.0,790,1.0,0,0,790,0,1944,150000.0
3.0,2.25,3800,1.0,0,0,3330,470,1976,575000.0
3.0,2.0,2168,2.0,0,1,2168,0,1950,625000.0
4.0,3.5,4140,2.0,0,0,4140,0,2000,950000.0
4.0,2.5,2440,1.0,0,0,1560,880,1965,278800.0
3.0,2.0,1720,2.0,0,0,1720,0,1908,713500.0
4.0,2.25,3020,1.5,1,3,2110,910,1916,1900000.0
5.0,2.0,2610,1.0,0,0,1710,900,1988,439000.0
3.0,2.0,1500,1.0,0,0,1060,440,1981,425000.0
4.0,2.5,2600,1.5,0,0,1570,1030,1961,252500.0
3.0,1.5,1370,1.0,0,0,1370,0,1961,185000.0
5.0,2.75,2400,1.0,0,0,1200,1200,1974,406550.0
2.0,1.5,1068,2.0,0,0,1068,0,1990,243000.0
3.0,1.5,2220,1.0,0,0,1110,1110,1962,500000.0
2.0,1.0,880,1.0,0,0,880,0,1942,204750.0
3.0,1.5,1310,1.0,0,0,1310,0,1968,222000.0
4.0,1.0,1350,1.0,0,0,1350,0,1966,200000.0
3.0,2.25,1400,3.0,0,2,1400,0,2006,367000.0
3.0,1.0,1170,1.0,0,0,1170,0,1962,183000.0
3.0,2.5,1020,2.0,0,0,720,300,2004,300000.0
3.0,1.75,1300,1.0,0,0,1300,0,1985,369000.0
3.0,2.0,2010,2.0,0,0,2010,0,1929,380000.0
3.0,2.0,1590,2.0,0,0,1590,0,1985,463000.0
3.0,1.0,1470,1.0,0,0,1470,0,1963,475000.0
3.0,1.75,1580,1.0,0,0,1580,0,1981,225000.0
3.0,1.75,1970,1.0,0,0,1970,0,1968,371000.0
3.0,2.5,2330,2.0,0,0,2330,0,2003,625000.0
6.0,5.0,7100,2.5,0,0,5240,1860,1933,3200000.0
3.0,1.75,1230,1.0,0,0,1230,0,1980,329000.0
3.0,1.75,2570,2.0,0,0,2570,0,1962,634000.0
4.0,2.5,3440,2.0,0,0,3440,0,2006,616000.0
3.0,2.25,3330,2.0,0,0,3330,0,1968,1824100.0
4.0,2.25,1780,2.0,0,0,1780,0,2002,435000.0
4.0,2.5,2110,2.0,0,0,2110,0,2000,320000.0
4.0,3.5,2770,2.0,0,0,2770,0,2002,820000.0
3.0,2.5,1590,2.0,0,0,1590,0,2000,310000.0
3.0,2.25,1460,2.0,0,0,1140,320,2003,443750.0
4.0,2.25,2070,1.0,0,0,1700,370,1967,795000.0
3.0,2.5,2420,1.0,0,0,1530,890,1957,475000.0
5.0,1.75,2000,2.0,0,0,2000,0,1921,585000.0
2.0,1.0,1010,2.0,0,0,1010,0,1981,315000.0
4.0,2.5,3050,2.0,0,0,3050,0,1989,635000.0
3.0,1.0,1160,1.0,0,0,1160,0,1968,305000.0
3.0,2.0,2180,1.0,0,0,1100,1080,1904,785000.0
3.0,1.75,1560,1.0,0,0,780,780,1944,525000.0
4.0,1.75,1580,1.0,0,0,790,790,1910,537000.0
3.0,1.75,1660,1.0,0,0,1380,280,1974,279950.0
4.0,2.0,2350,2.0,0,0,2350,0,1977,659000.0
2.0,1.0,1440,1.0,0,0,970,470,1980,203000.0
4.0,2.5,2930,2.0,0,0,2930,0,2005,782500.0
3.0,1.75,1590,1.0,0,0,1130,460,1984,250000.0
3.0,1.0,1400,1.0,0,0,1060,340,1955,279000.0
6.0,2.5,3190,2.0,0,0,3190,0,1979,664000.0
4.0,3.25,4580,2.0,0,3,3080,1500,1991,2900000.0
4.0,2.0,1830,1.0,0,0,1070,760,1953,378500.0
3.0,1.75,2720,1.5,0,0,2720,0,1988,535000.0
2.0,1.0,1360,1.0,0,0,1360,0,1932,520000.0
3.0,2.0,1520,1.0,0,0,800,720,1943,369950.0
3.0,2.25,2290,2.0,0,0,2290,0,1981,545000.0
3.0,2.5,2150,2.0,0,0,2150,0,1991,360000.0
3.0,1.5,1170,1.0,0,0,1170,0,1955,760000.0
3.0,1.75,1830,1.0,0,2,1010,820,1939,450000.0
4.0,2.5,2730,2.0,0,0,2730,0,1991,612500.0
3.0,1.0,1090,1.0,0,0,1090,0,1962,280000.0
3.0,2.5,2560,2.0,0,0,2560,0,1993,750000.0
3.0,1.0,1160,1.0,0,0,1160,0,1958,237000.0
2.0,1.75,1010,1.5,0,0,1010,0,1919,441500.0
3.0,2.0,1650,1.0,0,0,1650,0,1989,251000.0
3.0,1.0,2120,1.0,0,0,1220,900,1942,200000.0
1.0,1.0,960,1.0,0,0,760,200,1908,332000.0
3.0,2.5,1509,3.0,0,0,1509,0,2014,401500.0
4.0,1.75,2270,1.0,0,0,1300,970,1957,585000.0
4.0,2.5,1954,2.0,0,0,1954,0,2005,340000.0
3.0,3.5,2800,1.0,0,0,2800,0,2005,920000.0
3.0,1.0,1270,1.5,0,0,1270,0,1944,153000.0
4.0,2.25,1810,1.0,0,0,1080,730,1986,299950.0
4.0,2.5,2410,2.0,0,0,2410,0,1983,440000.0
3.0,2.5,1690,2.0,0,0,1690,0,2003,293000.0
3.0,1.75,1190,1.0,0,0,1190,0,1952,203000.0
2.0,1.75,1280,1.0,0,0,1280,0,1991,193000.0
3.0,1.75,1460,1.0,0,0,1460,0,1965,305000.0
4.0,1.75,1600,1.0,0,0,1130,470,1959,495000.0
3.0,1.75,1770,1.0,0,0,1130,640,1952,420000.0
4.0,2.5,2800,1.0,0,0,1700,1100,1971,569500.0
4.0,2.5,2680,2.0,0,0,2680,0,1989,620000.0
3.0,1.75,1680,1.0,0,0,1680,0,1959,466000.0
3.0,1.0,1120,1.0,0,0,1120,0,1962,355500.0
2.0,1.0,1040,1.0,0,0,1040,0,1955,687500.0
3.0,2.25,1790,2.0,0,0,1790,0,1975,432100.0
3.0,2.5,2410,1.5,0,0,2410,0,1976,500000.0
5.0,3.25,3370,2.0,0,0,2140,1230,1988,690000.0
2.0,1.0,800,1.0,0,0,800,0,1949,350000.0
2.0,1.0,1380,1.0,0,0,870,510,1943,268000.0
2.0,1.0,990,1.0,0,0,990,0,1945,120000.0
4.0,2.5,1800,2.0,0,0,1800,0,1994,285000.0
4.0,1.5,1820,1.0,0,0,1380,440,1955,365000.0
3.0,2.5,2620,2.0,0,0,2620,0,2002,635000.0
2.0,2.5,2290,2.0,0,0,2290,0,2005,630000.0
4.0,3.0,2200,2.0,0,0,2200,0,1968,450000.0
4.0,2.5,2940,1.0,0,0,1850,1090,1974,590000.0
2.0,1.75,1700,1.0,0,1,1260,440,1950,895000.0
3.0,1.0,860,1.0,0,0,860,0,1963,160000.0
2.0,1.0,910,1.0,0,0,910,0,1924,520000.0
4.0,3.25,2820,2.0,0,0,2820,0,1976,432000.0
2.0,1.0,930,1.0,0,0,930,0,1942,141800.0
4.0,2.0,2190,2.5,0,0,2190,0,1910,980000.0
4.0,2.5,3430,2.0,0,0,3430,0,2014,1290000.0
4.0,2.75,2560,1.0,0,0,1480,1080,1959,740000.0
2.0,1.0,770,1.0,0,0,770,0,1948,230000.0
3.0,4.5,5230,2.0,1,4,3740,1490,2005,3400000.0
3.0,2.25,2440,1.0,0,2,1830,610,1974,954500.0
3.0,1.5,1650,1.5,0,0,1650,0,1929,622000.0
1.0,1.0,780,1.0,0,0,780,0,1905,90000.0
3.0,3.0,1260,3.0,0,0,1260,0,1998,342000.0
4.0,2.5,2320,2.0,0,0,2320,0,2007,305000.0
4.0,2.75,1560,1.0,0,3,1060,500,1979,259900.0
3.0,2.0,2330,1.5,0,0,1600,730,1934,420000.0
2.0,1.0,1400,1.5,0,0,1100,300,1929,250000.0
3.0,1.5,1450,1.0,0,0,1450,0,1961,249950.0
2.0,1.0,1140,1.0,0,0,990,150,1932,199000.0
3.0,1.0,1120,1.0,0,0,1120,0,1954,355200.0
3.0,1.5,1970,1.0,0,0,1680,290,1955,425000.0
3.0,1.0,1110,1.0,0,0,1110,0,1980,379500.0
4.0,2.5,3070,2.0,0,0,3070,0,2009,860000.0
3.0,2.5,1940,2.0,0,0,1940,0,2004,335000.0
3.0,2.5,3050,2.0,0,0,3050,0,1997,865000.0
3.0,1.0,1240,1.5,0,0,1240,0,1902,390000.0
5.0,4.25,3380,2.0,0,0,3380,0,2014,569950.0
3.0,2.5,3190,2.0,0,0,3190,0,2006,495500.0
4.0,1.75,1670,1.0,0,0,1390,280,1953,476500.0
3.0,1.0,1660,1.0,0,0,1660,0,1957,261000.0
4.0,2.0,2070,1.0,0,0,2070,0,1955,375000.0
4.0,2.0,2070,1.0,0,0,2070,0,1955,550000.0
2.0,1.0,1430,1.0,0,0,930,500,1949,230000.0
5.0,2.5,2270,1.0,0,0,1570,700,1963,526750.0
3.0,2.0,1980,1.5,0,0,1070,910,1911,606000.0
4.0,2.75,2500,1.0,0,0,1780,720,1977,368500.0
3.0,1.0,1230,1.0,0,0,1230,0,1973,275000.0
4.0,1.0,1390,1.5,0,0,1390,0,1955,342000.0
4.0,1.75,2120,1.0,0,0,1600,520,1978,278100.0
4.0,2.75,1540,1.0,0,2,850,690,1929,450000.0
4.0,2.5,2000,2.0,0,0,2000,0,2005,349950.0
4.0,2.5,2400,2.0,0,0,2400,0,2001,425000.0
4.0,2.75,2110,1.0,0,0,1510,600,1962,435000.0
4.0,2.5,2550,1.0,0,0,1300,1250,1961,460000.0
4.0,1.75,1440,1.0,0,0,1440,0,1963,323000.0
2.0,1.0,810,1.0,0,0,810,0,1944,325000.0
2.0,1.75,1170,1.0,0,0,690,480,1924,480000.0
3.0,2.5,3590,1.0,0,0,2950,640,1958,1325000.0
4.0,1.75,2090,1.0,0,0,1280,810,1956,210000.0
5.0,4.5,3820,2.0,0,3,2830,990,2000,920000.0
3.0,1.0,1460,1.0,0,0,1460,0,1959,399000.0
3.0,1.75,2360,1.0,0,0,1180,1180,1940,631750.0
3.0,1.0,1100,1.0,0,0,1100,0,1962,184000.0
4.0,2.5,2100,2.0,0,0,2100,0,1974,333000.0
2.0,2.0,1310,2.0,0,0,1310,0,2004,218000.0
2.0,1.5,750,1.0,0,0,750,0,1919,258305.0
5.0,1.5,1720,1.5,0,0,1720,0,1915,775000.0
3.0,2.5,3370,2.0,0,0,3200,170,1951,515000.0
2.0,1.5,1200,2.0,0,0,1000,200,2015,455000.0
3.0,2.5,1830,2.5,0,0,1830,0,1954,440000.0
3.0,3.5,3870,2.0,0,0,2760,1110,2002,1440000.0
3.0,2.25,2220,2.0,0,0,1620,600,1919,850000.0
3.0,1.75,2920,1.0,0,0,1850,1070,1961,480000.0
5.0,2.75,2540,1.0,0,0,1520,1020,1980,420000.0
3.0,1.75,1970,1.0,0,0,1590,380,1976,408000.0
5.0,1.75,2170,1.0,0,0,1100,1070,1962,278000.0
3.0,3.0,2350,2.0,0,0,1560,790,2001,1195000.0
4.0,2.25,2630,2.0,0,0,2630,0,1979,454000.0
4.0,2.5,4120,1.0,1,4,2070,2050,1965,1851000.0
4.0,2.25,2440,2.0,0,0,2440,0,2007,499000.0
5.0,3.0,3480,2.0,0,0,3480,0,2012,590000.0
3.0,3.5,1900,2.0,0,0,1560,340,1999,385000.0
4.0,3.25,3160,2.0,0,2,3160,0,2011,1250000.0
2.0,1.75,1330,1.0,0,0,1330,0,1979,202200.0
3.0,2.25,1420,1.0,0,0,960,460,1976,450000.0
3.0,2.0,2570,1.5,0,0,2570,0,1986,435000.0
2.0,1.0,1270,1.0,0,0,1270,0,1908,550000.0
3.0,2.25,2470,1.0,0,2,1550,920,1973,361000.0
4.0,2.25,2590,2.0,0,0,2590,0,1979,760000.0
4.0,2.5,3030,2.0,0,0,3030,0,2003,902000.0
3.0,1.75,1240,1.5,0,0,1240,0,1951,505000.0
3.0,1.0,1040,1.0,0,0,1040,0,1961,200000.0
5.0,2.25,2320,1.0,0,0,1270,1050,1967,260000.0
2.0,1.0,1190,1.5,0,0,1190,0,1928,417000.0
3.0,2.25,2030,1.0,0,0,1360,670,1986,287500.0
3.0,1.5,1390,1.0,0,0,1390,0,1961,450000.0
2.0,1.75,2050,1.5,0,2,2050,0,1979,825000.0
4.0,3.0,3050,2.0,0,0,2330,720,1926,1475000.0
2.0,1.0,1240,1.5,0,0,1240,0,1921,319950.0
4.0,2.5,3030,2.0,0,0,3030,0,1981,682000.0
3.0,1.75,1930,1.0,0,0,1130,800,1956,560000.0
3.0,1.75,1490,1.0,0,0,1490,0,1985,350000.0
3.0,2.0,1510,1.0,0,0,1510,0,1995,270000.0
3.0,1.75,1320,1.0,0,0,1320,0,1990,284000.0
4.0,2.5,2330,2.0,0,0,2330,0,2004,308000.0
4.0,2.0,2240,1.0,0,0,1120,1120,1956,450000.0
4.0,2.5,2050,2.0,0,0,2050,0,1989,540000.0
4.0,1.5,1680,1.0,0,0,1130,550,1959,380000.0
4.0,2.75,2200,1.5,0,0,2200,0,1971,522500.0
1.0,1.0,670,1.0,0,0,670,0,1978,118000.0
4.0,1.75,1730,1.0,0,0,1010,720,1968,280400.0
4.0,2.75,2710,1.5,0,0,1690,1020,1995,710000.0
3.0,3.25,3410,2.0,0,0,3410,0,1993,720000.0
3.0,1.75,1330,1.0,0,0,1330,0,1961,787000.0
4.0,2.5,1990,2.0,0,0,1990,0,2012,537000.0
2.0,1.5,1900,1.0,0,0,1500,400,1916,650000.0
4.0,1.0,1310,1.0,0,0,910,400,1948,154200.0
4.0,2.5,1690,1.0,0,0,1080,610,1979,238000.0
3.0,1.0,1040,1.0,0,0,1040,0,1953,285650.0
2.0,1.5,1340,2.0,0,0,1190,150,2006,485500.0
2.0,1.0,1120,1.0,0,0,1120,0,1942,315000.0
5.0,6.75,9640,1.0,1,4,4820,4820,1983,4668000.0
3.0,2.0,2310,2.0,0,0,2310,0,1965,627000.0
3.0,2.5,2190,2.0,0,0,2190,0,1994,525000.0
3.0,3.25,1220,2.0,0,0,930,290,2014,526000.0
3.0,1.5,1200,1.0,0,0,1060,140,1910,480000.0
3.0,3.5,3840,2.0,0,0,3840,0,1996,970000.0
4.0,2.5,2460,1.0,0,0,1560,900,1965,640000.0
3.0,2.5,1630,1.0,0,0,1320,310,1985,279000.0
2.0,2.0,970,1.0,0,0,970,0,1940,303000.0
4.0,2.0,1780,1.5,0,0,930,850,1918,315000.0
4.0,1.75,1760,1.0,0,0,1080,680,1979,336500.0
2.0,1.0,770,1.0,0,0,770,0,1951,163250.0
3.0,1.0,1760,1.0,0,0,1050,710,1962,444950.0
2.0,1.0,990,2.0,0,0,990,0,1998,285000.0
2.0,1.0,1250,1.0,0,0,940,310,1938,370000.0
3.0,2.25,1440,2.0,0,0,1440,0,1997,330000.0
2.0,2.0,1960,1.0,0,0,980,980,1950,395000.0
6.0,3.0,2510,1.0,0,0,1460,1050,1944,440000.0
4.0,2.75,2920,2.0,0,0,2920,0,2012,625000.0
3.0,2.5,1730,2.0,0,0,1730,0,1991,435000.0
3.0,2.5,1570,2.0,0,0,1570,0,2005,299950.0
2.0,1.75,970,1.0,0,0,970,0,1944,560000.0
4.0,3.0,2800,2.0,0,0,2800,0,2002,380000.0
4.0,2.0,1580,2.0,0,0,1580,0,1906,333000.0
2.0,1.0,1220,1.0,0,0,920,300,1926,499000.0
3.0,1.5,1550,1.0,0,0,1330,220,1980,386000.0
3.0,2.0,1220,1.0,0,0,720,500,1947,320600.0
2.0,2.0,1651,1.0,0,0,1651,0,1946,285000.0
7.0,4.0,3150,2.0,0,0,3150,0,2013,450000.0
2.0,1.0,800,1.0,0,0,800,0,1933,175000.0
5.0,2.75,3190,2.0,0,0,3190,0,2004,544800.0
3.0,1.75,1720,1.0,0,0,1140,580,1981,220000.0
2.0,2.25,1100,2.0,0,0,1100,0,2009,374000.0
3.0,2.0,1010,1.0,0,0,1010,0,1984,200000.0
3.0,2.0,1010,1.0,0,0,1010,0,1984,259950.0
4.0,2.75,1760,1.0,0,0,1140,620,1971,255000.0
3.0,1.75,1400,1.0,0,0,1040,360,1975,447000.0
3.0,2.5,1820,1.5,0,0,1820,0,1926,287000.0
3.0,2.0,1470,1.0,0,0,1470,0,1932,344950.0
2.0,1.0,770,1.0,0,0,770,0,1921,212000.0
5.0,2.75,1340,1.0,0,0,1190,150,1962,425000.0
1.0,1.0,480,1.0,0,0,480,0,1922,170000.0
3.0,1.0,1260,1.5,0,0,1260,0,1928,565000.0
2.0,1.0,870,1.0,0,0,870,0,1940,234000.0
3.0,2.5,4010,1.0,0,3,2600,1410,1983,1511250.0
3.0,2.5,2340,1.0,0,0,1280,1060,1993,345000.0
3.0,2.75,1770,2.0,0,0,1770,0,2009,415000.0
5.0,1.75,2660,1.5,0,0,1670,990,1922,760000.0
5.0,2.5,3600,2.0,0,0,3600,0,1976,484000.0
2.0,1.75,1230,2.0,0,0,1230,0,2006,360000.0
3.0,2.75,3270,1.5,0,0,3270,0,1988,875000.0
3.0,2.5,3100,1.0,0,0,3100,0,1954,930000.0
3.0,2.0,1900,1.0,0,0,950,950,1966,250000.0
2.0,2.0,1750,2.0,0,0,1750,0,2012,394000.0
4.0,3.5,3380,2.0,0,1,2160,1220,2007,865000.0
2.0,2.0,2090,2.0,0,1,2090,0,1918,477500.0
4.0,2.75,4120,1.0,0,4,2060,2060,1947,1250000.0
3.0,1.75,1260,1.0,0,0,840,420,1947,270000.0
3.0,2.25,1800,1.0,0,0,1230,570,1974,567000.0
3.0,2.5,1960,1.0,0,0,980,980,1940,635000.0
6.0,2.75,4460,2.5,0,2,3460,1000,1930,1865000.0
3.0,1.75,1330,1.0,0,0,1330,0,1973,183000.0
3.0,1.75,1820,1.0,0,0,1220,600,1950,309933.0
4.0,2.75,3360,1.0,0,0,1760,1600,1973,945800.0
2.0,1.75,2860,1.0,1,4,1510,1350,1948,503000.0
3.0,1.0,1460,1.0,0,0,1460,0,1957,220000.0
3.0,1.75,1900,1.0,0,0,1900,0,1987,335000.0
3.0,2.25,1790,1.0,0,2,1240,550,1969,650000.0
4.0,3.5,3100,2.0,0,0,3100,0,2005,511000.0
2.0,1.0,900,1.0,0,0,900,0,1938,275000.0
2.0,1.75,1530,2.0,0,0,1260,270,1989,576250.0
2.0,3.25,2070,2.0,1,3,1760,310,1988,1452000.0
3.0,2.0,1340,1.0,0,0,920,420,1912,186000.0
1.0,1.0,1220,1.0,0,0,1220,0,1922,655100.0
4.0,2.5,2370,2.0,0,0,2370,0,1998,328000.0
3.0,2.5,1890,1.0,0,0,1460,430,1973,441000.0
3.0,1.75,1480,1.5,0,0,1480,0,1981,370000.0
2.0,1.0,1050,1.0,0,0,1050,0,1959,630000.0
4.0,2.25,2070,1.0,0,0,1720,350,1958,470500.0
2.0,1.0,1170,1.0,0,0,1170,0,1948,285950.0
3.0,1.5,1090,1.0,0,0,1090,0,1958,698000.0
3.0,2.5,1650,2.0,0,0,1650,0,1991,268000.0
4.0,3.75,4410,3.0,0,4,3570,840,2003,1625000.0
4.0,2.5,1780,2.0,0,0,1780,0,1993,355000.0
3.0,1.0,1550,1.0,0,0,1250,300,1952,299000.0
4.0,2.75,2290,2.0,0,0,2170,120,1926,1003000.0
4.0,2.0,2220,1.5,0,0,2220,0,1958,275000.0
3.0,1.75,1150,1.0,0,0,1030,120,1918,475000.0
4.0,2.5,2000,2.0,0,0,2000,0,1989,260000.0
2.0,1.75,1270,1.5,0,0,1270,0,1932,416000.0
5.0,1.0,1810,1.5,0,2,1810,0,1915,495000.0
3.0,1.0,1450,1.0,0,0,1450,0,1952,357500.0
2.0,1.5,1170,3.0,0,0,1170,0,2003,459500.0
3.0,2.5,1730,2.0,0,0,1730,0,1994,258000.0
3.0,2.25,2680,1.0,0,0,2680,0,1962,600000.0
3.0,1.0,1260,1.5,0,2,1260,0,1937,665000.0
3.0,1.5,1020,1.0,0,0,1020,0,1959,165000.0
5.0,2.5,1970,2.0,0,0,1970,0,1994,297000.0
2.0,1.0,830,1.0,0,0,830,0,1942,350000.0
4.0,4.5,5030,2.0,0,2,3250,1780,2008,2450000.0
2.0,1.0,800,1.0,0,0,800,0,1958,180000.0
3.0,1.75,1330,1.0,0,0,720,610,1981,339950.0
3.0,1.0,1030,1.0,0,0,1030,0,1952,365000.0
4.0,4.25,5660,2.0,0,0,4100,1560,2001,955000.0
3.0,2.5,2330,2.0,0,4,1410,920,2004,732000.0
3.0,1.75,1540,1.0,0,0,770,770,1947,500000.0
6.0,2.75,2040,1.0,0,2,1100,940,1961,610000.0
3.0,2.0,1540,1.0,0,0,1540,0,2004,525000.0
4.0,1.0,1920,1.0,0,0,1220,700,1966,170000.0
3.0,2.5,1870,2.0,0,0,1870,0,2005,300000.0
5.0,3.5,2960,2.0,0,0,1940,1020,1986,389500.0
3.0,1.5,1690,1.0,0,0,1690,0,1955,330000.0
3.0,2.25,1610,2.0,0,0,1610,0,1988,269950.0
2.0,1.0,670,1.0,0,0,670,0,1948,107000.0
3.0,1.0,1752,2.0,0,2,1752,0,2005,249000.0
4.0,2.0,1540,1.5,0,0,1540,0,1935,442500.0
3.0,2.5,3160,2.0,0,3,3160,0,2002,579000.0
3.0,1.75,2570,2.0,0,0,2570,0,1984,621500.0
3.0,1.5,1370,1.0,0,0,1080,290,1958,203000.0
2.0,1.0,860,1.0,0,0,860,0,1942,222900.0
2.0,1.5,1680,1.5,0,0,1680,0,1991,453000.0
1.0,0.75,930,1.0,0,0,930,0,1941,190000.0
4.0,1.75,1820,1.0,0,0,1150,670,1962,320000.0
3.0,1.5,2120,1.5,0,0,2120,0,1904,733500.0
4.0,2.25,3330,2.0,0,0,3330,0,1994,555000.0
3.0,2.25,2520,2.0,0,0,1850,670,2003,364950.0
3.0,1.75,1560,1.0,0,0,1160,400,1989,490000.0
5.0,1.75,2250,1.0,0,1,1350,900,1957,688000.0
2.0,1.0,640,1.0,0,0,640,0,1942,165000.0
5.0,3.75,3880,2.0,0,0,3880,0,2004,506000.0
3.0,2.25,3360,2.0,0,0,2770,590,1905,2193000.0
5.0,1.75,2350,1.0,0,0,1510,840,1968,754000.0
5.0,2.5,2340,2.0,1,4,2340,0,1959,949950.0
3.0,2.5,1430,3.0,0,0,1430,0,2003,443600.0
3.0,2.5,1920,2.0,0,0,1920,0,1998,380600.0
3.0,3.25,4330,2.0,0,0,3630,700,1985,722800.0
2.0,1.0,790,1.0,0,0,790,0,1948,342888.0
4.0,1.75,2350,1.0,0,2,1350,1000,1957,555000.0
3.0,2.5,1350,2.0,0,0,1350,0,1991,613000.0
3.0,2.0,1470,1.0,0,0,1470,0,1956,480000.0
6.0,1.5,1680,1.5,0,0,1680,0,1911,619500.0
4.0,2.5,1890,1.0,0,0,1290,600,1980,437000.0
4.0,2.5,2030,1.0,0,0,2030,0,1959,621000.0
4.0,1.75,1760,1.5,0,0,1760,0,1906,810000.0
3.0,2.25,1950,1.0,0,0,1350,600,1964,415000.0
4.0,1.0,1440,1.0,0,0,1080,360,1918,250000.0
3.0,1.5,2230,1.0,0,1,1260,970,1968,585000.0
3.0,1.0,1180,1.5,0,0,1180,0,1946,220000.0
5.0,2.5,2500,1.0,0,0,1400,1100,1963,580000.0
3.0,2.75,2680,1.0,0,0,1820,860,1964,1320000.0
4.0,2.5,2040,1.0,0,0,1610,430,1968,675000.0
4.0,2.75,2660,2.0,0,0,2660,0,2002,695000.0
5.0,2.75,2580,1.0,0,0,1730,850,1954,915000.0
3.0,1.0,1000,1.0,0,0,1000,0,1947,375000.0
3.0,1.5,1330,2.0,0,0,1140,190,2008,500000.0
2.0,2.0,1420,1.0,0,0,1420,0,2004,335000.0
2.0,1.0,1280,1.5,0,0,1280,0,1912,170000.0
5.0,2.5,2200,1.0,0,0,1400,800,1971,320900.0
3.0,1.75,1800,1.0,0,0,1440,360,1978,508000.0
3.0,1.75,1200,1.0,0,0,1200,0,1968,228950.0
4.0,2.0,1840,1.5,0,0,1080,760,1929,433000.0
2.0,1.0,960,1.0,0,0,960,0,1951,267500.0
4.0,1.5,2890,2.0,0,4,2090,800,1939,910000.0
3.0,1.75,1290,1.0,0,0,1290,0,1984,370000.0
2.0,1.0,1140,1.5,0,0,1140,0,1911,320000.0
3.0,1.75,1750,1.0,0,1,1750,0,1956,660000.0
4.0,2.25,2580,2.0,0,0,2580,0,1977,787888.0
4.0,2.5,2650,2.0,0,0,2650,0,2005,329000.0
2.0,1.0,1470,1.0,0,0,970,500,1941,602000.0
3.0,2.0,1640,1.0,0,0,1640,0,1959,375000.0
1.0,1.0,620,1.0,0,0,620,0,1926,212000.0
3.0,1.5,1440,1.0,0,0,1440,0,1977,224000.0
3.0,2.0,1160,1.0,0,0,1160,0,1986,315500.0
2.0,1.0,1070,1.0,0,0,1070,0,1902,350000.0
6.0,4.5,3560,2.0,0,0,3560,0,1989,389000.0
3.0,1.75,1720,1.0,0,0,1720,0,1962,285000.0
3.0,1.75,1530,1.0,0,0,1530,0,1958,425000.0
3.0,1.75,1270,1.0,0,0,1270,0,1980,190000.0
3.0,1.75,1510,1.0,0,0,1510,0,1971,374000.0
2.0,1.0,880,1.0,0,0,880,0,1904,292000.0
5.0,1.75,2020,1.5,0,0,1320,700,1911,475000.0
3.0,2.5,1410,1.0,0,0,820,590,1985,546500.0
3.0,1.0,860,1.0,0,0,860,0,1954,82000.0
3.0,1.0,860,1.0,0,0,860,0,1954,219900.0
3.0,1.0,1210,1.5,0,0,1210,0,1910,440000.0
3.0,2.5,2090,2.0,1,4,1550,540,1919,400000.0
3.0,1.75,1430,1.0,0,0,1430,0,1955,453000.0
6.0,3.25,2120,1.0,0,0,1060,1060,1983,330000.0
3.0,2.75,2540,2.0,0,0,2540,0,1991,359950.0
4.0,2.5,2490,2.0,0,0,2490,0,1983,616000.0
2.0,1.0,670,1.0,0,0,670,0,1960,245000.0
2.0,2.0,1320,3.0,0,0,1320,0,1997,296000.0
2.0,1.0,950,1.0,0,0,950,0,1924,193000.0
3.0,2.0,1870,1.5,0,0,1060,810,1927,456000.0
4.0,1.75,1840,1.0,0,0,980,860,1956,480000.0
3.0,3.25,1410,3.0,0,0,1410,0,2005,382000.0
2.0,1.0,1050,1.0,0,0,880,170,1904,650000.0
2.0,2.0,1400,1.0,0,0,1400,0,1957,431750.0
3.0,2.5,1630,2.0,0,0,1320,310,1997,419900.0
3.0,2.0,1900,1.0,0,0,1900,0,1995,315000.0
4.0,3.0,1890,1.0,0,0,1510,380,1979,597500.0
3.0,2.5,2980,1.0,0,0,1930,1050,1978,615000.0
4.0,3.25,2885,2.0,0,0,2885,0,1984,605000.0
3.0,2.5,1980,2.0,0,0,1980,0,1990,220000.0
4.0,2.5,3020,1.0,0,0,1710,1310,1960,340000.0
4.0,2.5,2980,2.0,0,0,2980,0,2001,620000.0
5.0,1.75,3290,1.5,0,0,3290,0,1973,602000.0
3.0,1.75,1580,1.0,0,0,1180,400,1951,575000.0
3.0,2.5,2090,1.0,0,0,1360,730,1987,285000.0
3.0,1.5,1100,1.0,0,0,1100,0,1965,306500.0
3.0,2.5,1870,2.0,0,0,1870,0,2002,325000.0
3.0,2.75,2390,1.0,0,0,1450,940,1973,623000.0
3.0,2.0,1320,1.0,0,0,1320,0,1993,256500.0
5.0,3.5,3430,2.0,0,0,2830,600,2002,473000.0
3.0,2.5,2250,2.0,0,0,2250,0,1985,549000.0
3.0,1.0,1710,1.0,0,0,1710,0,1986,305000.0
4.0,2.5,2160,2.0,0,0,2160,0,1988,317000.0
3.0,1.75,1400,1.0,0,0,1400,0,1963,450000.0
2.0,2.5,1560,1.0,0,0,780,780,1947,225000.0
5.0,2.0,2300,2.5,0,0,2300,0,1956,500000.0
2.0,1.0,820,1.0,0,0,820,0,1955,207000.0
3.0,1.0,1630,1.5,0,0,1630,0,1948,474900.0
3.0,2.5,2010,2.0,0,0,2010,0,1994,515000.0
4.0,1.0,1540,1.5,0,0,1090,450,1922,542000.0
4.0,2.75,2420,1.0,0,0,1530,890,1977,725000.0
3.0,2.5,1690,2.0,0,0,1690,0,2003,314950.0
3.0,2.0,1410,1.0,0,0,1410,0,1983,375000.0
3.0,1.75,1640,1.0,0,0,1640,0,1989,500000.0
3.0,1.75,2200,1.0,0,0,1500,700,1978,689000.0
3.0,2.25,1290,2.0,0,0,1000,290,2006,525000.0
3.0,1.5,1060,1.0,0,0,1060,0,1968,360000.0
3.0,1.0,1240,1.0,0,0,1240,0,1948,425000.0
2.0,1.0,1280,1.0,0,0,1280,0,1949,239950.0
2.0,2.5,2330,2.0,0,3,2330,0,1915,577500.0
3.0,1.75,2360,1.0,0,0,1360,1000,1948,615000.0
4.0,2.75,2210,1.0,0,0,1170,1040,1997,516000.0
4.0,2.75,3670,2.0,0,3,3670,0,1986,1218000.0
4.0,3.5,3080,2.0,0,3,2300,780,1937,1655000.0
2.0,1.0,770,1.0,0,0,770,0,1943,315000.0
4.0,2.0,2600,1.0,0,0,1410,1190,1959,250000.0
4.0,1.5,1220,1.0,0,0,1220,0,1942,250000.0
4.0,2.5,2910,1.0,0,0,1910,1000,1967,925000.0
3.0,1.0,1150,1.0,0,0,1150,0,1955,358000.0
3.0,2.5,1700,2.0,0,0,1700,0,1997,262000.0
3.0,1.75,1220,1.0,0,0,1220,0,1964,500000.0
5.0,1.0,1670,1.5,0,0,1670,0,1919,1300000.0
3.0,1.75,2420,2.0,0,1,2420,0,1984,500000.0
3.0,2.25,2610,2.0,0,0,2610,0,1988,675000.0
3.0,1.0,960,1.0,0,0,960,0,1955,235000.0
3.0,1.0,960,1.0,0,0,960,0,1955,545000.0
3.0,1.0,1010,1.0,0,0,1010,0,1981,350000.0
2.0,2.25,1550,2.0,0,0,1550,0,2008,320000.0
5.0,2.5,5067,1.0,0,2,3154,1913,1968,452000.0
3.0,2.0,2350,1.5,0,0,1990,360,1922,875000.0
3.0,1.5,1310,2.0,0,0,1310,0,1998,325000.0
4.0,2.25,2160,1.0,0,0,1080,1080,1947,756000.0
4.0,2.5,2510,1.0,0,0,1610,900,1978,319000.0
3.0,1.75,890,1.5,0,0,750,140,1926,455000.0
2.0,1.0,1129,1.0,0,0,1129,0,1953,330000.0
4.0,3.25,1980,1.0,0,0,1340,640,1980,510000.0
3.0,1.0,2360,1.0,0,0,1560,800,1964,532000.0
3.0,2.5,2480,2.0,0,0,1960,520,2014,775000.0
3.0,1.75,2160,1.0,0,0,1080,1080,1953,410000.0
2.0,1.75,1740,1.0,0,0,580,1160,1915,205000.0
4.0,2.5,2430,2.0,0,0,2430,0,1999,585000.0
2.0,1.75,1950,1.0,0,0,1950,0,1975,255000.0
2.0,1.0,910,1.0,0,0,910,0,1904,415000.0
4.0,2.0,2360,1.0,0,0,1180,1180,1925,459000.0
3.0,1.0,1130,1.0,0,0,1130,0,1965,354000.0
3.0,2.5,2150,2.0,0,0,2150,0,1995,587000.0
4.0,3.5,5270,2.0,0,0,3440,1830,2004,782000.0
3.0,1.5,1300,1.0,0,0,1300,0,1965,570000.0
3.0,1.0,1050,1.0,0,0,840,210,1941,414500.0
4.0,1.0,1380,1.0,0,0,1190,190,1928,185000.0
3.0,1.5,1610,1.0,0,0,1610,0,1961,262500.0
4.0,2.75,3150,1.0,0,0,2250,900,1965,370000.0
3.0,1.0,1520,1.0,0,0,1520,0,1954,362500.0
3.0,2.5,1990,2.0,0,0,1990,0,1993,536000.0
5.0,2.0,2500,1.5,0,0,1570,930,1921,425000.0
3.0,2.25,1890,1.0,0,0,1230,660,1973,435000.0
5.0,2.0,1840,1.0,0,0,1540,300,1942,435000.0
2.0,1.0,1220,1.0,0,0,760,460,1942,400000.0
2.0,1.5,1370,2.0,0,0,1080,290,2008,446000.0
3.0,2.5,2710,1.0,0,0,2710,0,1959,1250000.0
3.0,2.25,1760,2.0,0,0,1760,0,1991,300000.0
2.0,1.0,800,1.0,0,0,800,0,1938,404500.0
4.0,2.5,3530,2.0,0,0,3530,0,1986,910000.0
3.0,2.25,1780,1.5,0,0,1390,390,1927,771000.0
4.0,2.5,2610,2.0,0,0,2610,0,2009,335000.0
3.0,1.75,1850,1.0,0,0,1850,0,1965,390000.0
3.0,2.25,1560,1.0,0,0,1560,0,1963,288000.0
3.0,1.75,1270,1.0,0,0,1270,0,1956,403000.0
3.0,2.25,1420,3.0,0,0,1420,0,2006,510000.0
6.0,3.0,2880,2.0,0,0,2880,0,1980,751000.0
3.0,1.0,1420,1.0,0,4,1420,0,1950,408000.0
3.0,1.0,1640,1.5,0,0,1500,140,1920,1014250.0
3.0,2.0,1730,1.0,0,0,1730,0,1956,575000.0
3.0,1.75,1250,1.0,0,0,1250,0,1951,330000.0
3.0,2.25,1520,3.0,0,0,1520,0,2013,565000.0
3.0,2.5,1820,2.0,0,0,1820,0,1999,456000.0
4.0,2.5,2700,2.0,0,0,2700,0,1990,652500.0
3.0,1.75,1820,2.0,0,0,1820,0,1949,582000.0
4.0,2.5,2770,2.0,0,0,2770,0,2004,700000.0
2.0,1.0,1270,1.5,0,0,1270,0,1917,235000.0
3.0,1.75,1400,1.0,0,0,1400,0,1977,460000.0
3.0,2.25,1820,1.0,0,0,1240,580,1981,475000.0
2.0,2.0,1870,1.0,0,0,1870,0,2003,579000.0
4.0,2.0,1360,1.5,0,0,1360,0,1945,507000.0
3.0,2.5,1040,2.0,0,0,720,320,2004,210000.0
4.0,2.75,2140,2.0,0,0,2140,0,1993,359500.0
3.0,1.75,1330,1.0,0,0,1330,0,1987,248000.0
3.0,1.0,1070,1.0,0,0,1070,0,1952,239300.0
3.0,2.25,1370,3.0,0,0,1370,0,2009,315000.0
4.0,3.0,3510,2.0,0,0,3510,0,1976,970000.0
3.0,1.5,1730,1.0,0,1,1000,730,1954,510000.0
4.0,1.5,1550,1.0,0,0,1000,550,1956,418000.0
4.0,2.5,3280,2.0,0,0,3280,0,1996,699000.0
4.0,2.5,2150,1.0,0,3,1400,750,1967,871000.0
3.0,1.75,1580,1.0,0,1,1210,370,1967,515000.0
3.0,1.0,1460,1.0,0,0,1460,0,1952,400000.0
3.0,1.75,1410,1.0,0,0,1110,300,1954,445000.0
4.0,2.75,3090,1.0,0,2,1800,1290,1956,1110000.0
3.0,1.5,1690,1.0,0,0,1210,480,1976,212000.0
4.0,2.5,2870,2.0,0,0,2870,0,1980,710000.0
4.0,1.0,1100,1.0,0,0,880,220,1907,225800.0
3.0,1.75,2310,1.0,0,2,1580,730,1983,520000.0
5.0,3.75,3490,1.0,0,1,1940,1550,1968,1295000.0
4.0,2.0,2080,1.0,0,0,1040,1040,1950,248000.0
4.0,2.5,2230,1.0,0,0,1220,1010,1957,556000.0
5.0,1.75,1710,1.0,0,0,1070,640,1958,319950.0
4.0,2.75,1640,1.0,0,0,1000,640,1984,320000.0
3.0,2.5,1600,2.0,0,0,1600,0,1992,245000.0
3.0,2.5,2850,2.0,0,0,2850,0,1987,700000.0
5.0,2.75,2600,2.0,0,0,2600,0,2015,628000.0
3.0,2.0,1380,1.0,0,0,1380,0,1948,640000.0
4.0,1.75,1320,1.0,0,0,940,380,1942,420000.0
3.0,2.5,1420,3.0,0,0,1420,0,2002,349950.0
4.0,2.75,2420,2.0,0,0,2420,0,1996,307999.0
4.0,2.75,2600,2.0,0,0,1960,640,1949,749950.0
2.0,1.0,840,1.0,0,0,840,0,1919,290000.0
3.0,1.75,1420,1.0,0,0,1420,0,1962,235000.0
3.0,1.0,1790,1.0,0,0,1790,0,1937,225000.0
3.0,1.0,1790,1.0,0,0,1790,0,1937,302100.0
2.0,1.0,1340,1.0,0,0,890,450,1939,520000.0
2.0,1.0,1010,1.0,0,0,1010,0,1975,285000.0
3.0,2.0,1640,1.0,0,0,1640,0,1981,525000.0
5.0,2.75,2980,1.0,0,0,1540,1440,1982,374900.0
3.0,2.0,1370,1.0,0,0,1130,240,1926,377500.0
3.0,2.25,2190,1.5,0,1,2190,0,1927,587450.0
3.0,2.25,1530,1.0,0,0,1070,460,1979,245000.0
3.0,2.0,1290,1.0,0,0,1290,0,1994,200000.0
4.0,3.75,5150,2.0,0,3,4360,790,1997,2140000.0
3.0,2.5,2470,2.0,0,0,2470,0,1991,607000.0
1.0,1.25,1810,1.5,1,4,1230,580,1967,1247000.0
4.0,2.5,2230,1.0,0,0,1180,1050,1981,549950.0
3.0,3.0,2300,1.0,0,0,2300,0,1960,250000.0
3.0,2.5,2030,2.0,0,0,2030,0,1991,525000.0
3.0,1.75,2000,1.0,0,2,1480,520,1957,440000.0
3.0,2.75,3610,1.5,1,3,3130,480,1918,425000.0
5.0,2.5,3290,2.0,0,0,3290,0,2004,739900.0
3.0,2.0,1300,1.0,0,0,900,400,1993,315000.0
5.0,1.0,1880,1.5,0,0,1360,520,1917,340000.0
4.0,2.75,2170,2.0,0,0,2170,0,1995,366000.0
3.0,1.75,1680,1.0,0,0,930,750,1952,315000.0
3.0,1.5,1190,1.0,0,0,1190,0,1959,299000.0
2.0,1.0,940,1.0,0,0,940,0,1950,350000.0
2.0,1.75,1010,1.0,0,0,670,340,2003,340000.0
3.0,1.75,1290,1.0,0,0,1290,0,1962,460000.0
3.0,1.5,1480,1.0,0,0,1480,0,1957,224000.0
2.0,1.0,900,1.0,0,0,900,0,1940,140000.0
4.0,2.0,1400,1.5,0,0,1400,0,1930,246000.0
3.0,2.5,2040,2.0,0,0,2040,0,1995,330000.0
3.0,1.0,1450,1.0,0,0,1010,440,1969,306000.0
3.0,1.0,1210,1.0,0,0,1210,0,1949,324950.0
2.0,1.5,1800,1.0,0,0,1240,560,1987,345000.0
3.0,1.0,1490,1.0,0,0,1490,0,1954,207000.0
3.0,1.0,1240,1.5,0,0,1240,0,1953,238000.0
3.0,2.0,2632,2.0,0,3,2632,0,2000,695000.0
3.0,2.5,2150,2.0,0,0,2150,0,1979,649950.0
3.0,2.75,1710,1.0,0,0,1010,700,1947,515000.0
3.0,2.5,1530,2.0,0,0,1530,0,1998,452000.0
4.0,2.5,1630,2.0,0,0,1630,0,2003,236000.0
4.0,3.5,4080,2.0,0,2,3210,870,1998,1285000.0
3.0,2.75,2340,1.0,0,0,1500,840,1972,563000.0
3.0,1.75,1000,1.0,0,0,1000,0,1967,410988.0
,2.5,2290,2.0,0,0,2290,0,1985,339950.0
4.0,2.5,3180,2.0,0,0,3180,0,1986,1200000.0
4.0,2.5,2170,2.0,0,0,2170,0,1992,340000.0
4.0,3.25,3020,1.0,0,0,3020,0,1956,808100.0
3.0,1.75,1330,1.0,0,0,1330,0,1998,236000.0
4.0,1.75,1720,1.0,0,0,1720,0,1965,330000.0
4.0,3.5,2540,2.0,0,0,1820,720,1910,799990.0
,2.5,1810,2.0,0,0,1810,0,2003,240000.0
3.0,1.0,1410,1.0,0,0,1410,0,1960,343000.0
3.0,2.5,1530,1.0,0,0,1270,260,1993,332000.0
5.0,3.5,4380,2.0,0,0,4380,0,2003,945000.0
3.0,1.0,1140,1.0,0,0,1140,0,1943,239950.0
5.0,1.75,2110,1.5,0,0,1250,860,1946,674000.0
3.0,1.0,1050,1.0,0,0,1050,0,1967,200000.0
3.0,1.75,1600,1.0,0,0,1600,0,1966,453000.0
3.0,1.75,1430,1.0,0,0,1430,0,1950,330000.0
4.0,2.5,1996,2.0,0,0,1996,0,2009,285000.0
4.0,1.75,1530,1.0,0,0,910,620,1948,338000.0
2.0,1.0,1000,1.0,0,0,1000,0,1951,264950.0
4.0,2.0,2530,1.0,0,0,1350,1180,1954,880000.0
3.0,1.5,970,1.0,0,0,970,0,1976,209500.0
4.0,2.5,2400,1.0,0,0,1310,1090,1958,380000.0
3.0,2.0,1830,1.0,0,0,1830,0,1994,336500.0
3.0,2.25,2130,1.0,0,0,1290,840,1983,360000.0
4.0,3.25,3330,2.0,0,0,3330,0,1924,911100.0
2.0,1.0,560,1.0,0,0,560,0,1944,249900.0
4.0,1.0,1210,1.0,0,0,1210,0,1962,175000.0
3.0,2.5,2380,3.0,0,3,2380,0,1988,549950.0
3.0,1.75,1370,1.0,0,0,1370,0,1945,225000.0
3.0,1.75,1370,1.0,0,0,1370,0,1945,270000.0
3.0,2.25,1740,2.0,0,0,1740,0,1980,400000.0
2.0,1.0,790,1.0,0,0,790,0,1925,299800.0
3.0,2.5,2480,2.0,0,0,2480,0,1989,555000.0
3.0,2.5,1920,2.0,0,0,1920,0,1988,230000.0
4.0,2.5,2750,2.0,0,0,2750,0,2002,360000.0
2.0,1.0,880,1.0,0,0,880,0,1910,415000.0
4.0,1.75,2160,1.0,0,0,1660,500,1976,355000.0
4.0,2.5,2570,2.0,0,0,2570,0,1997,635000.0
5.0,2.75,2130,1.0,0,0,1100,1030,1978,353000.0
7.0,4.0,3150,1.0,0,0,3150,0,1957,999000.0
3.0,1.5,1780,1.0,0,0,1270,510,1967,265000.0
4.0,1.75,1910,1.0,0,0,1910,0,1959,250000.0
2.0,1.0,1170,1.0,0,0,1170,0,1951,225000.0
2.0,1.0,900,1.0,0,0,900,0,1944,553000.0
5.0,2.5,2650,1.0,0,0,1400,1250,1961,565000.0
2.0,1.0,1170,1.0,0,0,980,190,1907,312000.0
3.0,2.5,2630,2.0,0,0,2630,0,1991,475000.0
4.0,2.75,2150,1.0,0,0,1340,810,1992,320000.0
3.0,2.0,1430,1.0,0,0,1430,0,1964,453000.0
3.0,1.0,960,1.0,0,0,960,0,1910,320000.0
4.0,2.75,2640,1.0,0,2,1440,1200,1947,610000.0
3.0,1.5,1490,1.0,0,0,1490,0,1959,385000.0
3.0,1.75,1210,1.0,0,0,1210,0,1983,215000.0
4.0,1.5,1860,1.5,0,0,1860,0,1920,215000.0
3.0,2.5,1980,2.0,0,0,1980,0,2003,415000.0
1.0,1.0,900,1.0,0,0,900,0,1947,350000.0
1.0,1.0,900,1.0,0,0,900,0,1947,395000.0
2.0,1.75,1490,1.0,0,0,1490,0,1963,898000.0
3.0,2.5,2980,2.0,0,0,2980,0,2006,480000.0
3.0,2.5,2660,3.0,0,3,1870,790,2007,1240000.0
4.0,2.5,2790,2.0,0,0,2790,0,1989,599000.0
4.0,3.0,2800,2.0,0,0,2800,0,1999,770000.0
3.0,2.25,1590,2.0,0,0,1590,0,1980,1208000.0
4.0,2.25,3240,1.0,0,0,2080,1160,1953,1590000.0
3.0,2.0,2130,1.0,0,0,2130,0,1989,880000.0
3.0,2.0,1510,1.0,0,0,1510,0,1942,332000.0
3.0,1.75,1750,1.0,0,0,1750,0,1966,445000.0
4.0,2.75,4010,2.0,0,0,4010,0,2004,849000.0
4.0,1.5,1650,1.5,0,0,1650,0,1903,752000.0
9.0,7.5,4050,2.0,0,0,4050,0,1996,450000.0
3.0,1.0,1320,1.0,0,0,1320,0,1955,420000.0
4.0,2.5,2310,2.0,0,0,2310,0,1997,330000.0
3.0,1.75,1440,1.0,0,0,1440,0,1972,409000.0
5.0,1.75,2330,1.0,0,0,1180,1150,1968,350000.0
4.0,2.5,2430,1.0,0,0,2430,0,1994,570000.0
3.0,1.0,1390,1.0,0,0,1390,0,1982,315000.0
2.0,1.0,1150,1.0,0,0,1060,90,1930,224000.0
4.0,1.75,2120,1.0,0,0,1370,750,1965,293550.0
4.0,2.75,2300,1.5,0,0,1340,960,1966,350000.0
4.0,2.5,3320,2.0,0,3,3320,0,1988,1108000.0
4.0,2.5,2400,2.0,0,0,2400,0,1997,442500.0
3.0,2.5,3580,1.0,0,0,3240,340,1992,616500.0
3.0,2.5,2100,1.0,0,0,1700,400,1989,506400.0
3.0,2.25,1550,2.0,0,0,1550,0,2001,324000.0
3.0,1.5,1570,1.5,0,0,1570,0,1931,169000.0
3.0,2.0,1480,1.0,0,0,750,730,1928,595000.0
3.0,2.5,2720,2.0,0,0,2720,0,2002,299900.0
3.0,2.25,2270,1.0,0,0,1380,890,1977,332000.0
4.0,1.75,2410,1.0,0,0,1600,810,1978,432000.0
4.0,2.75,2730,1.0,0,2,1740,990,1996,510000.0
3.0,2.5,1540,2.0,0,0,1540,0,1986,270000.0
5.0,2.5,3120,2.0,0,4,3120,0,1986,750000.0
2.0,1.5,1480,1.0,0,0,930,550,1914,509250.0
3.0,1.0,860,1.0,0,0,860,0,1969,189000.0
4.0,2.5,2180,2.0,0,0,2180,0,1999,726500.0
3.0,2.0,1300,1.5,0,0,1300,0,1933,287000.0
4.0,3.5,3420,2.0,0,0,3420,0,2004,679000.0
3.0,2.25,2130,1.0,0,0,1570,560,1987,316000.0
4.0,2.5,2300,2.0,0,0,2300,0,1992,498000.0
4.0,1.75,2560,1.0,0,0,1480,1080,1979,448000.0
2.0,1.0,1040,1.0,0,0,1040,0,1951,535000.0
4.0,3.0,3080,2.0,0,1,3080,0,1990,560000.0
4.0,2.25,2670,1.0,0,0,1610,1060,1975,437850.0
4.0,2.75,3270,2.0,0,0,2720,550,1983,435000.0
4.0,2.5,2610,2.0,0,0,2610,0,1998,510000.0
3.0,2.5,2460,2.0,0,0,2460,0,1980,520000.0
2.0,1.5,1930,2.0,0,0,1930,0,1989,509000.0
3.0,1.0,1220,1.0,0,0,1220,0,1905,575000.0
4.0,2.5,2030,1.0,0,0,1330,700,1969,365000.0
3.0,2.0,2420,1.0,0,1,1500,920,1979,795000.0
3.0,2.5,1870,2.0,0,0,1870,0,2005,285000.0
3.0,2.25,3020,2.0,0,0,2720,300,1969,955000.0
4.0,2.5,2880,2.0,0,4,2050,830,1955,775000.0
4.0,3.0,1810,2.0,0,0,1810,0,1997,400000.0
4.0,2.5,2590,2.0,0,0,2590,0,1991,570000.0
5.0,3.25,3830,2.0,0,0,3830,0,2014,955990.0
3.0,2.25,3250,1.0,0,0,2260,990,2006,1150000.0
4.0,2.0,2760,1.0,0,0,2120,640,1979,459950.0
2.0,1.75,1220,1.0,0,0,1220,0,1942,245000.0
3.0,1.5,1280,3.0,0,0,1280,0,2003,281000.0
3.0,0.75,770,1.0,0,0,770,0,1942,205000.0
3.0,1.75,1520,1.0,0,0,1520,0,1968,290000.0
4.0,2.5,2080,1.0,0,0,2080,0,1954,635000.0
1.0,1.0,570,1.0,0,0,570,0,1918,310000.0
4.0,2.0,1500,1.0,0,0,830,670,1906,470000.0
2.0,2.5,2510,2.0,0,0,2510,0,1990,600000.0
4.0,2.0,1980,1.0,0,0,1980,0,1969,279000.0
3.0,3.5,2500,2.0,0,0,2500,0,2000,538500.0
4.0,2.5,2720,2.0,0,0,2720,0,1989,594950.0
2.0,1.0,910,1.0,0,0,910,0,1953,533050.0
3.0,1.75,1480,1.0,0,0,1480,0,1974,510000.0
4.0,2.25,2470,1.0,0,0,1270,1200,1974,360000.0
2.0,1.0,1650,1.0,0,0,1090,560,1960,435000.0
3.0,1.75,1700,1.0,0,0,1700,0,1967,559000.0
2.0,1.5,1995,1.5,0,1,1995,0,1991,645000.0
2.0,1.0,1280,1.0,0,0,640,640,1919,340000.0
4.0,2.5,2980,2.0,0,0,2980,0,2001,565000.0
3.0,1.75,1730,1.0,0,0,1480,250,1941,575700.0
3.0,3.25,2420,2.0,0,2,1840,580,2006,1010000.0
3.0,2.0,2800,1.0,0,0,2320,480,1996,540500.0
5.0,4.0,1400,1.0,0,0,900,500,1954,265000.0
4.0,2.0,2070,1.0,0,1,1180,890,1941,699950.0
1.0,1.75,750,1.0,0,0,550,200,1946,355000.0
3.0,1.5,1460,1.0,0,0,1460,0,1954,381000.0
5.0,2.25,2140,1.0,0,2,1220,920,1962,564000.0
2.0,1.0,740,1.0,0,0,740,0,1942,114975.0
1.0,0.75,410,1.0,0,0,410,0,1953,325000.0
2.0,1.0,1570,1.0,0,3,1570,0,1953,299990.0
5.0,2.75,2860,2.0,0,0,2860,0,2006,751000.0
3.0,2.25,1400,2.0,0,0,1400,0,1984,425000.0
3.0,1.75,2700,1.0,0,2,1560,1140,1947,665000.0
5.0,4.0,4460,2.0,0,4,3330,1130,1996,833450.0
7.0,1.5,2670,1.5,0,0,2320,350,1948,575000.0
3.0,1.75,1520,1.0,0,0,1520,0,1967,190000.0
3.0,1.75,1520,1.0,0,0,1520,0,1967,314950.0
2.0,2.0,1660,1.0,0,0,1120,540,1906,601150.0
2.0,1.0,860,1.0,0,0,860,0,1948,315000.0
2.0,1.5,2340,1.0,0,0,1280,1060,1954,545000.0
4.0,2.25,2110,2.0,0,0,2110,0,1979,565000.0
3.0,1.0,1010,1.0,0,0,1010,0,1954,175000.0
3.0,2.0,2330,2.5,0,0,2330,0,1987,530000.0
4.0,3.0,6430,2.0,0,0,6430,0,2001,4489000.0
3.0,1.75,1610,1.0,0,0,1310,300,1960,430000.0
3.0,1.75,1460,1.0,0,0,1460,0,1981,225000.0
5.0,4.0,2900,2.0,0,0,1950,950,1937,312000.0
3.0,1.0,1260,1.0,0,0,1260,0,1951,380000.0
2.0,1.0,1210,1.0,0,0,1210,0,1953,222200.0
5.0,3.5,3420,2.0,0,0,3420,0,2006,1438890.0
4.0,2.5,2120,2.0,0,0,2120,0,2002,329950.0
3.0,2.5,2460,1.0,0,0,2460,0,1992,995000.0
3.0,3.5,3790,2.0,0,0,3790,0,1993,929950.0
4.0,2.5,2350,1.0,0,0,2350,0,1987,692000.0
2.0,1.0,620,1.0,0,0,620,0,1911,402000.0
3.0,1.75,1920,1.0,0,0,1340,580,1962,510000.0
3.0,1.0,1050,1.0,0,0,1050,0,1959,249000.0
3.0,1.5,1360,1.0,0,0,1360,0,1966,244900.0
3.0,1.0,1180,1.0,0,0,1180,0,1944,289900.0
4.0,1.0,1560,1.0,0,0,1170,390,1939,552500.0
4.0,2.5,3300,2.0,0,0,3300,0,1984,760000.0
2.0,2.75,1100,2.0,0,0,750,350,2006,440000.0
3.0,1.75,1770,1.0,0,0,1090,680,1954,286000.0
3.0,1.0,1200,1.0,0,0,800,400,1950,260000.0
2.0,2.25,1330,2.0,0,0,1330,0,1985,355000.0
3.0,1.75,1570,1.0,0,0,1570,0,1959,318000.0
2.0,1.0,1610,1.0,0,0,1610,0,1952,255000.0
3.0,1.0,1100,1.0,0,0,1100,0,1978,139000.0
4.0,2.25,1810,2.0,0,0,1810,0,1976,485000.0
3.0,1.75,2930,2.0,0,0,2440,490,1995,549950.0
3.0,1.5,1780,1.5,0,0,1780,0,1916,588000.0
3.0,2.5,3050,1.5,0,0,1950,1100,1950,975000.0
3.0,2.0,1540,2.0,0,0,1540,0,2005,402000.0
3.0,1.0,1380,1.0,0,0,1380,0,1959,245000.0
3.0,1.75,1890,1.5,0,3,1890,0,1976,445000.0
3.0,1.75,1570,1.0,0,0,1570,0,1991,195000.0
5.0,2.0,2540,1.0,0,0,1480,1060,1962,385000.0
3.0,1.5,1520,1.0,0,0,1000,520,1955,450000.0
4.0,2.5,2780,2.0,0,0,2780,0,2004,1090000.0
2.0,1.0,1730,2.0,0,0,1730,0,1945,396675.0
5.0,2.25,2340,1.0,0,0,1170,1170,1951,242000.0
3.0,1.75,1300,1.0,0,0,1300,0,1943,380000.0
2.0,1.0,1420,2.0,0,0,1420,0,1941,496000.0
3.0,2.5,1470,2.0,0,0,1470,0,1980,399950.0
4.0,2.5,2850,2.0,0,0,2850,0,1998,895000.0
3.0,2.0,2360,2.0,0,3,1560,800,1926,690000.0
3.0,1.5,1610,2.0,0,0,1610,0,1927,270000.0
3.0,2.0,2420,1.0,0,0,1210,1210,1949,349900.0
3.0,2.5,1470,2.0,0,0,1170,300,2004,454280.0
3.0,2.5,1410,1.0,0,0,1410,0,1992,390000.0
3.0,1.75,1840,1.0,0,0,1840,0,1983,275000.0
4.0,2.5,2450,2.0,0,0,2450,0,1990,300000.0
3.0,1.75,1500,1.0,0,0,850,650,1940,700000.0
3.0,1.75,2080,1.0,0,0,1280,800,1950,520000.0
3.0,2.5,2770,2.0,0,0,2770,0,1987,715000.0
3.0,2.5,2370,2.0,0,0,2370,0,2006,404000.0
3.0,2.0,3000,2.0,0,0,1970,1030,1998,490500.0
6.0,2.75,4430,2.0,0,3,2680,1750,1964,1485000.0
4.0,1.75,1550,1.0,0,0,1550,0,1944,557800.0
4.0,2.25,2290,1.0,0,2,1550,740,1959,571000.0
4.0,2.5,2560,2.0,0,0,2560,0,2006,410000.0
3.0,1.5,1240,1.0,0,0,1240,0,1971,225000.0
4.0,2.5,2590,2.0,0,0,2590,0,2004,700000.0
3.0,1.0,1370,1.5,0,0,1370,0,1905,500000.0
2.0,2.0,1360,1.0,0,0,680,680,1925,536500.0
3.0,2.5,2060,1.0,0,0,1600,460,1980,330000.0
3.0,1.75,1120,1.0,0,0,1120,0,1976,249950.0
4.0,1.75,1630,1.5,0,0,1630,0,1943,249000.0
3.0,1.75,1590,1.5,0,0,1590,0,1909,249000.0
4.0,1.75,2480,1.0,0,0,1390,1090,1950,780000.0
4.0,2.5,2700,2.0,0,0,2700,0,2004,1200000.0
3.0,1.75,1930,1.0,0,0,1110,820,1975,434500.0
4.0,2.0,2490,1.0,0,0,2490,0,2002,590000.0
2.0,1.0,1000,1.0,0,0,1000,0,1910,417200.0
4.0,2.25,2130,2.0,0,0,2130,0,1976,649990.0
2.0,1.0,1060,1.0,0,0,960,100,1926,506000.0
3.0,2.5,1730,2.0,0,0,1730,0,1999,348000.0
4.0,2.5,2810,2.0,0,0,2810,0,1998,301000.0
2.0,1.0,880,1.0,0,0,880,0,1940,427550.0
3.0,1.0,1040,1.5,0,0,1040,0,1951,361000.0
2.0,2.5,1830,1.0,0,0,930,900,1946,460000.0
4.0,3.5,1800,2.0,0,2,1800,0,1984,958000.0
5.0,1.75,2460,1.5,0,0,1340,1120,1911,445000.0
3.0,2.5,1670,2.0,0,0,1670,0,1999,373000.0
4.0,2.25,2660,1.0,0,0,1750,910,1977,525000.0
3.0,2.5,2850,2.0,0,0,2850,0,1997,364988.0
2.0,1.0,820,1.0,0,0,820,0,1941,324000.0
4.0,3.0,2350,1.0,0,0,1490,860,1960,625000.0
3.0,1.75,1480,1.0,0,0,1480,0,1980,237500.0
6.0,2.25,2930,1.0,0,0,1730,1200,1965,429300.0
3.0,1.0,1250,1.0,0,0,1030,220,1949,155000.0
4.0,2.75,2760,1.5,0,2,1780,980,1940,614000.0
3.0,2.5,2380,2.0,0,0,2380,0,2014,650000.0
3.0,2.0,1730,1.0,0,0,1730,0,1986,625000.0
3.0,2.25,1670,1.0,0,0,1670,0,1961,587100.0
4.0,2.5,2150,2.0,0,0,2150,0,1991,380000.0
2.0,1.0,930,1.0,0,0,730,200,1917,479500.0
1.0,1.0,620,1.0,0,0,620,0,1900,382888.0
4.0,4.25,1960,2.0,0,0,1960,0,1940,540000.0
4.0,2.75,2550,1.0,0,0,1700,850,1972,691000.0
3.0,2.0,1990,1.0,0,0,1130,860,1912,760500.0
4.0,2.5,3550,2.0,0,0,3550,0,2006,685000.0
3.0,1.0,860,1.0,0,0,860,0,1955,199129.0
3.0,3.0,2031,2.0,0,0,2031,0,1988,335000.0
3.0,2.0,1590,1.0,0,0,1590,0,1974,305100.0
4.0,2.25,3010,1.0,0,0,3010,0,1959,830000.0
3.0,2.5,2610,2.0,0,0,2610,0,1993,810000.0
3.0,2.25,1440,1.0,0,0,1180,260,1988,500000.0
3.0,1.75,1920,1.0,0,2,960,960,1947,490000.0
2.0,1.75,1670,2.0,0,0,1670,0,1912,490000.0
4.0,1.75,1390,1.0,0,0,1030,360,1960,272000.0
3.0,2.25,2140,2.0,0,0,2140,0,1979,280000.0
3.0,1.0,1250,1.5,0,0,1250,0,1955,233000.0
3.0,1.0,1080,1.0,0,0,1080,0,1952,275000.0
3.0,3.25,2760,2.0,0,2,2110,650,1991,375000.0
3.0,2.75,2180,2.0,0,0,2180,0,2004,445000.0
3.0,2.5,1260,3.0,0,0,1260,0,2002,437500.0
4.0,1.0,1610,1.5,0,0,1510,100,1905,426250.0
3.0,1.5,2450,1.0,0,0,2450,0,1967,358000.0
4.0,3.5,4150,2.0,0,0,4150,0,2003,1175000.0
2.0,1.0,960,1.0,0,0,960,0,1939,305000.0
2.0,1.75,1340,1.0,0,0,1340,0,2004,415000.0
11.0,3.0,3000,2.0,0,0,2400,600,1918,520000.0
4.0,3.5,3080,2.0,0,0,3080,0,2003,733000.0
3.0,1.0,1130,1.0,0,0,1130,0,1954,411500.0
3.0,1.75,2280,1.5,0,0,1760,520,1909,540000.0
3.0,1.5,1952,1.0,0,0,1652,300,1960,270500.0
2.0,1.5,1280,2.0,0,0,1200,80,1998,422250.0
5.0,3.25,3690,2.0,0,0,3690,0,1977,655000.0
5.0,3.25,4610,2.0,0,3,3310,1300,2006,1200000.0
3.0,2.5,2920,2.5,0,0,2920,0,1990,550000.0
2.0,2.25,1230,2.0,0,0,1020,210,2004,460000.0
4.0,1.5,1580,1.0,0,0,790,790,1944,159075.0
2.0,1.0,1220,1.5,0,0,1220,0,1908,470000.0
2.0,1.0,1020,1.0,0,0,1020,0,1939,235000.0
2.0,1.5,1510,1.0,0,0,1510,0,1961,309950.0
4.0,1.75,1830,1.0,0,0,1010,820,1966,433000.0
3.0,2.5,2750,1.0,0,3,1650,1100,1967,895000.0
3.0,1.5,1860,1.0,0,0,1140,720,1967,291000.0
3.0,2.5,2720,2.0,0,0,2720,0,1988,835000.0
2.0,1.0,1360,1.0,0,0,1200,160,1936,640000.0
3.0,2.25,2340,1.0,0,0,1340,1000,1965,438000.0
4.0,2.5,2600,2.0,0,0,2600,0,2005,540000.0
4.0,2.5,2090,1.0,0,0,1090,1000,1993,325000.0
4.0,1.75,2260,1.5,0,0,1360,900,1924,380000.0
2.0,1.0,1390,1.0,0,0,930,460,1947,510000.0
4.0,2.5,2300,2.0,0,0,2300,0,2004,380000.0
4.0,2.5,2810,1.0,0,0,1710,1100,1973,825000.0
4.0,3.25,4060,2.0,0,0,4060,0,1996,880000.0
3.0,3.0,2790,2.0,1,4,2370,420,1933,1800000.0
3.0,1.0,1290,1.5,0,0,1290,0,1930,790000.0
2.0,1.5,720,1.0,0,0,720,0,1942,287000.0
3.0,3.0,2130,1.5,0,0,1570,560,1913,509000.0
3.0,2.25,1750,1.0,0,0,1350,400,1965,270000.0
3.0,2.0,960,1.0,0,0,960,0,1949,210000.0
3.0,1.0,1570,1.5,0,0,1570,0,1930,415000.0
3.0,2.5,3070,1.0,0,3,1720,1350,1985,550000.0
4.0,2.5,2920,1.0,0,3,2030,890,1957,1250000.0
3.0,1.0,1870,1.0,0,0,1120,750,1955,499950.0
3.0,1.5,1540,2.0,0,0,1540,0,1907,659000.0
2.0,1.5,1440,2.0,0,0,1440,0,1990,265000.0
4.0,3.75,2810,2.0,0,2,2070,740,1994,492000.0
4.0,2.5,2450,1.0,0,0,1250,1200,1958,715000.0
2.0,1.0,1330,1.5,0,0,1330,0,1925,175000.0
4.0,3.5,3130,2.0,0,0,2430,700,2011,975000.0
1.0,1.0,730,1.0,0,0,730,0,1945,306950.0
4.0,2.0,2480,1.5,0,0,1470,1010,1916,630000.0
3.0,1.0,1270,1.0,0,0,1270,0,1969,367500.0
3.0,3.25,2230,1.0,0,1,1430,800,1977,699950.0
3.0,3.0,2880,2.0,0,0,2220,660,1909,1000000.0
4.0,2.5,2434,2.0,0,0,2434,0,2007,285000.0
2.0,1.5,1120,2.0,0,0,1000,120,2004,215000.0
4.0,2.5,4080,2.0,0,0,4080,0,2001,1050000.0
4.0,2.75,3720,1.0,0,4,1960,1760,1962,1370000.0
3.0,1.0,1430,1.5,0,0,1010,420,1930,235000.0
3.0,2.0,1560,1.0,0,0,790,770,1923,604000.0
3.0,1.75,1700,1.0,0,0,1460,240,1947,750000.0
4.0,2.25,2510,1.0,0,0,2200,310,1967,800000.0
5.0,2.0,2600,1.5,0,0,1400,1200,1914,580000.0
1.0,1.0,790,1.0,0,0,790,0,1911,350000.0
4.0,2.0,1710,2.0,0,0,1320,390,1956,353750.0
5.0,2.75,2660,1.0,0,4,1470,1190,1969,1100000.0
4.0,2.0,1470,1.0,0,0,1470,0,1963,465000.0
3.0,2.0,2350,1.5,0,0,1780,570,1929,568000.0
5.0,2.0,2440,2.0,0,0,2440,0,1910,1005000.0
3.0,1.5,1150,1.0,0,0,1150,0,1961,213500.0
3.0,2.5,1510,1.0,0,0,1030,480,1976,250000.0
2.0,1.0,870,1.0,0,0,870,0,1942,357000.0
2.0,2.0,1280,2.0,0,0,1280,0,1918,425000.0
3.0,2.5,2600,2.0,0,0,2600,0,1988,571000.0
3.0,2.25,2030,1.0,0,0,1190,840,1977,588000.0
4.0,1.5,1930,2.0,0,0,1930,0,1979,275000.0
3.0,2.75,3210,2.0,0,1,3210,0,1998,565000.0
3.0,1.75,1970,1.0,0,0,1370,600,1961,460000.0
4.0,2.5,4060,1.0,0,4,2150,1910,1977,603500.0
3.0,2.5,3316,2.0,0,0,3316,0,1986,490600.0
2.0,2.0,1460,1.0,0,2,1460,0,1900,1010000.0
4.0,2.0,2100,1.0,0,0,2100,0,1972,500000.0
4.0,2.25,1830,2.0,0,0,1830,0,1990,249000.0
3.0,2.0,1530,1.0,0,0,1530,0,1970,235000.0
4.0,2.0,1490,1.0,0,0,1490,0,1942,410000.0
2.0,1.0,860,1.0,0,0,860,0,1952,370000.0
5.0,2.5,2130,1.0,0,0,1330,800,1968,360000.0
5.0,2.25,3580,2.0,0,0,3580,0,1966,1406890.0
4.0,2.5,2420,2.0,0,0,2420,0,2003,298000.0
4.0,2.25,1900,1.0,0,0,1370,530,1977,485000.0
3.0,1.75,1330,1.0,0,0,1330,0,1960,400000.0
3.0,2.5,2150,2.0,0,0,2150,0,2003,580000.0
2.0,2.5,1370,2.0,0,0,1080,290,2009,355000.0
3.0,2.5,2430,2.0,0,0,2430,0,1992,650000.0
4.0,1.0,1640,1.0,0,2,1220,420,1943,261490.0
3.0,1.0,1010,1.0,0,0,1010,0,1968,347000.0
3.0,1.0,1500,1.5,0,0,1370,130,1926,485000.0
3.0,2.5,1740,2.0,0,0,1180,560,2012,601000.0
3.0,3.25,2090,1.0,0,0,1510,580,1989,380000.0
3.0,3.0,1850,2.0,0,0,1850,0,1976,565000.0
3.0,2.5,2790,2.0,0,0,2790,0,1993,750000.0
3.0,2.25,1480,1.0,0,0,1190,290,1975,291000.0
3.0,2.5,2280,2.0,0,0,2280,0,1987,560000.0
4.0,2.25,3180,2.0,0,0,3180,0,1984,725000.0
3.0,2.0,2350,1.0,0,0,2350,0,1993,539000.0
5.0,3.25,3910,2.0,0,0,2710,1200,2000,470000.0
2.0,1.0,770,1.0,0,0,770,0,1947,264950.0
4.0,1.5,1780,2.0,0,0,1080,700,1900,200000.0
5.0,2.5,2300,1.0,0,0,1170,1130,1967,453500.0
2.0,2.5,2510,2.0,0,0,2510,0,1943,811000.0
3.0,3.25,1410,3.0,0,0,1410,0,2005,425000.0
4.0,2.25,4250,1.0,0,2,2380,1870,1974,1530000.0
4.0,2.75,2560,1.0,0,0,1860,700,1980,562000.0
3.0,2.5,1760,2.0,0,0,1760,0,1992,281000.0
3.0,2.25,2100,2.0,0,0,2100,0,1979,270000.0
3.0,1.0,1490,1.0,0,0,1490,0,1963,205950.0
2.0,1.0,870,1.0,0,0,870,0,1950,310000.0
3.0,1.75,1260,2.0,0,0,1260,0,2003,350000.0
4.0,2.0,2630,2.0,0,0,2630,0,1953,843500.0
4.0,2.0,1950,1.0,0,0,1160,790,1908,370000.0
4.0,2.0,2200,1.0,0,0,1100,1100,1979,279000.0
3.0,1.75,1600,1.0,0,0,1600,0,1960,408000.0
3.0,1.0,1230,1.0,0,0,1230,0,1952,392000.0
2.0,1.0,1030,1.0,0,0,1030,0,1917,455000.0
2.0,1.5,1040,1.0,0,0,870,170,1965,310000.0
3.0,3.0,2240,2.0,0,0,2240,0,1943,323500.0
3.0,1.0,1600,1.0,0,2,800,800,1944,364500.0
4.0,2.0,2190,1.0,0,0,1180,1010,1977,280000.0
3.0,1.75,1899,2.0,0,0,1899,0,1943,289900.0
3.0,1.0,1870,1.5,0,0,1580,290,1927,585000.0
3.0,2.5,1730,1.0,0,0,1360,370,1990,269000.0
3.0,2.25,1860,2.0,0,0,1860,0,1994,280000.0
3.0,1.75,1940,1.0,0,0,1290,650,1965,287000.0
2.0,1.0,670,1.0,0,0,670,0,1926,183000.0
3.0,1.0,1820,1.0,0,0,1040,780,1961,309000.0
4.0,2.5,3810,2.0,0,0,3810,0,2003,920000.0
5.0,2.25,2060,2.5,0,0,2060,0,1907,815241.0
3.0,1.75,1520,1.0,0,0,1140,380,1975,405000.0
5.0,3.5,3450,2.0,0,3,3450,0,2001,525000.0
2.0,1.0,830,1.0,0,0,830,0,1943,150000.0
4.0,1.75,1880,1.0,0,0,1020,860,1946,240000.0
4.0,2.25,2200,1.5,0,0,1300,900,1920,698000.0
3.0,2.0,1800,1.0,0,0,1800,0,1982,440000.0
3.0,1.0,1200,1.5,0,0,1200,0,1936,204000.0
3.0,2.0,2220,1.0,0,2,1220,1000,1947,875000.0
3.0,1.5,1380,1.0,0,0,1380,0,1960,650000.0
3.0,1.0,1660,1.0,0,0,1660,0,1947,392500.0
4.0,1.0,2320,1.5,0,0,1310,1010,1921,400000.0
3.0,2.25,2800,1.0,0,0,1420,1380,1971,653000.0
4.0,1.0,1210,1.5,0,0,1210,0,1900,452000.0
4.0,2.5,2331,2.0,0,0,2331,0,2007,345000.0
4.0,1.75,1820,1.0,0,2,1320,500,1952,350000.0
4.0,2.5,2860,2.0,0,0,2860,0,2004,650000.0
5.0,3.0,2750,1.5,0,0,1750,1000,1926,525000.0
5.0,3.0,2750,1.5,0,0,1750,1000,1926,840000.0
3.0,2.5,2280,2.0,0,3,2280,0,1926,1325000.0
4.0,2.0,1610,1.0,0,0,1610,0,1989,259950.0
5.0,3.5,3760,2.0,0,0,3150,610,1969,998000.0
3.0,3.0,2940,2.0,0,0,2230,710,1988,1070000.0
4.0,3.0,4460,2.0,0,0,3140,1320,1955,1910000.0
3.0,1.5,1110,2.0,0,0,940,170,2007,190500.0
3.0,2.25,2560,1.0,0,0,1280,1280,1977,465000.0
3.0,1.0,1060,1.0,0,2,1060,0,1906,370000.0
6.0,4.5,2810,1.0,0,0,2010,800,1958,290000.0
3.0,1.75,1380,1.0,0,0,930,450,1950,350000.0
3.0,1.75,1380,1.0,0,0,930,450,1950,740000.0
3.0,1.75,2560,1.0,0,0,1970,590,1959,460000.0
3.0,1.0,1010,1.0,0,0,1010,0,1972,290000.0
3.0,1.5,1790,2.0,0,3,1790,0,1987,475000.0
3.0,2.5,1600,2.0,0,0,1600,0,2003,214000.0
2.0,1.0,910,1.0,0,0,910,0,1951,455000.0
3.0,2.5,2497,2.0,0,0,2497,0,2007,275000.0
3.0,1.5,1800,1.0,0,0,1800,0,1966,305000.0
5.0,2.5,2570,1.0,0,0,1470,1100,1981,449000.0
3.0,2.5,1320,1.0,0,0,660,660,1918,366000.0
3.0,2.5,1670,2.0,0,0,1670,0,2003,348000.0
4.0,2.5,2800,2.0,0,0,2800,0,2003,515000.0
4.0,2.5,3360,2.0,0,0,3360,0,1988,950000.0
3.0,2.5,2590,2.0,0,0,2590,0,1991,815000.0
3.0,3.0,1530,2.0,0,0,1530,0,1993,199950.0
3.0,2.0,1330,1.0,0,0,1330,0,1969,386000.0
3.0,2.25,2160,2.0,0,0,2160,0,1991,273000.0
4.0,2.5,1830,2.0,0,0,1830,0,1994,284000.0
3.0,1.0,1470,1.0,0,0,1070,400,1950,399950.0
3.0,1.75,1150,1.0,0,0,590,560,1927,285000.0
3.0,2.5,1790,2.0,0,0,1790,0,2004,315000.0
3.0,1.0,1700,1.0,0,0,1120,580,1960,250000.0
4.0,2.0,1630,1.5,0,0,1630,0,1967,290000.0
4.0,2.5,3420,2.0,0,0,3420,0,1988,725000.0
3.0,2.0,1650,1.5,0,0,1650,0,1983,410000.0
4.0,2.5,2810,1.5,0,0,2810,0,1988,855000.0
4.0,2.5,2710,2.0,0,0,2710,0,1994,399900.0
4.0,2.5,3320,2.0,0,0,2650,670,1977,852600.0
2.0,1.0,720,1.0,0,0,720,0,1940,235000.0
2.0,1.0,930,1.0,0,0,930,0,1912,230950.0
3.0,2.25,1490,2.0,0,0,1490,0,1997,230000.0
3.0,2.5,1690,2.0,0,0,1150,540,2014,404763.0
3.0,2.5,1720,2.0,0,0,1720,0,1992,245000.0
3.0,1.5,1140,1.0,0,0,1140,0,1964,188000.0
4.0,2.5,2280,2.0,0,0,2280,0,1987,626100.0
3.0,1.0,1100,1.0,0,0,900,200,1929,428750.0
4.0,2.25,1800,1.0,0,0,1360,440,1980,522000.0
4.0,2.5,2500,2.0,0,0,2500,0,1988,684000.0
3.0,2.25,2950,1.0,0,2,1520,1430,1983,1065500.0
1.0,1.0,1940,1.0,0,3,1940,0,1963,611206.0
2.0,1.0,1280,1.0,0,0,1140,140,1942,350000.0
4.0,2.5,3800,2.0,0,0,3800,0,1993,894000.0
2.0,1.0,930,1.0,0,0,930,0,1953,420000.0
5.0,2.0,1930,1.0,0,0,1020,910,1962,400000.0
3.0,3.0,2980,1.0,0,0,1820,1160,1981,675000.0
4.0,2.5,2800,2.0,0,0,2800,0,2004,426000.0
4.0,2.25,3190,2.0,0,0,2300,890,1984,750000.0
3.0,1.75,1710,1.0,0,0,1710,0,1958,368000.0
3.0,1.0,1980,1.0,0,0,1120,860,1950,342000.0
3.0,1.75,1910,1.0,0,0,1080,830,1959,700000.0
6.0,3.75,3160,2.0,0,0,3160,0,1989,848750.0
3.0,2.0,1590,1.0,0,0,1320,270,1939,720000.0
4.0,2.25,1890,1.0,0,0,1890,0,1967,525000.0
3.0,2.75,2500,1.0,0,0,1580,920,2000,397900.0
3.0,2.0,1740,1.0,0,0,1230,510,1989,405000.0
3.0,2.0,1080,1.0,0,0,1080,0,1986,392800.0
3.0,1.5,1730,1.0,0,0,1330,400,1958,394999.0
3.0,2.5,2480,2.0,0,0,2480,0,2004,340000.0
3.0,2.25,1450,2.0,0,0,980,470,2005,482500.0
4.0,2.5,2750,2.0,0,0,2750,0,1991,812500.0
3.0,2.5,2820,1.0,0,1,1410,1410,1954,450000.0
3.0,1.75,1830,1.0,0,0,1830,0,1954,398000.0
2.0,3.25,1550,3.0,1,3,1550,0,2006,1075000.0
2.0,2.0,1640,1.0,0,2,840,800,1959,540000.0
4.0,2.0,1720,1.0,0,0,860,860,1923,275000.0
5.0,2.0,2880,2.0,0,0,2880,0,1921,780000.0
3.0,1.5,1220,1.5,0,0,1220,0,1931,225000.0
3.0,3.0,1560,2.0,0,0,1560,0,2009,503045.0
2.0,2.0,1090,2.0,0,0,1090,0,1990,249000.0
4.0,1.0,1140,1.0,0,2,1140,0,1916,569950.0
2.0,2.25,1040,2.0,0,0,1040,0,2003,450000.0
4.0,2.0,2580,1.0,0,0,1300,1280,1950,1099500.0
4.0,2.5,2310,1.5,0,0,1490,820,1927,700000.0
3.0,2.5,1590,2.0,0,0,1590,0,1991,454000.0
3.0,1.75,1270,1.0,0,0,1270,0,1969,555000.0
3.0,1.5,1240,1.0,0,0,1240,0,1970,214000.0
3.0,2.5,2210,2.0,0,0,2210,0,1988,590000.0
3.0,1.75,2340,1.5,0,0,1510,830,1978,459900.0
3.0,1.5,1420,1.0,0,0,920,500,1987,205000.0
3.0,1.75,1430,1.0,0,2,1140,290,1980,390000.0
3.0,2.75,2470,2.0,0,0,2470,0,1960,970500.0
3.0,2.5,2390,2.0,0,0,2390,0,2000,790000.0
3.0,1.0,1120,1.0,0,0,1120,0,1969,320000.0
3.0,2.25,2700,2.0,0,0,1760,940,1907,552500.0
3.0,3.0,3490,2.5,0,0,3170,320,1924,1050000.0
3.0,1.0,1640,1.0,0,0,1640,0,1966,230000.0
3.0,1.75,1620,1.0,0,0,1110,510,1950,680000.0
3.0,1.75,1670,2.0,0,0,1670,0,1912,985000.0
4.0,2.5,1870,2.0,0,0,1870,0,1990,375000.0
2.0,1.5,1300,1.5,0,0,1300,0,1900,431000.0
3.0,2.5,2190,2.0,0,0,2190,0,1991,463000.0
3.0,1.75,1320,1.0,0,0,1320,0,1966,350000.0
3.0,1.0,1250,1.0,0,0,1250,0,1964,485000.0
4.0,1.75,2040,1.0,0,0,1360,680,1967,355000.0
3.0,1.75,2140,1.0,0,0,1070,1070,1910,603500.0
5.0,1.75,2510,1.5,0,0,2010,500,1920,860000.0
5.0,2.5,2200,2.0,0,0,2200,0,1996,259875.0
4.0,2.5,2170,1.0,0,0,1220,950,1959,685000.0
4.0,2.5,2980,2.0,0,0,2980,0,2003,382500.0
3.0,1.0,1180,1.5,0,0,1180,0,1902,490000.0
3.0,2.0,1540,1.0,0,0,1540,0,1953,229000.0
3.0,2.0,1540,1.0,0,0,1540,0,1953,430000.0
5.0,2.5,3110,1.0,0,0,1720,1390,1974,580000.0
3.0,1.75,1370,1.0,0,0,1370,0,1940,510000.0
5.0,2.25,2440,1.5,0,0,2440,0,1975,489990.0
3.0,2.25,1760,2.0,0,0,1330,430,1983,440000.0
3.0,2.5,2810,1.0,0,0,1750,1060,2006,479950.0
4.0,2.5,2500,1.0,0,0,2500,0,1997,806000.0
4.0,2.5,3220,2.0,0,0,3220,0,1996,875000.0
3.0,2.5,2880,2.0,0,0,2880,0,1992,710800.0
3.0,2.5,2700,2.0,0,0,2700,0,2004,565000.0
5.0,3.0,2680,2.0,0,0,1870,810,1995,359999.0
3.0,1.75,1780,1.0,0,0,920,860,1922,625000.0
3.0,2.5,2240,2.0,0,0,2240,0,1999,349950.0
4.0,2.0,1610,1.0,0,0,1610,0,1967,415000.0
2.0,2.0,1440,2.0,0,0,960,480,2004,435000.0
3.0,1.75,1550,2.0,0,0,1550,0,1948,225000.0
3.0,1.75,1720,1.0,0,0,1720,0,1954,770000.0
3.0,1.75,1740,1.0,0,0,1740,0,1959,340000.0
5.0,2.75,3280,1.0,0,0,2050,1230,1981,965000.0
3.0,2.75,2216,1.0,0,0,2216,0,1968,667000.0
1.0,1.0,1100,1.0,0,0,820,280,1947,250000.0
3.0,1.0,1180,1.0,0,0,1180,0,1948,397990.0
3.0,1.75,2020,1.0,0,0,1370,650,1952,535000.0
3.0,1.5,1150,1.0,0,0,1150,0,1951,265950.0
3.0,1.75,2090,1.0,0,0,1200,890,1986,258000.0
3.0,2.5,1300,3.0,0,0,1300,0,2005,505500.0
5.0,2.5,2240,1.0,0,0,1340,900,1978,455000.0
5.0,3.25,3540,1.0,0,2,2000,1540,2005,1348000.0
4.0,2.25,2840,1.0,0,0,1780,1060,1958,600000.0
4.0,2.5,2080,2.0,0,0,2080,0,1996,329800.0
2.0,1.0,1550,1.0,0,0,1550,0,1947,222000.0
4.0,2.5,1900,1.0,0,0,1900,0,1962,450000.0
3.0,3.5,2760,2.0,0,0,2120,640,2004,952000.0
4.0,2.0,1410,1.5,0,0,1410,0,1927,625000.0
2.0,1.0,1240,1.0,0,0,1240,0,1960,226800.0
5.0,4.25,4420,2.0,0,0,3510,910,2000,1205000.0
4.0,2.75,3390,1.0,0,0,1970,1420,1961,350000.0
3.0,1.75,1400,1.0,0,0,1400,0,1962,395000.0
5.0,3.0,2110,2.0,0,0,1670,440,2002,285000.0
3.0,1.0,1310,1.0,0,0,1310,0,1948,553000.0
3.0,1.0,1270,1.0,0,0,1270,0,1957,254000.0
2.0,1.5,2060,1.0,0,0,1190,870,1924,348140.0
4.0,2.75,2530,1.0,0,0,1280,1250,1977,354950.0
3.0,2.75,1900,1.0,0,0,1410,490,1942,706000.0
4.0,2.5,2910,2.0,0,0,2910,0,2006,499000.0
3.0,1.5,1900,1.5,0,0,1300,600,1971,427500.0
5.0,3.5,2880,2.0,0,3,1980,900,1991,439000.0
4.0,2.5,2820,2.0,0,0,2820,0,1998,545000.0
3.0,1.0,1620,1.5,0,0,1620,0,1920,842000.0
4.0,2.5,3320,2.0,0,0,3320,0,1997,685000.0
4.0,3.5,3770,2.0,0,0,3770,0,2003,665000.0
2.0,1.0,1200,1.0,0,2,1200,0,1917,255000.0
5.0,2.25,2130,1.0,0,2,1240,890,1959,565000.0
5.0,1.75,1950,1.0,0,0,1050,900,1962,274000.0
3.0,2.0,1920,1.0,0,0,1510,410,1969,260000.0
4.0,2.0,2510,1.0,0,0,1280,1230,1961,581000.0
3.0,1.5,1990,1.5,1,4,1990,0,1926,625000.0
3.0,1.0,1230,1.0,0,0,1230,0,1969,220000.0
3.0,2.25,3190,2.0,0,2,3190,0,1982,765000.0
6.0,4.25,5720,2.0,0,0,4170,1550,2004,1325000.0
8.0,2.5,2280,1.5,0,0,1210,1070,1911,700000.0
4.0,1.0,1550,1.0,0,0,1550,0,1959,351000.0
3.0,2.5,1690,2.0,0,0,1150,540,2014,413565.0
3.0,3.25,1651,2.0,0,0,1341,310,2008,363000.0
4.0,1.75,2260,1.0,0,0,1690,570,1962,679000.0
2.0,1.75,1510,1.0,0,0,1510,0,2005,473000.0
3.0,2.0,1490,1.0,0,0,1490,0,1966,585888.0
4.0,2.5,2220,2.0,0,0,2220,0,2001,405000.0
3.0,1.75,2800,1.0,1,4,1400,1400,1965,650000.0
4.0,2.5,2210,1.0,0,0,1210,1000,1975,415000.0
3.0,2.0,2150,1.0,0,0,1080,1070,1951,575000.0
3.0,2.25,1400,1.0,0,0,1140,260,1985,220000.0
4.0,3.0,2450,1.0,0,0,1580,870,1967,610000.0
3.0,1.0,980,1.0,0,0,760,220,1941,499950.0
4.0,2.5,2800,2.0,0,0,2170,630,1990,883000.0
2.0,1.0,1240,1.5,0,2,1240,0,1925,436000.0
3.0,2.5,1610,2.0,0,0,1240,370,2007,320000.0
3.0,1.75,1510,1.0,0,0,1240,270,1989,425000.0
4.0,2.0,1670,1.0,0,0,1670,0,1967,204700.0
6.0,3.0,2320,1.0,0,0,1200,1120,1987,384000.0
3.0,2.75,1900,2.0,0,0,1900,0,1984,314000.0
3.0,2.5,2390,2.0,0,0,2390,0,2003,535000.0
4.0,1.75,2110,1.0,0,0,2110,0,1979,568000.0
4.0,1.5,1470,1.0,0,0,810,660,1973,426000.0
4.0,2.75,2670,2.0,0,3,1630,1040,1908,675000.0
4.0,2.5,2540,2.0,0,0,1870,670,2000,380000.0
3.0,2.5,3450,3.0,0,0,2970,480,1927,685000.0
3.0,2.0,1700,1.0,0,0,1700,0,1991,429000.0
4.0,1.5,1810,1.0,0,0,1500,310,1968,799000.0
5.0,1.75,1550,1.0,0,0,1030,520,1978,318500.0
3.0,3.25,4110,2.0,0,0,2630,1480,2002,925000.0
3.0,1.5,2080,1.0,0,0,1300,780,1963,420000.0
2.0,1.0,1100,1.0,0,0,1100,0,1906,570000.0
4.0,2.75,3950,2.0,0,0,3950,0,1960,1052500.0
3.0,1.0,1250,1.0,0,0,1250,0,1954,333000.0
2.0,1.75,2620,2.0,1,4,2120,500,1931,1360000.0
3.0,2.5,2290,3.0,0,0,2290,0,1953,660000.0
6.0,4.5,3500,2.0,0,0,3500,0,1980,350000.0
6.0,4.5,3500,2.0,0,0,3500,0,1980,682500.0
5.0,2.75,1690,1.0,0,0,970,720,1943,399990.0
5.0,3.25,4500,2.0,0,4,3000,1500,1968,860000.0
2.0,1.0,1120,1.0,0,0,1120,0,1948,216180.0
4.0,2.25,1740,2.0,0,0,1740,0,1989,300000.0
3.0,1.0,1010,1.0,0,0,1010,0,1960,145000.0
3.0,1.0,1010,1.0,0,0,1010,0,1960,255000.0
3.0,1.75,1200,1.0,0,0,1200,0,1984,250000.0
3.0,1.0,1020,1.0,0,0,1020,0,1978,245000.0
3.0,1.75,1850,2.5,0,0,1850,0,1979,445000.0
3.0,1.5,1830,1.0,0,0,1830,0,1957,562000.0
4.0,1.0,2070,1.0,0,0,1160,910,1963,501000.0
3.0,1.75,1160,1.0,0,0,1160,0,1918,190000.0
4.0,2.75,3280,2.0,0,0,3280,0,1996,862500.0
5.0,2.5,2340,2.0,0,0,2340,0,1922,1085000.0
5.0,3.0,3690,1.0,0,2,2690,1000,1960,575000.0
1.0,1.0,720,1.0,0,0,720,0,1935,250000.0
7.0,1.5,2660,1.5,0,0,2660,0,1962,310000.0
5.0,3.25,4300,2.0,0,3,2910,1390,1957,1400000.0
3.0,1.5,1590,1.0,0,1,1090,500,1969,284850.0
4.0,2.5,2590,2.0,0,0,2590,0,2003,570000.0
3.0,1.75,1720,1.0,0,2,1000,720,1954,304000.0
4.0,2.5,1790,1.0,0,2,1240,550,1983,560000.0
3.0,1.0,1590,1.0,0,1,1090,500,1954,325000.0
4.0,2.0,1580,1.5,0,2,1580,0,1912,557510.0
4.0,2.25,2580,1.0,0,0,1620,960,1967,305000.0
5.0,1.0,1740,1.0,0,0,1740,0,1958,320000.0
5.0,2.25,3470,1.5,0,0,2790,680,1978,455000.0
3.0,1.0,1180,1.0,0,0,1180,0,1963,383001.0
3.0,1.75,1700,1.5,0,0,1700,0,1931,545000.0
2.0,1.0,1190,1.0,0,0,1190,0,1925,487500.0
5.0,2.5,2450,2.0,0,0,2450,0,2002,345000.0
6.0,2.75,2630,1.0,0,0,1650,980,1974,583000.0
3.0,2.25,2130,2.0,0,0,2130,0,1977,534950.0
4.0,1.0,1060,1.0,0,0,950,110,1904,403504.0
3.0,1.75,1480,1.5,0,0,1480,0,1946,500000.0
3.0,1.75,1610,1.0,0,0,1610,0,1990,319502.0
4.0,2.75,2440,2.0,0,0,1750,690,1960,525000.0
4.0,3.0,3100,2.0,0,0,2400,700,1996,563000.0
4.0,2.75,2890,1.5,0,0,1990,900,1911,898500.0
3.0,2.5,3240,2.0,0,0,3240,0,1991,651000.0
4.0,2.75,2900,2.0,0,0,2040,860,1911,450000.0
4.0,2.25,2650,1.0,0,0,1610,1040,1975,665000.0
4.0,2.5,2560,2.0,0,0,1610,950,1929,825000.0
3.0,1.0,1150,1.5,0,0,1150,0,1938,200000.0
3.0,2.0,1760,1.0,0,0,1760,0,1998,295000.0
4.0,2.5,3220,2.0,0,0,3220,0,2004,748000.0
3.0,2.5,3200,1.0,0,0,2660,540,1967,580000.0
3.0,1.0,1250,1.0,0,0,1250,0,1942,275000.0
3.0,1.0,1000,1.0,0,0,1000,0,1963,196000.0
2.0,1.0,740,1.0,0,0,740,0,1938,235750.0
3.0,2.25,2170,1.0,0,0,2170,0,1965,315000.0
4.0,2.5,2370,2.0,0,0,2370,0,1999,338000.0
4.0,2.5,2300,2.0,0,0,2300,0,2006,353000.0
3.0,1.75,1400,1.0,0,0,1400,0,1998,235000.0
3.0,2.5,3080,2.0,0,0,3080,0,1990,569999.0
4.0,2.25,2350,2.0,0,0,2350,0,1968,505000.0
4.0,3.0,2660,1.5,0,0,1820,840,1906,1234000.0
2.0,1.75,1250,1.0,0,0,1250,0,1950,299000.0
3.0,2.0,1100,1.0,0,0,1100,0,1991,240000.0
3.0,1.75,3330,1.0,1,4,1940,1390,1960,1955000.0
4.0,3.25,3640,2.0,0,2,1960,1680,1913,1265000.0
2.0,1.75,1350,2.0,0,0,1350,0,1986,405000.0
4.0,2.0,1310,1.0,0,0,1310,0,1953,304000.0
4.0,2.25,1800,2.0,0,0,1800,0,2003,272000.0
2.0,1.0,1260,1.0,0,0,690,570,1925,412000.0
4.0,2.5,2990,2.0,0,0,2990,0,2001,698000.0
2.0,1.0,1140,1.0,0,0,1140,0,1942,400000.0
3.0,2.5,2100,2.0,0,0,2100,0,1994,305000.0
4.0,2.0,2400,1.0,0,0,2400,0,1962,585000.0
2.0,1.5,1400,1.0,0,0,960,440,1982,190000.0
4.0,2.5,2990,2.0,0,0,2990,0,1988,760000.0
3.0,1.75,1930,1.0,0,0,1930,0,1977,570000.0
3.0,1.0,980,1.0,0,0,980,0,1946,144000.0
2.0,1.0,690,1.0,0,0,690,0,1942,139000.0
4.0,1.5,1430,1.5,0,0,1130,300,1945,525000.0
1.0,1.0,1110,1.0,0,0,1110,0,1935,293000.0
2.0,2.5,1250,2.0,0,0,1030,220,2005,267100.0
4.0,3.25,3470,2.0,0,0,2830,640,2005,1500000.0
3.0,2.25,1500,2.0,0,0,1500,0,1992,240000.0
3.0,2.5,2530,2.5,0,4,2530,0,1915,975000.0
5.0,1.75,2150,1.0,0,0,1460,690,1970,279950.0
3.0,1.75,1260,1.0,0,0,1260,0,1979,405000.0
3.0,2.5,2740,2.0,0,4,2740,0,1973,400000.0
3.0,1.0,960,1.0,0,0,960,0,1954,225000.0
3.0,1.0,1520,1.0,0,0,1120,400,1967,250000.0
3.0,2.25,1570,1.0,0,0,1180,390,1991,272950.0
5.0,1.0,3240,2.0,0,0,3240,0,2007,625000.0
3.0,1.75,1280,1.5,0,0,1280,0,1910,670000.0
3.0,2.5,2130,3.0,0,0,2130,0,1990,1065000.0
3.0,1.75,1970,1.0,0,0,1420,550,1963,540000.0
3.0,2.5,2990,2.0,0,0,2990,0,2003,525000.0
2.0,1.0,1160,1.0,0,0,1160,0,1947,425000.0
3.0,1.75,1890,1.0,0,0,1290,600,1965,465500.0
3.0,2.5,2170,2.0,0,0,2170,0,2006,443500.0
4.0,2.25,1570,1.0,0,3,1570,0,1972,350000.0
3.0,2.5,3260,2.0,0,0,3260,0,1984,850000.0
3.0,2.25,1250,3.0,0,0,1250,0,2008,205000.0
4.0,2.5,1940,1.0,0,0,1140,800,1977,315000.0
3.0,2.5,2150,2.0,0,0,2150,0,1992,470000.0
4.0,2.25,3310,1.0,0,4,1660,1650,1973,1100000.0
3.0,1.75,3400,1.0,0,0,2050,1350,1979,340000.0
4.0,2.5,2660,1.0,0,0,1740,920,1960,310000.0
3.0,1.0,950,1.0,0,0,950,0,1950,305000.0
3.0,1.5,1480,1.0,0,0,1480,0,1959,307150.0
4.0,2.5,2840,1.0,0,0,1780,1060,1977,729032.0
5.0,2.5,3240,1.0,0,1,2020,1220,1958,750000.0
4.0,2.5,1961,2.0,0,0,1961,0,2006,289000.0
3.0,1.0,1100,1.0,0,0,1100,0,1950,480000.0
3.0,1.75,1500,1.0,0,0,1500,0,1974,529000.0
3.0,1.75,1480,2.0,0,0,1140,340,1944,585000.0
4.0,2.75,2510,1.0,0,0,2050,460,1976,704000.0
4.0,2.0,1490,1.5,0,0,1490,0,1926,607000.0
3.0,2.25,2190,2.0,0,0,1810,380,1978,580000.0
5.0,2.5,2530,2.0,0,0,2530,0,1976,875000.0
4.0,2.5,2440,1.0,0,0,1560,880,1976,610000.0
3.0,0.75,1040,1.0,0,0,1040,0,1941,230000.0
4.0,2.25,2450,2.0,0,0,2450,0,1976,510000.0
4.0,2.5,2210,1.0,0,0,1370,840,1977,733000.0
3.0,2.0,1050,1.0,0,0,1050,0,1953,169100.0
3.0,2.0,1050,1.0,0,0,1050,0,1953,250000.0
4.0,2.25,2730,2.0,0,0,2730,0,1977,500000.0
2.0,1.0,1620,1.0,0,4,1320,300,1948,700000.0
4.0,2.75,2410,2.0,0,0,2410,0,2001,379000.0
4.0,2.5,3420,2.0,0,0,3420,0,2002,650000.0
2.0,1.0,920,1.0,0,0,920,0,1948,412133.0
4.0,2.25,2330,1.0,0,0,1740,590,1962,480000.0
3.0,1.75,1940,1.0,0,0,1940,0,1957,650000.0
2.0,2.5,1900,2.0,0,0,1900,0,2005,505000.0
4.0,2.5,3510,1.0,0,0,1930,1580,1957,931088.0
4.0,1.75,1860,1.0,0,0,1860,0,1964,570000.0
3.0,1.0,1380,1.0,0,0,1380,0,1919,475000.0
6.0,1.75,2210,1.0,0,0,1310,900,1959,240000.0
4.0,2.5,2640,1.0,0,0,1590,1050,1979,462000.0
3.0,2.5,4530,2.0,0,2,3220,1310,1912,1115000.0
3.0,1.0,1500,1.0,0,0,1500,0,1970,243000.0
4.0,2.25,2010,1.0,0,0,2010,0,1957,660000.0
2.0,1.75,2080,1.0,1,4,1040,1040,1939,1190000.0
4.0,4.25,5584,2.0,0,0,5584,0,1998,1680000.0
6.0,7.75,9890,2.0,0,4,8860,1030,2001,6885000.0
3.0,2.5,2080,2.0,0,0,2080,0,2004,368000.0
5.0,4.25,3970,2.0,0,0,2860,1110,2004,811500.0
2.0,1.0,770,1.0,0,0,770,0,1948,275000.0
4.0,2.5,2500,2.0,0,0,2500,0,2001,650000.0
3.0,2.0,2410,1.5,0,0,2410,0,1995,485000.0
3.0,2.5,1340,1.0,0,0,1340,0,1976,425000.0
3.0,2.5,2640,1.0,0,0,1550,1090,1978,530000.0
4.0,1.75,2740,1.0,0,2,1370,1370,1954,657000.0
4.0,2.75,1580,1.0,0,0,1080,500,2002,315000.0
4.0,1.5,2180,1.0,0,0,1280,900,1954,273000.0
3.0,2.75,1960,1.0,0,0,1240,720,1975,550000.0
2.0,2.25,1560,2.0,0,0,1270,290,2006,347000.0
5.0,2.75,2440,1.0,0,0,1240,1200,1972,525000.0
3.0,1.5,990,2.0,0,0,840,150,2007,490000.0
3.0,2.25,2210,2.0,0,0,2210,0,1978,500000.0
3.0,2.75,3080,2.0,0,0,3080,0,2008,585000.0
4.0,2.75,2900,1.0,0,2,1750,1150,1981,926500.0
1.0,1.0,1020,1.0,0,0,1020,0,1927,465000.0
4.0,2.0,1900,1.0,0,0,1900,0,1975,200000.0
6.0,4.75,5770,2.0,0,3,4500,1270,1998,1680000.0
2.0,1.0,990,1.0,0,0,990,0,1949,220500.0
2.0,1.0,990,1.0,0,0,990,0,1949,329000.0
3.0,4.0,2080,3.0,0,4,2080,0,1997,715000.0
3.0,4.0,2080,3.0,0,4,2080,0,1997,780000.0
2.0,1.0,1480,1.0,0,0,1050,430,1949,410000.0
2.0,1.0,1480,1.0,0,0,1050,430,1949,778100.0
3.0,1.0,1090,1.0,0,0,1090,0,1952,406000.0
4.0,2.5,2800,1.0,0,0,1660,1140,1963,665000.0
2.0,1.0,1000,1.0,0,0,1000,0,1947,305000.0
3.0,2.5,1640,2.0,0,0,1640,0,1991,265000.0
4.0,1.0,1620,1.5,0,0,1620,0,1923,485000.0
3.0,2.5,2460,1.0,0,0,1860,600,1977,600000.0
2.0,1.5,1860,1.0,0,0,1060,800,1940,510000.0
2.0,1.0,1080,1.0,0,0,1080,0,1972,195000.0
3.0,1.75,1980,1.0,0,0,1270,710,1965,432500.0
3.0,1.75,1510,1.0,0,0,1220,290,1967,490000.0
3.0,2.5,1690,2.0,0,0,1690,0,1992,270000.0
2.0,1.5,1010,2.0,0,0,1010,0,1984,370000.0
3.0,2.5,2090,2.0,0,0,2090,0,1991,327500.0
2.0,1.0,1060,1.0,0,0,1060,0,1908,826000.0
3.0,1.75,1750,2.0,0,0,1750,0,1934,510000.0
2.0,1.0,890,1.0,0,0,890,0,1941,587750.0
5.0,2.5,3020,1.0,0,0,1650,1370,1965,449228.0
3.0,2.5,2030,1.0,0,0,2030,0,1999,565000.0
4.0,2.5,3170,2.0,0,0,3170,0,2000,660000.0
5.0,2.75,2470,1.0,0,0,1250,1220,1977,400000.0
4.0,2.0,2060,1.0,0,0,1030,1030,1949,612500.0
4.0,1.75,2120,1.0,0,0,1060,1060,1917,560000.0
3.0,2.25,2180,1.5,0,0,1520,660,1939,727000.0
4.0,3.0,2300,2.0,0,0,2300,0,1976,224000.0
4.0,2.5,4200,2.0,0,0,4200,0,1990,1080000.0
3.0,2.25,1480,1.0,0,0,1220,260,1977,439000.0
3.0,1.5,2240,1.5,0,0,1480,760,1980,335000.0
4.0,1.5,2740,1.0,0,0,1370,1370,1937,779000.0
5.0,1.75,1830,1.5,0,0,1830,0,1948,452000.0
4.0,3.0,2000,1.5,0,0,2000,0,1947,775000.0
3.0,1.75,1380,1.0,0,0,1380,0,1967,235000.0
3.0,1.75,1620,2.0,0,0,1620,0,1953,370000.0
4.0,3.0,3180,2.0,0,0,3180,0,1976,790000.0
2.0,1.5,1140,1.0,0,0,1140,0,1947,903000.0
3.0,1.0,970,1.0,0,0,970,0,1967,209950.0
3.0,2.5,1780,2.0,0,0,1780,0,1988,309000.0
3.0,1.75,2240,1.0,0,0,1120,1120,1948,440000.0
4.0,2.25,2810,2.0,0,0,1860,950,1959,571500.0
2.0,1.0,920,1.0,0,0,920,0,1906,514000.0
3.0,1.75,1830,1.0,0,1,1200,630,1947,323000.0
2.0,1.75,1560,1.0,0,0,1560,0,2002,290000.0
4.0,4.25,5540,2.0,0,1,4280,1260,2006,2575000.0
3.0,2.0,2310,1.0,0,0,2310,0,1979,1362500.0
4.0,1.5,1470,1.5,0,0,1470,0,1946,551000.0
4.0,2.5,3430,1.5,0,2,3430,0,1979,960000.0
5.0,2.5,2900,2.0,0,0,2900,0,1989,720000.0
3.0,1.75,1850,1.0,0,0,1320,530,1979,218000.0
4.0,2.5,2190,2.0,0,0,2190,0,1997,334950.0
4.0,2.25,2510,2.0,0,0,2510,0,1979,605000.0
4.0,3.25,3200,2.0,0,0,2390,810,2006,825000.0
4.0,1.75,1670,1.0,0,0,1670,0,1974,268500.0
3.0,1.75,1010,1.0,0,0,1010,0,1969,230000.0
4.0,4.0,5050,2.0,0,0,3260,1790,2000,1335000.0
2.0,1.5,1430,1.0,0,0,1430,0,1955,245500.0
3.0,2.25,1880,1.0,0,0,1280,600,1982,440000.0
4.0,2.75,2180,2.0,0,0,2180,0,1993,571500.0
3.0,2.25,1830,2.0,0,0,1830,0,1997,182500.0
2.0,1.0,970,1.0,0,0,970,0,1951,217000.0
2.0,1.5,1170,1.0,0,0,1170,0,1941,335000.0
2.0,1.0,1010,1.0,0,0,1010,0,1924,501000.0
3.0,2.5,2140,1.0,0,0,1290,850,1979,339950.0
3.0,1.75,2230,1.0,0,0,1630,600,1968,340000.0
2.0,1.0,1140,1.5,0,0,1140,0,1966,582500.0
2.0,1.0,860,1.0,0,0,860,0,1948,298800.0
6.0,1.75,2540,1.0,0,0,1340,1200,1977,317500.0
4.0,2.5,2420,1.5,0,2,1550,870,1926,598000.0
2.0,2.25,1640,2.0,0,0,1640,0,1980,375000.0
4.0,2.25,2550,2.0,0,2,2550,0,1996,465000.0
3.0,2.5,2507,2.0,0,0,2507,0,2006,551870.0
3.0,2.5,1920,2.0,0,0,1920,0,1993,295000.0
4.0,1.75,2210,1.0,0,0,1640,570,1977,263500.0
4.0,4.0,3530,2.0,0,0,2630,900,1958,1095000.0
2.0,1.0,1100,1.5,0,0,1100,0,1920,300000.0
4.0,1.0,3390,1.5,0,0,2190,1200,1924,780000.0
3.0,1.5,1590,1.0,0,0,1590,0,1956,325000.0
2.0,1.0,820,1.0,0,0,820,0,1949,370000.0
4.0,2.5,2370,1.0,0,0,1660,710,1974,715000.0
4.0,2.0,1600,1.0,0,0,1600,0,1938,356000.0
4.0,1.75,1740,1.5,0,0,1740,0,1976,329950.0
3.0,2.25,1470,2.0,0,0,1080,390,1984,490000.0
3.0,3.25,1410,3.0,0,0,1410,0,2005,429000.0
4.0,2.5,1620,2.0,0,0,1620,0,1983,510000.0
3.0,2.5,2360,2.0,0,0,2360,0,2003,550000.0
3.0,1.0,1830,1.0,0,0,1830,0,1956,467500.0
5.0,2.0,2130,1.5,0,0,1270,860,1926,615000.0
2.0,1.0,990,1.0,0,0,990,0,1953,325000.0
2.0,1.0,1010,2.0,0,0,1010,0,1907,219950.0
3.0,1.0,1720,1.0,0,0,1720,0,1946,950000.0
3.0,1.0,1630,1.5,0,0,1630,0,1912,925000.0
4.0,1.5,1310,1.0,0,0,1060,250,1953,251200.0
3.0,1.5,1610,1.0,0,0,1610,0,1968,215000.0
3.0,2.0,1850,1.0,0,0,1180,670,1970,245000.0
3.0,1.75,1270,1.5,0,0,980,290,1922,259000.0
4.0,1.5,1420,1.5,0,0,1420,0,1925,349950.0
5.0,4.5,5220,2.0,0,0,5220,0,2001,1565000.0
2.0,1.0,1410,1.0,0,0,1020,390,1939,600000.0
2.0,1.5,1170,3.0,0,0,1170,0,2001,405000.0
3.0,2.5,1860,2.0,0,0,1860,0,1993,625000.0
4.0,1.0,1620,1.5,0,0,1620,0,1943,430000.0
3.0,3.0,1280,3.0,0,0,1280,0,2004,533000.0
4.0,2.5,2750,2.0,0,0,2750,0,1999,1050000.0
3.0,1.75,1420,1.0,0,0,710,710,1931,230000.0
4.0,1.75,2000,1.0,0,0,1010,990,1975,275000.0
2.0,1.0,1100,1.0,0,0,1100,0,1926,403000.0
3.0,3.0,1720,1.0,0,2,1720,0,1966,550388.0
3.0,1.5,1240,1.0,0,0,1240,0,1958,415500.0
3.0,1.75,2170,1.0,0,0,1110,1060,1925,913000.0
2.0,1.0,1800,1.0,0,0,900,900,1942,334998.0
3.0,1.0,1160,1.0,0,0,1160,0,1959,201500.0
3.0,2.5,3030,2.0,0,0,3030,0,1997,820000.0
3.0,1.0,890,1.0,0,0,890,0,1951,371000.0
4.0,2.5,2150,1.0,0,0,1240,910,1976,229950.0
4.0,2.5,2150,1.0,0,0,1240,910,1976,344900.0
3.0,2.5,2060,2.0,0,0,2060,0,1924,840000.0
3.0,1.5,1380,1.0,0,0,1380,0,1967,285000.0
4.0,2.25,1800,1.0,0,0,1230,570,1979,475000.0
2.0,1.0,1460,1.0,0,0,1460,0,1924,420000.0
3.0,2.0,2210,1.5,0,2,1710,500,1909,685000.0
4.0,3.0,3590,2.0,0,0,3590,0,2005,879000.0
3.0,1.0,1140,1.0,0,0,990,150,1942,197200.0
3.0,1.0,1240,1.5,0,0,1240,0,1909,529950.0
4.0,2.5,4340,2.5,0,0,4340,0,1992,1090000.0
3.0,1.5,1570,2.0,0,0,1570,0,1915,792000.0
3.0,2.5,1680,2.0,0,0,1680,0,1994,262000.0
3.0,1.75,1560,1.0,0,0,780,780,1927,353900.0
1.0,1.5,1200,1.5,0,0,1200,0,1983,380000.0
3.0,2.5,1690,2.0,0,0,1690,0,2002,305000.0
4.0,2.0,2310,1.0,0,0,1430,880,1994,440000.0
4.0,3.5,2650,2.0,0,0,2060,590,2001,1008000.0
5.0,3.0,3610,2.0,0,0,3610,0,2003,549900.0
4.0,3.0,2620,2.0,0,0,2620,0,1992,678500.0
3.0,2.25,1760,1.0,0,0,1160,600,1986,270000.0
3.0,1.0,940,1.5,0,0,940,0,1949,430000.0
5.0,4.25,4830,2.5,0,2,3710,1120,1914,1925000.0
4.0,2.75,3350,2.0,0,0,3350,0,2014,790500.0
3.0,2.25,1570,2.0,0,0,1570,0,1991,447450.0
3.0,2.0,2240,1.0,0,0,1630,610,1954,375000.0
4.0,2.0,1950,1.0,0,0,1950,0,1963,565000.0
2.0,1.0,1010,1.0,0,2,810,200,1918,400000.0
3.0,1.5,1630,1.0,0,0,1300,330,1976,246000.0
3.0,1.75,1420,1.0,0,0,1100,320,1967,329922.0
5.0,3.25,3950,1.0,0,0,2100,1850,1969,1249000.0
3.0,1.0,1210,1.0,0,0,1210,0,1910,375000.0
3.0,1.75,1890,1.0,0,0,1230,660,1944,385000.0
4.0,2.5,1690,1.5,0,0,1140,550,1912,591500.0
4.0,2.0,2560,1.0,0,0,1350,1210,1960,255000.0
3.0,1.5,1350,1.0,0,0,1350,0,1959,275000.0
4.0,2.75,3120,2.0,0,0,3120,0,2010,800000.0
2.0,1.0,1140,1.0,0,0,1140,0,1952,327000.0
4.0,1.5,2230,1.0,0,1,1220,1010,1954,355000.0
2.0,1.0,1050,1.0,0,0,780,270,1947,310000.0
5.0,3.25,4180,2.0,0,0,2880,1300,1979,869000.0
3.0,2.0,1200,1.0,0,0,1200,0,1942,272000.0
5.0,2.25,3320,2.0,0,0,3320,0,2000,665000.0
3.0,2.5,1590,2.0,0,0,1590,0,1989,225000.0
3.0,2.5,2750,2.0,0,0,2750,0,1989,375000.0
3.0,1.5,1530,1.0,0,0,1530,0,1975,375500.0
3.0,1.75,1570,1.0,0,0,920,650,1948,550000.0
3.0,1.0,1470,1.0,0,0,1220,250,1946,248000.0
3.0,1.0,1470,1.0,0,0,1220,250,1946,546940.0
4.0,3.0,3150,2.0,0,0,3150,0,2001,680000.0
4.0,2.5,2380,2.0,0,0,2380,0,1997,350000.0
2.0,2.5,2000,3.0,0,1,1810,190,1994,593000.0
2.0,1.0,1140,1.0,0,0,1140,0,1958,390000.0
3.0,1.0,1340,1.0,0,0,1340,0,1924,297000.0
2.0,1.0,1450,1.0,0,0,1450,0,1965,355000.0
3.0,2.5,2020,2.0,0,0,2020,0,1987,309900.0
3.0,2.25,1810,2.0,0,0,1810,0,1992,257000.0
4.0,3.0,3600,2.0,0,0,3600,0,1959,1698000.0
3.0,2.0,1260,2.0,0,0,1260,0,1987,300000.0
3.0,2.0,1560,3.0,0,0,1560,0,2014,500000.0
8.0,4.0,4020,1.0,0,0,2010,2010,1968,900000.0
4.0,3.0,3150,2.0,0,0,3150,0,2001,695000.0
4.0,2.5,1680,2.0,0,0,1680,0,2001,213400.0
2.0,1.0,1320,1.0,0,0,1020,300,1939,425000.0
3.0,3.0,2700,2.0,0,0,1570,1130,1986,420000.0
1.0,1.0,1080,1.5,0,0,1080,0,1948,411000.0
4.0,2.25,3130,2.0,0,0,3130,0,1986,762500.0
5.0,4.5,4850,2.0,0,0,4850,0,2001,569950.0
4.0,1.0,1220,1.5,0,0,1220,0,1916,258000.0
3.0,2.25,1780,2.0,0,0,1780,0,2004,499000.0
3.0,1.0,1250,1.0,0,0,1250,0,1961,310000.0
2.0,2.5,1780,3.0,0,0,1350,430,2005,398500.0
4.0,2.5,1930,1.0,0,0,1120,810,1981,250600.0
4.0,2.5,2470,1.0,0,0,1420,1050,1985,352000.0
2.0,1.0,1180,1.0,0,1,940,240,1909,600000.0
3.0,1.0,2270,1.0,0,0,1170,1100,1946,645000.0
4.0,2.5,1770,2.0,0,0,1770,0,2004,291500.0
4.0,1.75,2250,1.0,0,0,2150,100,1940,350000.0
3.0,2.5,1540,1.0,0,0,1080,460,1974,279000.0
2.0,1.0,820,1.0,0,0,820,0,1940,320000.0
2.0,2.0,1580,1.0,0,0,1580,0,2004,495000.0
4.0,2.5,2430,1.0,0,0,1450,980,1989,490000.0
5.0,1.5,2160,1.5,0,2,2160,0,1926,770000.0
3.0,1.75,1770,1.0,0,0,1770,0,1959,215000.0
3.0,3.5,3580,1.5,0,0,3580,0,2005,665000.0
3.0,2.25,1890,1.0,0,0,1190,700,1987,423500.0
3.0,3.0,1910,1.5,0,0,1910,0,1900,850000.0
2.0,1.0,910,1.0,0,0,910,0,1943,155000.0
3.0,2.25,1460,1.0,0,0,1460,0,1963,505000.0
3.0,3.5,3310,2.0,0,0,3310,0,2005,780000.0
3.0,1.5,1630,1.0,0,0,1630,0,1970,165000.0
2.0,2.5,2130,1.0,0,0,1330,800,1972,707000.0
3.0,2.5,1220,3.0,0,0,1220,0,2000,497000.0
4.0,1.75,1670,1.0,0,2,1070,600,1955,349170.0
4.0,1.5,1300,1.5,0,0,1300,0,1963,287000.0
4.0,2.5,3220,1.0,0,0,3220,0,1969,2375000.0
4.0,2.5,2430,1.0,0,0,1670,760,1963,645000.0
5.0,2.25,2240,2.0,0,0,2240,0,1990,238000.0
5.0,2.25,2240,2.0,0,0,2240,0,1990,328000.0
2.0,1.5,790,2.0,0,0,700,90,2003,365000.0
3.0,1.0,1380,1.0,0,0,1380,0,1948,380000.0
4.0,1.5,1680,2.0,0,0,1680,0,1962,525000.0
4.0,2.25,2000,2.0,0,0,1650,350,1926,402000.0
2.0,1.0,1680,1.0,0,0,860,820,1969,308000.0
3.0,2.5,1960,2.0,0,0,1960,0,2006,405000.0
3.0,1.75,2590,1.0,0,0,2590,0,1951,808000.0
4.0,3.5,3790,2.5,0,0,3790,0,2010,875000.0
3.0,2.5,2370,3.0,0,0,2370,0,1982,860000.0
4.0,2.25,1930,1.0,0,0,1300,630,1960,367500.0
6.0,3.5,2580,1.0,0,0,1290,1290,1987,604000.0
2.0,0.75,890,1.0,0,0,890,0,1934,230000.0
4.0,2.75,2160,1.0,0,0,1410,750,1978,435000.0
4.0,2.5,1970,2.0,0,0,1970,0,2007,347500.0
4.0,1.75,1570,1.0,0,2,1030,540,1981,525000.0
2.0,1.5,1480,1.0,0,0,1480,0,1940,280000.0
2.0,1.5,1480,1.0,0,0,1480,0,1940,490000.0
4.0,1.75,1430,1.0,0,0,1430,0,1942,265000.0
4.0,2.25,2720,1.0,0,0,2000,720,1979,645000.0
3.0,2.25,2420,1.0,0,0,1750,670,1964,390000.0
3.0,2.5,1400,1.0,0,0,1120,280,1988,267500.0
4.0,3.5,5844,2.0,0,1,5844,0,2007,1275000.0
4.0,1.75,1840,1.0,0,0,960,880,1958,404000.0
3.0,2.25,2530,2.0,0,0,2530,0,1989,380000.0
4.0,2.75,2810,1.0,0,0,1810,1000,1978,812500.0
3.0,1.0,1020,1.0,0,0,1020,0,1959,265000.0
5.0,2.75,2550,1.0,0,0,1390,1160,1967,480000.0
1.0,1.0,710,1.0,0,0,710,0,1939,264000.0
5.0,3.0,5530,1.5,0,2,5530,0,1969,1350000.0
4.0,1.75,2150,1.0,0,0,1110,1040,1966,550000.0
2.0,1.5,880,1.5,0,0,880,0,1929,615000.0
3.0,1.75,1630,1.0,0,0,1630,0,1967,464000.0
3.0,1.0,1380,2.0,0,0,1380,0,1976,365000.0
4.0,2.25,2800,1.0,0,0,1680,1120,1977,490000.0
4.0,2.25,2070,2.0,0,0,2070,0,1977,280927.0
2.0,1.0,830,1.0,0,0,830,0,1954,282613.0
3.0,2.25,2770,2.0,0,0,2770,0,1982,675000.0
4.0,2.5,2060,1.0,0,0,1440,620,1985,575550.0
3.0,2.0,1490,1.0,0,0,1490,0,1990,259900.0
4.0,2.25,2120,2.0,0,0,2120,0,1996,450000.0
4.0,2.5,2810,2.0,0,0,2810,0,2013,487500.0
4.0,2.25,2400,2.0,0,0,2400,0,1973,275000.0
3.0,2.5,2460,2.0,0,0,2460,0,2002,305000.0
3.0,1.75,2030,1.0,0,2,2030,0,1977,395000.0
3.0,1.0,880,1.0,0,2,880,0,1940,215000.0
3.0,2.0,1320,1.5,0,0,1320,0,1920,410000.0
4.0,2.5,2160,1.0,0,0,1390,770,1976,440000.0
4.0,3.5,4190,2.0,0,2,4190,0,1994,1160000.0
4.0,2.0,2280,1.0,0,0,2280,0,1956,500000.0
5.0,2.75,2590,2.0,0,0,2590,0,1909,961000.0
4.0,2.25,2770,2.0,0,0,2770,0,1979,825000.0
3.0,1.75,2145,1.5,0,0,2145,0,1910,734000.0
4.0,4.25,4480,2.0,0,0,3680,800,2003,490000.0
4.0,2.5,1780,2.0,0,0,1780,0,1991,175000.0
1.0,1.0,720,1.0,0,0,720,0,1914,190000.0
4.0,2.25,2050,2.0,0,0,2050,0,1978,305000.0
3.0,1.0,2040,1.0,0,3,1680,360,1940,1300000.0
2.0,1.0,920,1.0,0,0,920,0,1919,417000.0
2.0,1.0,680,1.0,0,0,680,0,1906,275000.0
3.0,2.5,1940,2.0,0,0,1940,0,1991,661000.0
4.0,2.75,2230,1.0,0,0,1320,910,1998,435000.0
5.0,2.25,2910,1.0,0,1,1910,1000,1972,788000.0
5.0,3.25,5270,2.0,0,1,4010,1260,1977,1795000.0
5.0,3.25,2820,1.5,0,0,2320,500,1906,408000.0
2.0,1.0,1790,1.5,0,0,1490,300,1912,570000.0
5.0,3.25,2920,2.0,0,1,2120,800,1953,1540000.0
2.0,1.0,840,1.0,0,0,840,0,1955,400000.0
3.0,1.75,1820,1.0,0,0,1820,0,1987,247000.0
3.0,1.75,1550,1.0,0,0,1100,450,1949,453000.0
2.0,1.0,1270,1.0,0,0,650,620,1923,235000.0
4.0,1.75,2460,1.5,0,3,1620,840,1919,675000.0
3.0,2.0,2110,1.0,0,0,1080,1030,1919,516200.0
1.0,1.0,920,1.5,0,0,920,0,1996,650000.0
3.0,1.5,1500,1.0,0,0,1000,500,1945,257100.0
2.0,2.0,1440,1.0,0,0,1440,0,2006,457000.0
3.0,1.75,1610,1.5,0,0,1060,550,1929,540000.0
3.0,1.75,1970,1.0,0,0,1970,0,1966,268000.0
3.0,1.0,1150,1.0,0,0,1150,0,1960,300000.0
2.0,2.5,2110,1.0,0,0,1590,520,1975,380000.0
3.0,2.5,3580,1.5,0,0,3580,0,1990,725000.0
3.0,1.0,1000,1.0,0,0,1000,0,1968,249000.0
5.0,1.0,1680,1.0,0,0,1400,280,1929,274000.0
4.0,3.25,3950,2.0,0,0,3950,0,2003,1780000.0
3.0,1.75,2390,1.0,0,0,1350,1040,1955,396500.0
2.0,1.5,1820,1.0,0,0,1240,580,1956,460000.0
3.0,1.0,1100,1.0,0,0,1100,0,1957,277000.0
6.0,4.0,2280,1.0,0,0,1270,1010,1998,449500.0
4.0,3.0,2530,1.5,0,0,1540,990,1925,785950.0
3.0,2.5,1940,1.0,0,2,1440,500,1975,545000.0
3.0,2.0,1360,1.0,0,0,1360,0,1983,244000.0
3.0,2.5,1660,2.0,0,0,1660,0,1983,165000.0
2.0,1.0,800,1.0,0,0,800,0,1906,435000.0
3.0,2.5,2670,1.0,0,0,2670,0,1987,642000.0
3.0,2.5,1720,2.0,0,0,1720,0,1999,340000.0
4.0,2.5,3550,2.0,0,0,3550,0,1991,730000.0
3.0,1.75,1370,1.0,0,0,800,570,1982,563250.0
5.0,2.5,2820,2.0,0,0,2820,0,1979,675000.0
3.0,1.5,1620,1.0,0,0,1280,340,1954,620000.0
2.0,2.0,1290,1.0,0,0,950,340,1956,275000.0
3.0,1.0,1830,1.0,0,0,1830,0,1942,270000.0
4.0,2.5,2040,2.0,0,0,2040,0,2003,325000.0
4.0,2.5,1850,2.0,0,0,1600,250,2005,476100.0
2.0,1.0,1300,1.0,0,0,1300,0,1959,700000.0
4.0,2.0,1620,1.5,0,0,1620,0,1978,220000.0
3.0,1.75,1560,1.0,0,0,1560,0,1975,236000.0
3.0,2.5,2600,1.0,0,0,1700,900,1951,790000.0
3.0,1.0,2010,1.0,0,0,1210,800,1967,350000.0
2.0,1.0,780,1.0,0,0,780,0,1941,130000.0
4.0,2.5,1982,2.0,0,0,1982,0,2004,283200.0
3.0,1.0,1500,1.0,0,0,890,610,1945,273000.0
5.0,2.25,2460,1.0,0,0,1330,1130,1976,599000.0
4.0,2.5,2680,1.0,0,3,1510,1170,1960,460000.0
4.0,4.25,5860,2.0,0,0,4910,950,1996,1157200.0
4.0,1.75,1720,1.0,0,0,860,860,1971,385000.0
3.0,1.0,1420,1.5,0,0,1420,0,1944,264250.0
3.0,2.5,1760,3.0,0,0,1640,120,2006,608000.0
3.0,2.5,2790,2.0,0,0,2790,0,1984,450000.0
3.0,2.0,2360,2.0,0,0,2360,0,1909,1755000.0
5.0,2.0,1890,2.0,0,0,1890,0,1944,339950.0
6.0,3.75,3810,2.0,0,0,3810,0,1977,760000.0
2.0,1.0,1160,1.0,0,0,860,300,1940,350000.0
3.0,1.75,2320,1.0,0,2,2320,0,1960,541500.0
6.0,2.75,3280,1.0,0,0,1910,1370,1963,730000.0
3.0,1.0,980,1.0,0,0,980,0,1949,215000.0
3.0,2.0,1640,1.0,0,0,1640,0,1977,420000.0
4.0,2.25,2060,1.0,0,0,1440,620,1983,655000.0
3.0,2.5,1500,2.0,0,0,1500,0,1981,240000.0
4.0,2.0,2360,1.0,0,0,1260,1100,1939,730000.0
4.0,1.5,1940,1.0,0,0,1940,0,1962,390000.0
3.0,1.0,1280,1.0,0,0,1280,0,1954,473000.0
4.0,3.5,3630,2.0,0,0,3630,0,1970,698000.0
3.0,2.5,1820,2.0,0,0,1820,0,2005,511000.0
2.0,1.5,960,2.0,0,0,960,0,1993,358000.0
3.0,1.75,1630,1.0,0,0,1060,570,1955,499990.0
4.0,2.25,1940,1.0,0,0,1360,580,1960,322000.0
3.0,1.0,980,1.0,0,0,980,0,1969,201000.0
4.0,2.5,3140,1.0,0,1,2570,570,1988,765000.0
4.0,2.75,2880,1.5,0,0,1710,1170,1928,920000.0
4.0,2.0,1650,1.0,0,0,860,790,1977,360000.0
3.0,1.75,1980,2.0,0,0,1980,0,1987,297300.0
3.0,1.0,860,1.0,0,0,860,0,1942,399000.0
3.0,1.0,1430,1.5,0,0,1430,0,1950,400000.0
3.0,1.75,1260,1.0,0,0,1260,0,1964,230000.0
3.0,1.0,960,1.0,0,0,960,0,1968,290000.0
3.0,2.5,2060,2.0,0,0,2060,0,2003,323800.0
4.0,1.5,1430,1.5,0,0,1430,0,1930,574500.0
3.0,2.25,1670,2.0,0,0,1220,450,2002,505000.0
2.0,1.0,880,1.0,0,0,880,0,1944,372500.0
3.0,1.5,1300,1.0,0,0,1300,0,1964,425000.0
3.0,2.5,2380,1.5,0,0,2380,0,2000,446250.0
2.0,0.75,520,1.0,0,0,520,0,1924,330000.0
3.0,2.5,2680,2.0,0,1,2680,0,1983,608095.0
3.0,2.5,2140,1.0,0,0,1320,820,1958,550000.0
4.0,2.5,1820,2.0,0,0,1820,0,2004,265000.0
4.0,2.25,1820,1.5,0,0,1320,500,1930,399888.0
2.0,1.0,1050,1.0,0,0,850,200,1927,430000.0
3.0,2.5,2100,2.0,0,0,2100,0,2013,554990.0
3.0,2.5,2210,2.0,0,0,2210,0,2003,359950.0
2.0,1.0,860,1.0,0,0,860,0,1901,405000.0
2.0,1.0,870,1.0,0,0,870,0,1981,280000.0
4.0,2.25,2570,2.0,0,0,2570,0,1966,479950.0
5.0,1.75,2980,1.0,0,0,2230,750,1976,575000.0
4.0,2.25,2360,2.0,0,0,2360,0,1983,392000.0
4.0,2.25,2310,2.0,0,0,2310,0,1977,760500.0
3.0,2.5,2300,2.0,0,0,2300,0,2003,435000.0
4.0,2.75,2810,2.0,0,0,2810,0,1993,1565000.0
4.0,1.5,2040,1.0,0,0,1190,850,1961,261000.0
3.0,2.25,3290,2.0,0,0,2730,560,1939,1482500.0
7.0,4.0,2960,2.0,0,0,1950,1010,1927,853800.0
3.0,2.5,2670,2.0,0,0,2670,0,1989,657500.0
4.0,2.5,2530,2.0,0,2,2010,520,1990,331950.0
3.0,1.75,1720,1.0,0,1,1220,500,1986,514000.0
3.0,3.5,3090,2.0,0,2,2020,1070,1995,496000.0
4.0,2.5,3930,2.0,0,0,3930,0,1987,1093000.0
3.0,1.0,1120,1.0,0,0,1120,0,1976,195700.0
4.0,2.25,3960,2.0,0,2,2630,1330,1925,1395710.0
4.0,3.25,4060,2.0,0,0,4060,0,1991,1175000.0
3.0,2.5,2350,1.0,0,0,2350,0,1966,643403.0
4.0,2.5,2380,2.0,0,0,2380,0,1997,357000.0
3.0,1.75,1480,1.0,0,0,1040,440,1953,865000.0
3.0,2.5,2930,2.0,0,0,2930,0,1988,905000.0
3.0,1.5,1290,1.0,0,0,1290,0,1954,265000.0
2.0,2.5,2730,2.0,0,0,2730,0,1998,535000.0
3.0,1.0,1290,1.0,0,0,790,500,1929,450000.0
4.0,2.5,2170,2.0,0,0,2170,0,1991,460500.0
4.0,1.75,1850,1.0,0,0,1140,710,1960,315000.0
4.0,2.5,2110,1.0,0,0,1270,840,1978,607500.0
2.0,1.0,960,1.0,0,0,960,0,1916,432000.0
3.0,4.0,3910,2.0,0,2,2610,1300,1933,1695000.0
4.0,2.5,2590,2.0,0,0,2590,0,2001,479000.0
5.0,2.75,3080,2.0,0,0,3080,0,2002,475000.0
3.0,1.0,1630,1.0,0,0,1630,0,1952,415000.0
2.0,1.0,910,1.0,0,0,910,0,1914,450000.0
3.0,2.5,2780,1.5,0,1,2110,670,1969,1140000.0
5.0,3.0,3880,2.0,0,0,3880,0,2004,430000.0
3.0,1.75,1360,1.0,0,0,960,400,1971,296000.0
4.0,2.25,2560,1.0,0,0,1790,770,1976,303000.0
4.0,2.5,2600,2.0,0,0,2600,0,2004,641000.0
3.0,2.25,1220,1.0,0,0,790,430,1984,280000.0
3.0,2.0,1560,1.0,0,0,1260,300,1966,260750.0
4.0,2.5,2080,2.0,0,0,2080,0,2001,601000.0
3.0,1.5,1490,1.0,0,0,1490,0,1918,255000.0
4.0,2.75,2020,1.0,0,0,1420,600,1976,555000.0
3.0,1.5,1530,1.0,0,0,1530,0,1955,865000.0
4.0,2.5,3450,1.5,0,0,2180,1270,1964,1388000.0
3.0,2.25,1400,1.0,0,0,1140,260,1987,315000.0
2.0,1.0,1730,1.0,0,0,1380,350,1962,200000.0
3.0,1.0,1370,1.0,0,0,1370,0,1948,357000.0
2.0,1.5,1050,2.0,0,0,960,90,2007,390000.0
5.0,1.75,2840,1.0,0,0,2210,630,1954,462000.0
2.0,1.0,1010,1.0,0,0,1010,0,1955,174500.0
2.0,1.0,1210,1.5,0,0,1210,0,1921,305000.0
5.0,1.75,1720,1.0,0,0,1150,570,1956,449000.0
3.0,2.0,2710,2.0,0,0,2710,0,1951,260000.0
4.0,2.5,3110,2.0,0,0,3110,0,2004,751000.0
2.0,1.0,1250,1.0,0,0,1250,0,1948,370037.0
3.0,1.75,1900,2.0,0,0,1900,0,1988,229950.0
3.0,1.75,1740,1.0,0,0,1330,410,1978,349000.0
4.0,2.5,2070,2.0,0,0,2070,0,2003,348000.0
3.0,3.25,3030,2.0,0,2,2220,810,1905,1220000.0
4.0,3.0,3610,2.0,0,0,3610,0,1993,510000.0
3.0,1.5,1520,1.0,0,0,1040,480,1981,265000.0
3.0,2.75,2780,3.0,0,2,2780,0,1974,1250000.0
4.0,4.0,5545,2.0,0,0,3605,1940,2003,937500.0
3.0,1.75,2590,1.0,0,0,1590,1000,1971,485000.0
4.0,1.0,1150,1.5,0,0,1150,0,1951,489000.0
2.0,1.0,920,1.0,0,0,920,0,1952,400000.0
3.0,2.5,2110,2.0,0,0,2110,0,2005,638000.0
3.0,1.75,1170,1.0,0,0,1170,0,1968,440000.0
6.0,2.0,1900,1.0,0,0,1200,700,1964,305000.0
6.0,2.0,1900,1.0,0,0,1200,700,1964,649950.0
4.0,2.5,3290,2.0,0,0,3290,0,2005,680000.0
4.0,2.5,2660,2.0,0,0,2660,0,1996,629000.0
3.0,2.5,2160,2.0,0,0,2160,0,1988,555000.0
4.0,2.75,2700,2.0,0,0,2700,0,1976,669000.0
3.0,2.5,1980,2.0,0,0,1980,0,1994,272000.0
4.0,2.25,2600,1.0,0,0,1600,1000,1965,270000.0
3.0,1.0,1280,1.0,0,0,1280,0,1964,215000.0
3.0,1.5,1710,1.0,0,0,1180,530,1947,690000.0
4.0,1.75,1270,1.0,0,2,1270,0,1950,256000.0
3.0,2.25,1890,1.0,0,0,1100,790,1981,255000.0
7.0,4.0,3440,2.0,0,0,3440,0,1970,550000.0
3.0,1.0,1190,1.0,0,0,1190,0,1957,410000.0
2.0,1.0,1030,1.0,0,0,1030,0,1912,410000.0
3.0,1.75,1240,1.0,0,0,1240,0,1986,259000.0
3.0,1.0,1730,1.0,0,0,1030,700,1955,292000.0
4.0,3.5,4610,2.0,0,2,4610,0,2003,1648000.0
5.0,1.0,1590,1.5,0,0,1190,400,1929,518000.0
3.0,2.5,1760,2.0,0,0,1760,0,1992,485000.0
3.0,2.0,1330,1.0,0,0,1330,0,1989,259500.0
4.0,2.5,2340,2.0,0,0,2340,0,2003,354000.0
3.0,2.25,3740,2.0,0,0,2330,1410,1966,999950.0
3.0,1.75,1150,1.0,0,0,1150,0,1959,464500.0
3.0,2.5,1750,2.0,0,0,1750,0,2005,300000.0
3.0,2.75,3890,2.0,0,1,3260,630,1967,1080000.0
4.0,2.5,1770,2.0,0,0,1770,0,1989,309950.0
3.0,1.0,1160,1.5,0,0,1160,0,1909,315000.0
3.0,1.0,1440,1.5,0,0,1440,0,1908,499950.0
4.0,2.0,2600,1.0,0,2,1400,1200,1953,780000.0
3.0,3.25,2640,1.0,0,2,1960,680,1976,885000.0
2.0,1.0,1010,1.5,0,0,1010,0,1906,500000.0
3.0,2.0,1840,1.0,0,2,1840,0,1989,329000.0
4.0,1.75,1720,1.0,0,0,1020,700,1963,246000.0
3.0,1.5,1280,1.0,0,0,1280,0,1960,405000.0
4.0,1.75,1700,1.0,0,0,1120,580,1981,349000.0
4.0,2.5,1980,2.0,0,0,1980,0,1992,374950.0
3.0,2.0,1160,1.0,0,0,1160,0,1969,306000.0
4.0,1.75,1980,1.0,0,0,990,990,1961,416000.0
3.0,2.5,1960,2.0,0,0,1960,0,1989,560000.0
3.0,1.5,1270,1.0,0,0,1150,120,1948,260000.0
3.0,2.25,2060,1.0,0,0,1560,500,1978,306500.0
3.0,1.75,1980,1.0,0,0,1480,500,1968,299950.0
3.0,2.5,1450,1.0,0,0,1450,0,1990,265500.0
3.0,1.5,1200,1.0,0,0,1200,0,1986,219000.0
3.0,1.75,1830,1.0,0,0,1230,600,1977,365000.0
3.0,2.0,2090,1.5,0,0,2090,0,1959,499000.0
3.0,1.75,1510,1.0,0,0,1510,0,1967,366000.0
3.0,2.25,1310,3.0,0,0,1310,0,2014,514950.0
4.0,2.75,3790,2.0,0,0,3790,0,1999,875000.0
3.0,2.25,2240,1.0,0,0,2240,0,1957,831000.0
4.0,3.25,2740,2.0,0,0,2060,680,2003,689900.0
3.0,2.5,1660,2.0,0,0,1660,0,1994,315000.0
,,2460,2.0,0,0,2460,0,1990,355000.0
3.0,1.0,1480,1.0,0,0,970,510,1963,336500.0
3.0,2.75,2640,1.5,0,0,1750,890,1926,1100000.0
6.0,2.0,1900,1.0,0,0,1170,730,1959,375000.0
3.0,2.0,2860,1.0,0,0,1700,1160,1985,289275.0
4.0,3.5,3440,2.0,0,0,3440,0,2002,455000.0
3.0,1.75,1640,1.0,0,2,1640,0,1975,505000.0
3.0,1.0,1450,1.5,0,0,1450,0,1919,450000.0
3.0,2.5,2300,2.0,0,0,2300,0,2001,567500.0
3.0,1.5,1460,1.0,0,0,1460,0,1955,265000.0
3.0,2.0,1570,1.0,0,0,1570,0,2001,340000.0
3.0,2.0,1540,1.5,0,0,1540,0,1939,375000.0
6.0,3.0,3300,2.0,0,0,2200,1100,1970,920000.0
4.0,2.25,2130,2.0,0,0,2130,0,1972,850000.0
3.0,1.0,1010,1.0,0,0,1010,0,1969,202000.0
4.0,3.0,2420,1.0,0,0,2420,0,1984,725000.0
3.0,3.25,3870,2.0,0,0,3150,720,1991,900000.0
2.0,1.5,1960,1.0,0,0,1210,750,1951,680200.0
3.0,1.0,1170,1.0,0,0,1170,0,1918,216500.0
3.0,1.5,1890,1.0,0,0,1890,0,1966,325000.0
3.0,2.5,2250,2.0,0,0,2250,0,2004,675000.0
2.0,0.75,750,1.0,0,1,750,0,1936,435000.0
3.0,1.75,1610,1.0,0,0,1050,560,1977,263500.0
4.0,2.25,2590,2.0,0,0,2590,0,1978,550000.0
3.0,2.5,2520,2.0,0,1,2520,0,1995,875000.0
4.0,1.0,1340,1.0,0,0,1340,0,1966,246600.0
3.0,2.25,1460,3.0,0,0,1460,0,2006,337000.0
3.0,1.75,1380,1.0,0,0,1380,0,1988,240000.0
3.0,1.75,1510,1.0,0,0,1510,0,1984,490000.0
5.0,2.5,2510,1.0,0,0,1260,1250,1975,510000.0
3.0,1.0,910,1.0,0,0,910,0,1971,305000.0
3.0,2.5,1970,2.0,0,0,1970,0,2003,350000.0
3.0,1.75,1540,1.0,0,0,1070,470,1959,284200.0
4.0,2.5,1980,2.0,0,0,1980,0,1995,357000.0
4.0,2.75,3150,1.0,0,0,2480,670,1986,854000.0
4.0,2.5,4700,2.0,0,0,4700,0,1999,1175000.0
3.0,2.25,2300,1.0,0,0,1150,1150,1963,1000000.0
4.0,2.25,1880,2.0,0,0,1760,120,1909,616500.0
4.0,2.75,2640,2.0,0,0,1840,800,1911,750000.0
6.0,4.5,3900,2.0,0,0,2870,1030,1979,650000.0
4.0,2.25,2670,1.0,0,0,1420,1250,1962,275000.0
4.0,1.75,1840,1.0,0,0,920,920,1918,540000.0
3.0,1.0,1120,1.0,0,0,1120,0,1961,225000.0
4.0,2.5,2970,2.0,0,0,2970,0,1991,845000.0
3.0,2.25,1410,1.0,0,0,1410,0,1923,490000.0
4.0,2.5,3060,2.0,0,0,3060,0,2005,753000.0
3.0,1.75,2490,1.0,0,0,1290,1200,1972,475000.0
1.0,0.75,840,1.5,0,0,840,0,1949,124000.0
1.0,0.75,840,1.5,0,0,840,0,1949,224000.0
2.0,1.0,1130,1.0,0,0,1130,0,1916,485000.0
4.0,1.75,1850,1.0,0,0,1270,580,1944,230000.0
4.0,2.75,2330,1.0,0,0,1800,530,1980,372000.0
4.0,2.5,1880,2.0,0,0,1880,0,1990,306000.0
4.0,3.5,2980,2.0,0,0,2340,640,2008,905000.0
4.0,1.0,1440,1.0,0,0,1040,400,1950,440000.0
3.0,1.75,1630,1.0,0,0,1100,530,1977,280000.0
3.0,2.5,1778,2.0,0,0,1778,0,1999,435000.0
3.0,2.5,1930,2.0,0,0,1930,0,1990,425000.0
2.0,0.75,1130,1.0,0,0,1130,0,1956,204950.0
2.0,1.75,1650,1.0,0,0,1000,650,1959,670000.0
2.0,1.0,820,1.0,0,0,820,0,1921,475000.0
5.0,2.5,2900,1.0,0,0,1450,1450,1964,352000.0
4.0,1.75,2330,1.0,0,2,1260,1070,1961,575000.0
4.0,3.5,4440,2.0,0,2,3240,1200,1965,1730000.0
3.0,2.0,1660,2.0,0,3,1660,0,1950,491000.0
4.0,2.5,3020,2.0,0,0,3020,0,2004,750000.0
4.0,2.5,1850,1.0,0,0,1430,420,1978,830000.0
6.0,3.75,5960,2.0,0,4,3900,2060,2005,1140000.0
3.0,1.0,960,1.0,0,0,960,0,1970,137124.0
4.0,1.0,1150,1.5,0,0,1150,0,1907,225000.0
4.0,2.5,2130,1.0,0,0,1230,900,1963,732600.0
4.0,2.25,2460,2.0,0,0,2460,0,1984,818000.0
3.0,2.25,2360,1.0,0,0,2360,0,1978,431000.0
2.0,2.25,1320,3.0,0,0,1320,0,1996,304000.0
5.0,2.0,1910,1.0,0,0,1010,900,1908,650000.0
2.0,2.0,1610,2.0,0,0,1610,0,1977,450000.0
4.0,1.0,1610,1.0,0,0,1610,0,1958,269000.0
3.0,1.0,1160,1.0,0,0,1160,0,1953,875000.0
4.0,2.25,2870,1.0,0,0,1480,1390,1977,890000.0
4.0,2.5,2280,2.0,0,0,2280,0,1986,565000.0
2.0,2.0,1370,2.0,0,0,1150,220,2006,448175.0
,,1470,2.0,0,0,1470,0,1996,235000.0
5.0,3.0,2970,2.0,0,0,2970,0,2000,680000.0
3.0,1.75,1460,2.0,1,4,1120,340,1970,629000.0
3.0,3.5,1570,2.5,0,0,1330,240,2000,494000.0
4.0,3.0,2880,2.0,0,0,1920,960,1926,1100000.0
5.0,2.5,1900,1.0,0,0,1190,710,1969,450000.0
3.0,1.75,2020,1.0,0,0,1320,700,1969,330000.0
4.0,2.5,3110,2.0,0,3,3110,0,1984,960000.0
4.0,2.5,2390,2.0,0,0,2390,0,1990,360000.0
3.0,2.5,2150,2.0,0,0,2150,0,2004,378000.0
3.0,1.75,1340,1.0,0,0,1090,250,1941,499950.0
3.0,2.5,1990,2.0,0,0,1990,0,1986,450000.0
2.0,2.0,1600,1.0,0,0,800,800,1950,523500.0
3.0,2.5,2680,2.0,0,0,2680,0,1986,600000.0
3.0,2.5,2080,2.0,0,0,2080,0,2002,290000.0
3.0,3.25,1340,2.0,0,0,1340,0,1986,176000.0
3.0,2.0,2590,1.5,0,0,1790,800,1904,885000.0
2.0,1.75,1240,1.5,0,0,1240,0,1906,483000.0
3.0,1.0,1310,1.0,0,0,1310,0,1978,240000.0
4.0,2.25,2530,1.0,0,1,1530,1000,1957,720000.0
4.0,2.5,1780,2.0,0,0,1780,0,2001,311000.0
3.0,2.0,1600,1.0,0,0,1600,0,1950,332500.0
3.0,1.75,1570,1.0,0,0,1080,490,1956,164950.0
3.0,1.75,1570,1.0,0,0,1080,490,1956,371000.0
3.0,1.75,1650,1.0,0,0,1650,0,1976,264500.0
4.0,2.25,2920,2.0,0,0,2260,660,1937,1738000.0
2.0,1.0,870,1.0,0,2,870,0,1921,503000.0
4.0,2.5,2830,2.0,0,0,2170,660,2000,738000.0
2.0,1.0,980,1.0,0,0,980,0,1925,393000.0
2.0,1.0,990,1.0,0,0,990,0,1992,280000.0
4.0,2.5,2360,1.0,0,2,1530,830,1964,260000.0
2.0,1.0,1000,1.0,0,2,1000,0,1915,505000.0
3.0,1.5,1660,1.0,0,0,1120,540,1976,241000.0
3.0,1.75,1520,1.0,0,0,1520,0,1975,530000.0
1.0,1.0,1180,1.5,0,2,840,340,1910,713000.0
3.0,1.75,1770,2.0,0,0,1770,0,1944,487000.0
2.0,1.0,980,1.0,0,0,980,0,1969,128000.0
3.0,1.0,1840,1.0,0,0,1040,800,1960,210500.0
3.0,2.5,1810,1.0,0,0,1210,600,1968,420000.0
3.0,2.5,1780,2.0,0,0,1780,0,1930,679000.0
4.0,2.75,2840,3.0,0,0,2840,0,2014,784950.0
4.0,2.5,2650,2.0,0,0,2650,0,1998,352000.0
3.0,1.5,1270,2.0,0,0,1080,190,2004,386000.0
3.0,1.75,1260,1.0,0,0,1260,0,1994,335000.0
3.0,2.0,1750,1.0,0,0,1490,260,1982,472500.0
5.0,2.25,2680,1.0,0,0,1340,1340,1976,599950.0
4.0,3.25,3830,2.0,0,0,3830,0,2014,963990.0
3.0,2.0,1610,2.0,0,2,1610,0,1925,735000.0
3.0,4.25,3840,2.0,0,0,3840,0,1998,858450.0
5.0,2.75,2670,2.0,0,0,1800,870,1914,665000.0
3.0,2.5,2000,2.0,0,0,2000,0,1993,290000.0
2.0,1.0,860,1.0,0,0,860,0,1925,250000.0
3.0,1.75,1420,1.0,0,0,1420,0,1986,192500.0
4.0,2.0,2060,1.0,0,2,2060,0,1957,350000.0
4.0,2.5,2790,2.0,0,0,2790,0,2003,518000.0
4.0,1.0,1410,1.5,0,0,1410,0,1911,563000.0
4.0,3.0,2420,2.0,0,0,2420,0,2003,375000.0
3.0,2.5,1460,3.0,0,0,1460,0,2002,400000.0
5.0,1.75,2460,1.0,0,0,1230,1230,1957,240000.0
2.0,1.0,1000,1.0,0,0,1000,0,1902,317500.0
5.0,4.0,4420,2.0,0,0,2740,1680,1982,1315000.0
3.0,1.0,1240,1.0,0,0,1240,0,1921,234000.0
3.0,2.5,1740,2.0,0,0,1740,0,1975,645000.0
2.0,1.0,1280,1.0,0,0,1200,80,1908,649000.0
4.0,2.5,2520,2.0,0,0,2520,0,2004,605000.0
3.0,3.5,1500,3.0,0,0,1500,0,1999,337900.0
3.0,2.75,2490,2.0,0,0,2290,200,1906,535000.0
4.0,1.0,1530,1.0,0,0,1130,400,1957,325000.0
4.0,2.25,1740,1.0,0,0,1740,0,1967,429950.0
3.0,2.5,3550,2.0,0,0,3550,0,1989,775000.0
2.0,1.0,1280,1.0,0,0,1280,0,1965,650000.0
4.0,2.25,2320,2.0,0,0,2320,0,1967,1200000.0
2.0,1.0,1140,1.0,0,0,1140,0,1935,275000.0
4.0,3.5,3930,2.0,0,0,3930,0,1997,575000.0
3.0,2.5,2370,1.0,0,0,1640,730,1959,540000.0
3.0,1.75,2340,1.0,0,0,1170,1170,1917,640000.0
3.0,1.5,1240,1.0,0,0,1240,0,1967,275000.0
4.0,2.5,2740,2.0,0,0,2740,0,1997,672800.0
4.0,2.25,1940,1.0,0,0,1430,510,1956,495000.0
3.0,2.5,2950,1.5,0,0,2950,0,1995,820000.0
4.0,2.75,1980,1.0,0,0,1980,0,1952,475000.0
4.0,2.0,2850,1.0,0,4,1450,1400,1970,1275000.0
3.0,1.0,1160,1.0,0,0,1160,0,1967,380000.0
3.0,2.0,2130,1.0,0,0,2130,0,1987,397500.0
5.0,2.5,2420,1.0,0,2,1620,800,1978,352000.0
6.0,2.5,2820,1.0,0,0,1430,1390,1967,893880.0
5.0,3.25,3710,2.0,0,0,2510,1200,1986,635000.0
3.0,2.25,1770,2.0,0,0,1770,0,1977,420000.0
3.0,2.0,1260,1.0,0,0,750,510,1987,503000.0
2.0,1.75,2330,1.0,0,2,1220,1110,1953,689000.0
4.0,2.75,2490,1.5,0,0,1610,880,1922,749500.0
6.0,3.75,4090,2.0,0,0,3100,990,1984,1150000.0
4.0,2.5,2800,2.0,0,0,2800,0,2001,563500.0
4.0,3.0,2440,2.0,0,0,1890,550,1981,480000.0
4.0,3.0,2540,1.0,0,1,1620,920,1977,374950.0
3.0,2.5,1600,2.0,0,0,1600,0,1995,308950.0
4.0,2.75,2680,1.0,0,0,1340,1340,1958,445000.0
3.0,1.5,1220,1.0,0,0,1220,0,1968,237200.0
3.0,1.75,1550,1.5,0,0,1550,0,1953,453500.0
3.0,2.0,2080,1.0,0,0,1040,1040,1954,616500.0
5.0,5.0,5000,2.0,0,0,5000,0,2000,1250000.0
1.0,1.0,630,1.0,0,0,630,0,1954,396000.0
3.0,1.0,1070,1.0,0,0,1070,0,1949,210000.0
2.0,1.75,1900,1.0,0,0,1200,700,1919,539000.0
3.0,2.5,2960,2.0,0,0,2960,0,1979,605000.0
3.0,2.0,1490,2.0,0,0,1490,0,1948,437500.0
3.0,1.5,1500,1.0,0,0,1500,0,1952,215000.0
4.0,2.5,2410,2.0,0,0,2410,0,2000,440000.0
3.0,1.0,2000,1.0,0,0,1680,320,1939,525000.0
3.0,1.5,1140,1.0,0,0,840,300,1985,319900.0
3.0,1.0,1120,1.0,0,0,1120,0,1977,335000.0
3.0,2.25,2900,2.0,0,0,2900,0,1986,485000.0
4.0,2.25,3220,2.0,0,0,3220,0,1976,359999.0
5.0,2.75,2500,1.0,0,3,2500,0,1959,799000.0
3.0,2.25,1610,1.0,0,0,1610,0,1977,280000.0
4.0,2.75,2250,1.5,0,0,1500,750,1927,1050000.0
1.0,2.0,1240,2.0,0,0,1240,0,1910,290000.0
2.0,2.25,1660,2.0,0,0,1660,0,1995,235000.0
3.0,1.75,2080,1.0,0,0,1040,1040,1925,495000.0
3.0,2.25,1880,2.0,0,0,1880,0,1980,290000.0
4.0,1.5,1050,1.0,0,0,1050,0,1969,230000.0
3.0,1.75,1480,1.0,0,0,1480,0,1968,234000.0
4.0,2.5,2420,2.0,0,0,2420,0,2001,597400.0
4.0,2.5,2190,1.0,0,0,1110,1080,1966,370000.0
4.0,2.5,2660,2.0,0,0,2660,0,1993,755000.0
3.0,2.5,2430,2.0,0,0,2430,0,1999,342000.0
2.0,1.0,770,1.0,0,0,770,0,1918,497000.0
3.0,1.0,3060,1.0,0,0,3060,0,1959,835000.0
4.0,2.75,2920,2.0,0,0,2920,0,1999,730000.0
3.0,1.0,1370,1.0,0,0,1070,300,1939,655000.0
3.0,2.5,1870,2.0,0,0,1870,0,1993,205000.0
4.0,2.0,1800,1.5,0,0,1800,0,1918,632750.0
5.0,3.0,2100,1.0,0,0,1250,850,2013,330000.0
5.0,2.25,2530,2.0,0,0,2530,0,1961,527500.0
4.0,2.5,3290,2.0,0,0,3290,0,2002,716500.0
4.0,2.5,1890,2.0,0,0,1890,0,2006,388500.0
3.0,1.75,1680,1.0,0,0,1680,0,1967,530000.0
3.0,2.5,2170,2.0,0,0,2170,0,2002,419000.0
3.0,1.75,1200,1.0,0,0,1200,0,1978,385000.0
4.0,2.5,2990,2.0,0,0,2990,0,2003,655000.0
4.0,2.75,3770,2.0,0,2,3070,700,1924,1695000.0
2.0,1.0,1020,1.0,0,0,1020,0,1904,279000.0
3.0,1.5,1700,1.0,0,0,1100,600,1962,262000.0
4.0,1.0,1550,1.5,0,0,1550,0,1919,533000.0
3.0,1.75,1680,1.0,0,2,1680,0,1950,640000.0
3.0,2.25,1680,2.0,0,0,1680,0,1987,285000.0
4.0,2.5,1910,1.0,0,0,1910,0,1921,458400.0
5.0,3.25,3160,1.0,0,0,2190,970,1960,620000.0
3.0,1.5,2020,1.0,0,0,1190,830,1956,465000.0
4.0,3.75,3210,2.0,0,0,3210,0,1985,690000.0
3.0,2.25,2350,1.0,0,0,1390,960,1977,462500.0
4.0,2.5,1910,2.0,0,0,1910,0,1994,369950.0
2.0,1.0,840,1.0,0,0,840,0,1954,124500.0
4.0,2.25,2620,1.0,0,0,2620,0,1965,950000.0
4.0,1.5,1220,1.0,0,0,1220,0,1965,418000.0
3.0,1.0,1060,1.0,0,0,1060,0,1927,160000.0
4.0,2.5,2200,1.0,0,0,1500,700,1964,457000.0
2.0,1.75,2120,1.0,0,0,1130,990,1948,530000.0
3.0,1.0,1250,1.0,0,0,1250,0,1956,385000.0
3.0,1.75,1440,1.0,0,0,1440,0,1958,491000.0
4.0,2.25,1890,1.0,0,0,1890,0,1967,521000.0
3.0,1.0,1140,1.0,0,0,1140,0,1967,255000.0
5.0,3.0,2840,1.0,0,0,1710,1130,2003,292050.0
6.0,3.0,1880,1.0,0,0,1880,0,1966,326000.0
2.0,1.0,750,1.0,0,0,750,0,1941,300000.0
3.0,1.75,1630,1.0,0,0,1330,300,1979,291600.0
5.0,1.5,1720,1.0,0,0,1720,0,1967,435000.0
3.0,2.5,1600,3.0,0,0,1600,0,2005,465000.0
3.0,2.25,1230,1.5,0,0,1230,0,1913,200000.0
3.0,1.5,1610,1.0,0,2,1090,520,1959,238000.0
4.0,2.5,1320,1.0,0,0,1320,0,1956,455000.0
6.0,3.0,2180,2.0,0,0,2180,0,1980,230000.0
4.0,2.25,2190,2.0,0,0,1410,780,1928,808000.0
3.0,1.0,1490,1.5,0,0,1490,0,1916,578500.0
3.0,2.0,1463,3.0,0,0,1463,0,2003,390000.0
3.0,2.5,1800,2.0,0,0,1800,0,1989,517500.0
4.0,2.75,2880,1.5,0,0,2100,780,1912,755000.0
3.0,1.75,1250,1.0,0,0,980,270,1925,579500.0
3.0,2.75,1670,3.0,0,0,1350,320,2014,649950.0
4.0,1.75,2000,1.0,0,0,1100,900,1965,228000.0
4.0,1.75,2280,1.5,0,0,1470,810,1926,665000.0
4.0,2.5,2110,2.0,0,0,2110,0,1999,689000.0
4.0,2.5,2520,1.0,0,0,1440,1080,1977,560000.0
3.0,1.0,1590,1.0,0,0,1590,0,1944,529000.0
5.0,2.5,2100,1.0,0,0,2100,0,1970,375000.0
4.0,2.75,2090,1.0,0,0,2090,0,1949,325000.0
4.0,2.5,3390,2.0,0,2,3390,0,1990,583000.0
2.0,1.0,790,1.0,0,0,790,0,1932,330000.0
3.0,2.5,1970,2.0,0,0,1970,0,1995,262000.0
4.0,2.5,2870,2.0,0,0,2870,0,2004,555000.0
2.0,1.0,1110,1.0,0,0,1010,100,1951,585000.0
3.0,2.75,1940,2.0,0,3,1770,170,2008,425590.0
2.0,1.0,720,1.0,0,0,720,0,1947,235000.0
2.0,1.0,710,1.0,0,0,710,0,1909,362362.0
3.0,2.0,1370,1.0,0,0,1370,0,1997,252000.0
4.0,2.5,2690,2.0,0,0,2690,0,1992,439000.0
4.0,2.25,3360,2.0,0,0,3360,0,1988,465000.0
4.0,2.0,1500,1.5,0,0,1500,0,1983,249900.0
2.0,2.5,2600,1.0,0,0,1300,1300,1926,665000.0
3.0,1.75,1160,1.0,0,0,1160,0,1972,370000.0
2.0,1.0,1430,1.5,0,0,1300,130,1929,620000.0
3.0,1.0,1870,1.0,0,0,1720,150,1937,375000.0
4.0,2.0,2560,1.0,0,0,1280,1280,1957,552625.0
3.0,1.0,1160,1.0,0,0,1160,0,1966,315500.0
2.0,1.75,1680,1.0,0,0,1680,0,1983,620000.0
4.0,2.5,2010,1.0,0,0,1310,700,1959,510000.0
4.0,2.5,2540,2.0,0,0,2540,0,1987,652500.0
4.0,2.5,3240,2.0,0,0,3240,0,1998,574000.0
3.0,2.5,2670,2.0,0,0,2670,0,2010,430000.0
3.0,2.0,1080,1.0,0,0,1080,0,1947,390000.0
3.0,1.0,1430,1.0,0,0,950,480,1945,466500.0
2.0,2.25,1290,2.0,0,0,1290,0,1984,315000.0
4.0,1.5,1240,1.0,0,0,1240,0,1971,220000.0
3.0,1.75,1840,1.0,0,0,1440,400,1978,325000.0
3.0,1.0,1120,1.0,0,0,1120,0,1953,365000.0
3.0,3.5,2100,2.0,0,0,2100,0,1980,356000.0
4.0,1.75,2030,1.0,0,0,1610,420,1950,380000.0
4.0,2.25,2030,2.0,0,0,2030,0,1983,579000.0
2.0,1.0,890,1.0,0,0,890,0,1943,682000.0
3.0,1.75,1750,1.0,0,0,1470,280,1968,499000.0
3.0,1.0,1300,1.0,0,0,1300,0,1968,333760.0
4.0,2.5,2650,2.0,0,0,2650,0,1994,745000.0
3.0,1.75,1750,1.0,0,0,1750,0,1968,380000.0
3.0,3.0,1440,3.5,0,2,1440,0,2005,435000.0
3.0,2.75,1700,1.0,0,0,1060,640,1919,520000.0
4.0,2.5,3920,2.0,0,0,3920,0,1988,965000.0
3.0,2.25,1470,1.0,0,0,1350,120,1959,270000.0
5.0,2.75,2520,1.5,0,0,2120,400,1916,1100000.0
3.0,1.75,2140,1.0,0,0,1220,920,1964,577500.0
3.0,1.75,1550,1.0,0,0,1250,300,1911,650000.0
4.0,2.5,3180,2.0,0,0,3180,0,1986,1227500.0
5.0,4.25,6510,2.0,0,3,3250,3260,1980,1900000.0
2.0,2.0,1440,1.5,0,0,1440,0,1983,475000.0
3.0,1.0,1150,1.0,0,0,1150,0,1970,200000.0
4.0,2.5,2320,2.0,0,0,2320,0,1997,397000.0
3.0,2.0,1230,1.0,0,0,1230,0,1989,383610.0
4.0,2.5,2060,2.0,0,0,2060,0,1999,275000.0
3.0,2.0,2783,2.0,0,0,2783,0,1910,840000.0
4.0,2.5,2140,2.0,0,0,2140,0,1985,365000.0
3.0,2.75,1420,2.0,0,0,1160,260,2004,362000.0
3.0,1.75,2090,1.0,0,0,1390,700,1956,350000.0
2.0,1.75,1320,1.5,0,0,1320,0,1980,200000.0
4.0,2.5,2300,1.0,0,0,1360,940,1979,299000.0
4.0,1.5,3050,1.0,0,0,1650,1400,1966,555000.0
3.0,2.25,2960,1.0,0,3,2260,700,1953,1326000.0
5.0,2.75,2520,1.0,0,3,1570,950,1960,896000.0
2.0,1.75,1740,1.0,0,0,1280,460,1950,550000.0
2.0,1.0,1300,1.0,0,0,1300,0,1986,324500.0
3.0,1.0,1170,1.0,0,0,1170,0,1960,312500.0
4.0,3.25,1946,2.0,0,1,1946,0,1990,485000.0
2.0,1.0,1250,1.0,0,0,1250,0,1923,511000.0
2.0,1.5,1230,2.0,0,0,1230,0,1983,139500.0
4.0,2.5,2180,2.0,0,0,2180,0,1989,464000.0
3.0,1.75,1740,1.0,0,0,1140,600,1978,255000.0
4.0,2.5,3830,2.0,0,0,2900,930,2004,679975.0
3.0,2.0,2250,1.0,0,0,1500,750,1964,624800.0
3.0,2.75,2590,2.0,0,0,2590,0,1983,920000.0
3.0,2.5,2090,1.5,0,0,2090,0,1928,1365000.0
3.0,1.5,2400,1.0,0,0,1540,860,1964,510000.0
4.0,2.25,2260,2.0,0,0,2260,0,1984,289659.0
4.0,2.5,2910,2.0,0,0,2910,0,1999,585000.0
5.0,3.0,3640,2.0,0,0,3640,0,2004,555000.0
4.0,2.75,3770,2.0,0,2,2550,1220,1964,940000.0
3.0,2.0,1600,1.0,0,0,1600,0,1979,460000.0
3.0,2.5,2110,2.0,0,0,2110,0,1978,319000.0
3.0,2.5,1720,2.0,0,0,1720,0,2005,280000.0
3.0,1.0,1100,1.0,0,0,1100,0,1917,250000.0
4.0,2.5,2620,2.0,0,0,2620,0,1990,749950.0
5.0,2.5,3090,1.0,0,0,2990,100,1957,458000.0
3.0,2.5,1890,2.0,0,0,1890,0,2000,465000.0
3.0,1.75,1850,1.0,0,0,1150,700,1977,580000.0
4.0,2.5,3100,2.0,0,0,3100,0,1994,700000.0
4.0,2.5,2506,2.0,0,0,2506,0,2007,350000.0
4.0,1.0,1700,1.0,0,0,1080,620,1977,456000.0
3.0,2.0,1550,1.5,0,0,1550,0,1983,290000.0
4.0,2.75,2200,1.0,0,0,1290,910,1980,475000.0
3.0,2.5,1890,2.0,0,0,1890,0,2005,285000.0
3.0,1.0,1140,1.0,0,0,1140,0,1962,309000.0
4.0,2.0,3740,2.0,0,0,3740,0,2000,860000.0
3.0,2.25,1940,1.0,0,0,1440,500,1979,219000.0
3.0,2.5,2130,2.0,0,0,2130,0,1990,546500.0
2.0,1.0,1470,1.0,0,0,770,700,1919,338000.0
2.0,1.0,1070,1.0,0,0,1070,0,1942,505000.0
4.0,1.75,1680,1.0,0,0,840,840,1979,340000.0
3.0,2.25,2730,2.0,0,0,2730,0,1990,678000.0
3.0,1.75,1890,1.0,0,0,1890,0,1969,800000.0
1.0,1.0,1080,1.0,0,0,1080,0,1963,112000.0
3.0,1.75,1440,1.5,0,0,1440,0,1925,252000.0
4.0,2.75,2540,1.0,0,0,1600,940,1979,335000.0
3.0,2.0,2300,1.0,0,0,1430,870,1955,610000.0
3.0,2.0,1690,1.0,0,0,1360,330,1979,245000.0
3.0,1.75,1800,1.0,0,0,1390,410,1972,493500.0
4.0,2.25,1770,2.0,0,0,1770,0,1986,596500.0
3.0,2.0,1190,1.5,0,0,1190,0,1907,245000.0
3.0,1.75,1320,1.0,0,0,1320,0,1977,333500.0
3.0,1.0,1290,1.0,0,0,1290,0,1976,373000.0
4.0,2.5,3000,2.0,0,0,3000,0,2008,759900.0
3.0,2.25,1358,3.0,0,0,1358,0,2007,317000.0
3.0,1.5,1220,1.5,0,0,1220,0,1914,670000.0
2.0,2.5,2720,2.0,1,4,2720,0,1990,985000.0
3.0,1.5,1060,1.0,0,0,1060,0,1983,310000.0
4.0,2.5,3020,2.0,0,0,2540,480,1997,750000.0
3.0,2.0,1640,2.0,0,0,1640,0,1987,408000.0
5.0,3.75,3870,2.0,0,0,3870,0,1998,900000.0
4.0,2.25,2860,1.0,0,0,1460,1400,1957,460000.0
4.0,2.5,1740,1.0,0,0,1740,0,1952,339000.0
3.0,2.0,1140,1.0,0,0,1140,0,1909,660000.0
4.0,3.0,3290,2.0,0,0,3290,0,1990,449950.0
3.0,1.0,1210,1.0,0,0,1210,0,1930,235000.0
5.0,2.25,3320,1.0,0,2,1900,1420,1964,769000.0
2.0,2.0,1350,1.0,0,0,1350,0,2003,428000.0
3.0,2.25,1990,2.0,0,0,1990,0,1984,445000.0
4.0,2.5,2060,1.0,0,0,1220,840,1974,462000.0
3.0,1.0,1460,1.5,0,0,1460,0,1916,775000.0
4.0,1.75,2250,1.0,0,0,2250,0,1967,605000.0
2.0,1.0,950,1.0,0,0,950,0,1946,193500.0
4.0,2.5,3140,2.0,0,0,3140,0,1991,389950.0
4.0,3.5,3560,2.0,0,0,3560,0,2006,790000.0
2.0,1.0,1410,1.0,0,2,940,470,1918,442000.0
4.0,2.25,2770,2.0,0,0,2770,0,1974,890000.0
3.0,1.0,1864,1.0,0,0,1864,0,1958,235000.0
4.0,1.75,1930,1.0,0,2,1130,800,1959,495000.0
4.0,2.5,3870,2.0,0,0,3870,0,2007,600000.0
3.0,2.0,2020,1.5,0,3,1790,230,1937,1400000.0
3.0,2.0,1300,1.0,0,0,1300,0,1967,251000.0
4.0,2.25,3410,2.0,0,0,2410,1000,1978,471000.0
4.0,2.5,2370,2.0,0,0,2370,0,1995,597000.0
5.0,3.5,2770,2.0,0,0,2770,0,1985,804000.0
3.0,1.75,1250,1.0,0,0,1250,0,1972,357000.0
3.0,2.5,1690,2.0,0,0,1150,540,2014,419990.0
4.0,2.5,3040,2.0,0,0,3040,0,1987,725000.0
3.0,2.5,2710,2.0,0,0,2710,0,2003,275000.0
3.0,2.25,1190,1.0,0,0,1190,0,1984,445000.0
3.0,2.5,2300,2.0,0,0,2300,0,1995,510000.0
4.0,1.0,1360,1.0,0,0,1360,0,1955,330000.0
3.0,1.0,1500,1.0,0,0,750,750,1942,270000.0
4.0,2.0,1610,1.0,0,0,1230,380,1941,495000.0
4.0,1.75,1420,2.0,0,0,1420,0,1950,225000.0
3.0,1.5,1750,1.0,0,0,1050,700,1952,716528.0
3.0,2.5,1510,2.0,0,0,1510,0,1991,260000.0
4.0,2.5,2330,2.0,0,0,2330,0,1998,471000.0
5.0,3.5,2690,2.0,0,2,1930,760,1919,690000.0
5.0,1.5,1700,1.5,0,0,1700,0,1937,548000.0
3.0,1.0,1020,1.0,0,0,880,140,1928,505000.0
3.0,1.0,1160,1.0,0,0,1160,0,1966,325000.0
4.0,2.25,2450,2.0,0,0,2450,0,1980,682000.0
3.0,2.25,2010,2.0,0,0,2010,0,1985,605000.0
2.0,1.75,1370,1.0,0,0,1370,0,1975,276200.0
3.0,1.0,1370,1.5,0,0,1370,0,1906,530000.0
3.0,3.0,1990,1.0,0,0,1440,550,1988,245000.0
4.0,2.5,2790,2.0,0,0,2790,0,1987,654950.0
2.0,1.0,780,1.0,0,0,780,0,1939,221900.0
4.0,2.0,2240,1.0,0,2,1340,900,1926,466000.0
3.0,2.0,2210,1.0,0,0,2210,0,2003,383150.0
4.0,1.0,1390,1.0,0,0,1050,340,1924,657100.0
3.0,2.0,1800,2.0,0,0,1800,0,1988,539000.0
6.0,3.0,3320,1.0,0,0,1660,1660,1977,400000.0
4.0,2.5,1960,1.0,0,0,980,980,1931,215000.0
2.0,1.0,850,1.0,0,0,850,0,1927,489000.0
4.0,2.5,2980,2.0,0,0,2980,0,1994,649000.0
4.0,1.75,1980,1.0,0,0,1320,660,1953,700000.0
2.0,1.0,790,1.0,0,0,790,0,1953,268500.0
3.0,2.5,1800,2.0,0,0,1800,0,1996,515000.0
4.0,2.0,2260,1.0,0,0,2260,0,1978,685000.0
2.0,1.5,800,2.0,0,0,800,0,2006,305000.0
4.0,2.0,2490,1.5,0,2,2090,400,1926,950000.0
4.0,2.5,1610,2.0,0,0,1610,0,2006,292500.0
4.0,1.75,1850,1.0,0,0,1100,750,1956,270000.0
4.0,1.75,1850,1.0,0,0,1100,750,1956,450000.0
4.0,1.0,1920,1.5,0,0,1920,0,1920,535000.0
3.0,2.5,1740,2.0,0,0,1740,0,2000,550000.0
3.0,2.25,1430,2.0,0,0,980,450,1996,457500.0
3.0,1.5,1420,1.0,0,0,1420,0,1962,136500.0
3.0,1.5,1420,1.0,0,0,1420,0,1962,224097.0
3.0,2.5,1560,2.0,0,0,1560,0,1994,254000.0
4.0,2.25,2030,1.0,0,0,1230,800,1963,335000.0
5.0,2.5,3280,2.0,0,0,3280,0,2012,594950.0
3.0,1.75,1360,1.0,0,0,1360,0,1983,350000.0
3.0,1.0,1180,1.0,0,0,1180,0,1970,169950.0
3.0,2.5,1940,1.0,0,0,1340,600,1979,432500.0
2.0,1.75,1300,2.0,0,0,1300,0,1948,440000.0
3.0,2.25,1650,2.0,0,0,1650,0,1985,233703.0
3.0,1.5,1140,2.0,0,0,1140,0,1988,310000.0
3.0,2.5,2540,2.0,0,0,2540,0,1998,735000.0
4.0,2.75,3440,2.0,0,0,3440,0,2014,730000.0
3.0,1.75,1800,1.0,0,0,1200,600,1961,257000.0
2.0,2.25,1260,3.0,0,0,1260,0,2004,485000.0
4.0,2.25,2370,1.0,0,2,1440,930,1959,899000.0
3.0,1.0,1520,1.5,0,0,1520,0,1952,279000.0
4.0,2.0,1750,1.0,0,0,1050,700,1974,225000.0
3.0,1.5,2680,2.0,0,2,1880,800,1913,1355000.0
3.0,2.5,1590,2.0,0,0,1590,0,2000,355000.0
4.0,1.75,1560,1.0,0,0,1560,0,1967,382500.0
3.0,2.5,2000,2.0,0,0,2000,0,1992,324360.0
3.0,1.75,2380,1.5,0,0,2380,0,1966,315000.0
2.0,1.0,2230,2.0,0,0,2230,0,1951,426000.0
5.0,2.5,2820,2.0,0,0,2820,0,2003,395000.0
3.0,1.0,1570,1.5,0,0,1570,0,1922,212644.0
3.0,3.0,1845,2.0,0,2,1845,0,1947,510000.0
2.0,1.0,830,1.0,0,0,830,0,1939,85000.0
2.0,1.0,830,1.0,0,0,830,0,1939,235000.0
4.0,2.5,2030,2.0,0,0,2030,0,2001,295000.0
3.0,2.5,1430,1.5,0,0,1430,0,1910,720001.0
3.0,1.0,1510,1.0,0,0,860,650,1940,313950.0
3.0,1.0,1510,1.0,0,0,860,650,1940,415000.0
3.0,1.75,1610,1.0,0,0,1610,0,1981,305000.0
3.0,1.5,1600,1.5,0,0,1250,350,1906,625000.0
3.0,1.0,1420,1.0,0,0,1420,0,1961,490000.0
3.0,2.0,1660,2.0,0,0,1660,0,1987,269950.0
5.0,4.0,4230,2.0,1,4,3230,1000,1949,2700000.0
4.0,3.0,3310,2.5,0,0,2910,400,1900,829000.0
4.0,2.5,2470,1.0,0,0,2470,0,1987,635000.0
3.0,1.0,1040,1.0,0,0,1040,0,1959,217500.0
4.0,1.75,1850,1.0,0,0,1050,800,1965,270000.0
3.0,3.0,4610,2.0,0,2,2790,1820,1947,1245000.0
4.0,2.5,2480,2.0,0,0,2480,0,2007,480000.0
3.0,1.75,2130,1.0,0,2,1170,960,1954,575000.0
4.0,2.75,2350,2.0,0,0,2350,0,2001,426950.0
3.0,1.0,920,1.0,0,0,920,0,1960,125000.0
3.0,1.0,920,1.0,0,0,920,0,1960,208000.0
4.0,2.0,1780,1.0,0,0,900,880,1976,325000.0
7.0,4.0,2690,1.0,0,0,2690,0,1960,597157.0
4.0,2.5,3010,2.5,0,2,3010,0,2006,728725.0
5.0,2.0,3180,1.0,0,0,1910,1270,1968,708000.0
4.0,3.0,4120,2.0,0,0,4120,0,2005,1300000.0
3.0,1.0,1280,1.0,0,0,1280,0,1977,405000.0
4.0,2.75,1690,1.5,0,0,1400,290,1945,550000.0
4.0,2.5,2320,2.0,0,0,2320,0,2006,451000.0
5.0,3.75,3090,2.0,0,0,3090,0,2014,540500.0
5.0,3.5,5050,2.0,0,2,5050,0,2001,1025000.0
4.0,1.0,1640,1.0,0,0,950,690,1963,218000.0
4.0,2.25,2170,1.0,0,0,1540,630,1974,562000.0
4.0,2.5,3140,2.0,0,0,2280,860,1977,401500.0
2.0,1.0,1090,1.0,0,0,1090,0,1954,196700.0
3.0,1.75,1930,1.0,0,0,1480,450,1975,583000.0
5.0,2.5,2100,1.0,0,0,1400,700,1974,309900.0
4.0,3.0,3110,2.0,0,0,3110,0,1995,485000.0
3.0,1.0,930,1.0,0,0,930,0,1926,465000.0
4.0,2.25,2050,2.0,0,0,2050,0,1984,595000.0
3.0,1.0,1160,1.0,0,0,1160,0,1958,254000.0
3.0,2.75,1820,2.0,0,0,1820,0,1994,488500.0
4.0,2.5,2110,2.0,0,0,2110,0,1977,260000.0
2.0,1.0,870,1.0,0,0,870,0,1944,166000.0
2.0,1.5,1080,1.0,0,2,1080,0,1923,440000.0
3.0,2.0,1260,2.0,0,0,1260,0,1943,375000.0
2.0,1.0,900,1.0,0,0,780,120,1944,529500.0
2.0,1.0,750,1.0,0,0,750,0,1934,338000.0
3.0,2.25,1800,1.0,0,0,1340,460,1986,335620.0
4.0,2.25,2220,1.0,0,0,1690,530,1978,464000.0
2.0,1.0,1390,1.0,0,0,1390,0,1925,354000.0
4.0,3.5,2160,2.0,0,0,1660,500,1998,601000.0
3.0,2.25,1840,1.0,0,0,1370,470,1979,285000.0
2.0,2.0,1690,2.0,0,0,1690,0,1906,462500.0
4.0,2.5,2650,2.0,0,0,2650,0,1989,350000.0
4.0,1.0,1120,1.0,0,0,1120,0,1972,329000.0
4.0,2.5,2500,1.0,0,0,1320,1180,1984,312500.0
4.0,2.5,2220,2.0,0,0,2220,0,2001,370000.0
3.0,1.75,1260,1.0,0,0,1260,0,1979,399900.0
3.0,1.0,1480,1.5,0,0,1480,0,1925,398000.0
2.0,1.5,930,1.0,0,2,830,100,1909,550500.0
3.0,2.75,2780,1.5,0,0,1870,910,1913,709000.0
5.0,2.75,2770,1.0,0,0,1700,1070,1965,402000.0
3.0,1.5,1530,1.0,0,0,1530,0,1952,450000.0
3.0,2.25,2140,1.0,0,0,1440,700,1961,524000.0
4.0,2.75,4600,1.0,0,4,2400,2200,1989,800000.0
4.0,1.0,1760,1.0,0,0,1230,530,1966,185000.0
4.0,1.0,1760,1.0,0,0,1230,530,1966,365000.0
4.0,2.5,3110,2.0,0,0,3110,0,1989,925000.0
3.0,1.75,2260,1.0,0,0,1520,740,1968,714000.0
3.0,2.0,1460,1.0,0,0,1460,0,1972,495000.0
3.0,2.25,2050,1.0,0,0,1230,820,1990,535000.0
4.0,2.5,2340,1.0,0,0,2340,0,1953,880000.0
3.0,1.5,1230,1.0,0,0,1230,0,1949,150000.0
3.0,2.25,1880,1.0,0,0,1420,460,1972,554500.0
3.0,1.75,1280,1.5,0,0,1280,0,1916,520000.0
4.0,2.75,3660,2.0,0,0,3660,0,2014,839990.0
3.0,2.5,1650,2.0,0,0,1650,0,2003,500000.0
2.0,1.0,1960,1.5,0,0,1960,0,1936,305000.0
3.0,2.5,1580,2.0,0,0,1580,0,2003,247800.0
4.0,2.5,2490,2.0,0,0,2490,0,2000,344200.0
4.0,2.5,2000,2.0,0,0,2000,0,2003,459950.0
4.0,1.75,1550,1.0,0,0,1550,0,1967,229900.0
4.0,2.25,2820,1.0,0,1,1950,870,1974,750000.0
4.0,2.5,2600,1.0,0,0,1840,760,1983,509000.0
4.0,1.0,2200,1.0,0,4,1640,560,1956,680000.0
5.0,2.5,2500,1.0,0,0,1490,1010,1977,661500.0
2.0,1.0,1270,3.0,0,0,1270,0,2000,370000.0
4.0,2.75,2900,1.0,0,0,2410,490,1978,785000.0
2.0,1.0,840,1.0,0,0,840,0,1952,355000.0
4.0,2.0,1940,1.0,0,0,970,970,1951,446000.0
5.0,3.5,3490,2.0,0,0,3490,0,1996,830000.0
3.0,2.5,1940,2.0,0,0,1940,0,1990,324000.0
4.0,2.25,2490,2.0,0,0,2490,0,1981,500000.0
3.0,1.0,1390,1.0,0,0,1390,0,1951,745000.0
4.0,2.5,3940,2.0,0,0,2620,1320,1921,1197000.0
2.0,2.5,1760,1.0,0,0,1130,630,1988,385000.0
3.0,2.25,2560,1.0,0,0,1510,1050,1958,565000.0
4.0,2.5,2300,1.0,0,0,1420,880,1979,465000.0
3.0,3.25,1770,3.0,0,0,1770,0,2001,401000.0
3.0,1.75,2310,1.0,0,0,1630,680,1978,385000.0
3.0,2.5,2310,2.0,0,0,2310,0,1989,395000.0
5.0,1.5,2000,1.5,0,0,2000,0,1946,245000.0
3.0,2.0,1540,1.0,0,0,890,650,1994,500000.0
5.0,1.75,2590,1.0,0,0,1750,840,1979,334000.0
3.0,1.0,980,1.0,0,0,980,0,1953,550000.0
3.0,1.0,1730,1.0,0,0,1180,550,1961,216000.0
3.0,2.5,3070,3.0,0,0,2510,560,1928,340500.0
4.0,2.25,2100,2.0,0,0,2100,0,1975,375000.0
3.0,2.75,2080,1.0,0,3,1580,500,1966,600000.0
4.0,1.75,1890,1.0,0,0,1250,640,1960,375000.0
4.0,1.75,2000,1.5,0,0,1450,550,1926,536500.0
3.0,3.0,3030,2.0,0,0,1760,1270,1984,599900.0
2.0,1.5,1110,1.0,0,0,1110,0,1904,750000.0
3.0,1.0,1650,1.0,0,0,1170,480,1955,355000.0
3.0,2.0,1410,1.0,0,0,910,500,1947,590000.0
2.0,1.0,2140,1.0,0,0,1070,1070,1946,680000.0
3.0,2.5,1860,2.0,0,0,1860,0,1994,429000.0
2.0,1.0,1170,1.0,0,0,1170,0,1909,581000.0
3.0,1.5,980,1.0,0,0,980,0,1968,463800.0
5.0,5.5,7400,2.0,0,3,6290,1110,2001,2983000.0
5.0,1.75,1650,1.5,0,0,1650,0,1902,443000.0
3.0,2.5,1480,1.0,0,0,1180,300,1986,276200.0
5.0,3.5,4060,2.0,0,0,2960,1100,2001,630000.0
3.0,1.75,1370,2.0,0,0,1370,0,1927,570000.0
4.0,2.25,2480,2.0,0,2,2380,100,1929,979700.0
4.0,2.5,2030,1.5,0,0,1730,300,1921,730000.0
5.0,2.25,2200,1.0,0,0,1100,1100,1963,268450.0
3.0,1.75,1770,1.0,0,0,1270,500,1962,490000.0
3.0,2.5,2550,1.0,0,3,1750,800,1957,808000.0
3.0,1.0,1250,1.0,0,0,1250,0,1969,350000.0
4.0,1.75,2390,1.0,0,2,1390,1000,1957,695000.0
4.0,2.5,5730,2.0,0,4,4280,1450,1991,1228000.0
1.0,1.0,1120,1.5,0,0,1120,0,1950,309950.0
3.0,1.0,1270,1.0,0,0,650,620,1942,134000.0
4.0,2.5,2390,2.0,0,0,2390,0,1988,645500.0
3.0,2.0,1760,1.5,0,0,1540,220,1927,750000.0
3.0,2.5,2560,2.0,0,0,2110,450,1967,1399000.0
4.0,1.75,1820,1.0,0,0,1100,720,1955,344900.0
2.0,3.25,1840,3.0,0,0,1840,0,2001,601450.0
4.0,2.0,1810,2.0,0,0,1700,110,1909,575000.0
3.0,1.75,2470,1.0,0,1,1570,900,1962,405000.0
4.0,2.75,2520,2.0,0,0,2520,0,1999,518000.0
2.0,1.0,1600,1.0,0,0,1600,0,1947,265000.0
3.0,1.0,1280,1.0,0,0,1280,0,1969,180000.0
3.0,2.5,1590,2.0,0,0,1590,0,1985,285000.0
3.0,2.75,2000,1.0,0,0,1000,1000,1954,433000.0
3.0,1.75,1780,1.0,0,0,1350,430,1977,399000.0
3.0,2.5,1700,2.0,0,0,1700,0,1966,565000.0
3.0,1.5,1970,1.0,0,0,1970,0,1966,406500.0
4.0,1.75,1940,1.0,0,0,1090,850,1955,420000.0
4.0,3.5,3290,1.5,0,0,2290,1000,1906,965000.0
4.0,3.5,3500,2.0,0,0,2460,1040,1996,1375000.0
5.0,2.25,3260,2.0,0,0,3260,0,1982,353950.0
5.0,3.25,4230,2.0,0,0,3860,370,1996,847700.0
5.0,1.0,1590,1.5,0,0,1090,500,1942,185000.0
2.0,1.5,1010,1.0,0,0,1010,0,1923,269000.0
3.0,1.75,1820,1.0,0,0,1340,480,1976,422800.0
2.0,1.0,870,1.0,0,0,870,0,1947,379950.0
3.0,2.0,1620,1.0,0,0,1200,420,1969,525000.0
4.0,3.5,3980,2.0,0,2,3980,0,2006,810000.0
4.0,1.0,1630,1.0,0,0,1630,0,1962,209950.0
3.0,2.0,1230,2.0,0,0,1010,220,2003,439950.0
4.0,2.0,3510,1.0,0,2,2210,1300,1965,554820.0
4.0,2.5,2160,2.0,0,0,2160,0,2002,359000.0
3.0,1.0,1020,1.0,0,0,1020,0,1941,242500.0
3.0,1.75,1590,1.0,0,0,1590,0,1954,330000.0
3.0,2.25,3440,2.0,0,3,2190,1250,1979,740000.0
5.0,1.0,3020,2.0,0,0,3020,0,1901,630000.0
3.0,1.75,2280,1.0,0,3,1360,920,1941,750000.0
4.0,2.5,2790,2.0,0,0,2790,0,1999,695000.0
2.0,0.5,580,1.0,0,0,580,0,1941,109000.0
3.0,1.5,2030,1.0,0,0,1080,950,1961,389000.0
2.0,1.0,850,1.0,0,0,850,0,1924,447000.0
3.0,2.0,2480,1.0,0,0,2480,0,1955,1200000.0
3.0,1.75,1010,1.0,0,0,1010,0,1977,315000.0
3.0,2.5,2420,2.0,0,0,2420,0,1988,640000.0
3.0,2.25,2180,2.0,0,0,2180,0,1984,570000.0
3.0,2.75,1830,2.0,0,0,1830,0,1997,495000.0
5.0,2.75,2040,1.0,0,0,1200,840,1969,449500.0
4.0,2.75,2640,2.0,0,0,1840,800,1943,1084500.0
2.0,1.0,1060,1.0,0,0,1060,0,1952,294950.0
3.0,1.0,1640,1.0,0,0,1040,600,1960,170500.0
4.0,1.0,1190,1.5,0,0,1190,0,1926,312000.0
3.0,2.5,2180,1.0,0,0,2180,0,1992,350000.0
4.0,2.5,2120,2.0,0,0,2120,0,1989,690000.0
4.0,2.5,2210,2.0,0,0,2210,0,1999,375000.0
4.0,2.5,2510,2.0,0,0,2510,0,1987,575000.0
4.0,2.25,2500,1.0,0,0,1600,900,1978,646000.0
3.0,2.5,1560,2.0,0,0,1560,0,1974,239950.0
5.0,2.5,2510,1.5,0,0,1710,800,1929,400000.0
4.0,1.75,3060,1.0,0,0,3060,0,1958,455000.0
3.0,2.0,1310,1.0,0,0,1310,0,1990,240000.0
4.0,4.0,4260,2.0,0,0,3280,980,1939,3400000.0
3.0,2.0,2500,1.5,0,0,1680,820,1922,695000.0
2.0,1.0,670,1.0,0,0,670,0,1942,304950.0
3.0,1.75,1840,1.0,0,2,1140,700,1914,650000.0
3.0,1.75,1480,2.0,0,0,1480,0,1995,402500.0
3.0,2.5,2420,2.0,0,0,2420,0,1998,482000.0
3.0,2.0,1820,1.0,0,0,1120,700,1923,655000.0
5.0,2.75,1940,2.0,0,0,1940,0,1951,577000.0
3.0,2.5,1630,2.0,0,0,1630,0,1986,350000.0
4.0,2.25,2520,1.0,0,2,1680,840,1970,415000.0
4.0,2.5,2120,2.0,0,0,2120,0,1983,396400.0
3.0,2.5,2490,2.0,0,0,2490,0,2000,654300.0
4.0,2.5,3410,2.0,0,0,3410,0,2004,774950.0
4.0,2.0,2380,2.0,0,2,2380,0,1925,855000.0
3.0,2.5,2490,2.0,0,0,1670,820,1918,1145000.0
2.0,2.5,1240,2.0,0,0,1240,0,2007,330000.0
4.0,2.25,1900,1.0,0,0,1400,500,1959,290000.0
3.0,3.0,2390,1.5,0,0,2390,0,2008,519500.0
3.0,1.75,1810,1.0,0,0,1400,410,1977,450000.0
3.0,3.5,4490,2.0,1,4,4490,0,1993,3120000.0
3.0,1.0,1620,1.5,0,0,1620,0,1928,265000.0
4.0,2.5,2640,2.0,0,0,2640,0,1990,359000.0
4.0,3.75,2870,2.0,0,3,2510,360,2012,2000000.0
4.0,2.5,3250,1.0,0,2,2030,1220,1985,1050000.0
2.0,1.0,800,1.0,0,0,800,0,1946,402500.0
3.0,1.75,1360,1.0,0,0,1360,0,1957,450000.0
5.0,2.25,1950,1.0,0,0,1130,820,1980,262500.0
4.0,2.25,1970,2.0,0,0,1970,0,1979,285000.0
3.0,2.5,2020,2.0,0,0,2020,0,2005,290000.0
2.0,2.5,2280,1.0,0,0,2280,0,2005,752500.0
4.0,2.75,3540,2.0,0,0,3540,0,1998,820000.0
3.0,2.5,1560,2.0,0,0,1560,0,1999,292000.0
2.0,1.0,750,1.0,0,2,750,0,1937,213000.0
4.0,3.0,2240,2.0,0,0,2240,0,1942,400000.0
1.0,0.75,590,1.0,0,0,590,0,1944,202000.0
1.0,,690,1.0,0,0,690,0,1948,484000.0
3.0,2.0,1580,1.0,0,0,1080,500,1981,617450.0
3.0,1.0,1040,1.0,0,0,1040,0,1956,250000.0
5.0,1.75,1880,1.0,0,0,960,920,1963,405000.0
2.0,1.0,1070,1.0,0,0,1070,0,1951,325000.0
3.0,3.0,1860,1.0,0,0,1040,820,1954,301350.0
2.0,1.75,1550,1.0,0,0,1050,500,1940,425000.0
3.0,1.0,1860,1.0,0,0,1470,390,1954,460000.0
3.0,2.5,3090,2.0,0,2,3090,0,1992,938000.0
3.0,1.75,1720,1.0,0,0,1320,400,1985,348000.0
2.0,1.0,1260,1.5,0,0,1260,0,1926,435000.0
3.0,1.5,1120,1.0,0,0,1120,0,1963,227950.0
2.0,1.0,1250,1.0,0,0,900,350,1948,425000.0
3.0,2.0,1810,1.5,0,0,1810,0,1925,550000.0
3.0,2.5,1890,2.0,0,0,1890,0,1992,347500.0
4.0,1.75,2020,1.0,0,0,1620,400,1959,397000.0
4.0,1.75,1790,1.0,0,0,1490,300,1969,410000.0
3.0,3.5,3190,2.0,0,0,3190,0,1998,780000.0
4.0,3.25,3030,1.5,0,0,2700,330,1925,1350000.0
3.0,2.25,1630,2.0,0,0,1630,0,2004,476000.0
3.0,1.75,1180,1.0,0,0,1180,0,1967,390000.0
3.0,2.0,1560,1.0,0,0,1560,0,1968,226500.0
3.0,2.0,1340,2.0,0,0,1340,0,1984,495000.0
5.0,3.25,2590,1.0,0,2,2590,0,1968,1500000.0
3.0,1.0,1020,1.0,0,0,880,140,1950,385000.0
3.0,2.5,2370,2.0,0,0,2370,0,2003,535950.0
4.0,2.5,3170,2.5,0,0,3170,0,1989,910000.0
2.0,1.0,1120,1.0,0,0,1120,0,1926,465000.0
3.0,1.75,1440,1.0,0,0,1440,0,1983,495000.0
4.0,2.0,2170,1.5,0,0,1470,700,1920,250000.0
4.0,2.25,3490,2.0,0,0,2280,1210,1928,1225000.0
4.0,2.25,1970,2.0,0,0,1970,0,1973,400000.0
4.0,2.5,2780,2.0,0,0,2780,0,1987,715000.0
3.0,2.0,2250,1.0,0,0,2250,0,1992,342000.0
4.0,1.75,1340,1.0,0,0,1340,0,1967,420000.0
3.0,1.0,1400,1.0,0,0,1400,0,1968,148226.0
3.0,1.0,1510,1.0,0,0,1010,500,1968,313000.0
3.0,1.0,1320,1.0,0,0,1320,0,1959,150000.0
2.0,1.0,820,1.0,0,0,820,0,1954,150000.0
2.0,1.0,1080,1.0,0,0,1080,0,1958,230000.0
2.0,1.0,840,1.0,0,0,840,0,1948,389100.0
4.0,2.25,2070,1.0,0,0,1360,710,1974,645000.0
3.0,1.0,1520,1.0,0,0,990,530,1958,310000.0
2.0,1.75,1210,2.0,0,0,1210,0,2014,351358.0
5.0,2.75,3810,2.0,0,0,3810,0,2014,1700000.0
4.0,3.5,5370,2.0,0,0,5370,0,2002,1565000.0
3.0,2.0,1540,2.0,0,0,1540,0,1900,850000.0
4.0,2.5,2310,2.0,0,0,2310,0,1991,470000.0
3.0,2.25,1870,3.0,0,0,1870,0,2008,770000.0
3.0,1.75,1840,1.0,0,0,1340,500,1977,366000.0
3.0,2.5,2060,2.0,0,0,2060,0,1987,545000.0
3.0,1.0,1010,1.0,0,0,1010,0,1968,205000.0
2.0,1.0,1020,1.0,0,0,1020,0,1948,405000.0
4.0,2.5,2220,1.0,0,0,1270,950,1973,467000.0
2.0,1.0,1050,1.0,0,0,1050,0,1909,392500.0
4.0,2.75,3030,1.5,0,3,2360,670,1973,901000.0
3.0,1.75,1800,1.0,0,0,1300,500,1972,500000.0
3.0,2.5,1860,2.0,0,0,1860,0,2000,384950.0
4.0,3.5,4070,2.0,0,0,4070,0,2006,1700000.0
2.0,1.0,860,1.0,0,0,860,0,1948,245000.0
4.0,2.25,3080,2.0,0,0,3080,0,1968,1165000.0
3.0,1.5,1280,2.0,0,0,1280,0,1983,184500.0
2.0,2.0,1540,1.5,0,0,1540,0,1986,269000.0
3.0,2.5,1530,2.0,0,0,1530,0,1998,570000.0
4.0,1.75,2350,1.0,0,0,2350,0,1961,850000.0
3.0,1.0,920,1.0,0,0,920,0,1969,209000.0
4.0,1.75,1840,1.0,0,0,1840,0,1933,327000.0
3.0,1.5,1650,1.0,0,0,1100,550,1961,369500.0
3.0,1.75,1760,1.0,0,0,1230,530,1976,440000.0
4.0,2.25,3290,1.5,0,0,3290,0,1968,947500.0
2.0,1.0,1270,1.5,0,0,1270,0,1919,510000.0
3.0,2.0,1600,1.0,0,0,930,670,1941,385000.0
5.0,3.0,2670,1.0,0,0,1400,1270,1990,370000.0
4.0,1.5,1960,1.5,0,2,1960,0,1922,660000.0
3.0,4.25,3300,2.0,0,2,2520,780,1976,729000.0
3.0,1.75,2000,2.0,0,0,2000,0,1979,440000.0
4.0,2.5,2360,1.0,0,0,2360,0,2000,445000.0
2.0,1.0,1430,1.0,0,0,1430,0,1938,460000.0
3.0,3.0,2330,1.0,0,0,1300,1030,1971,516000.0
4.0,2.5,2060,2.0,0,0,2060,0,2002,343888.0
4.0,1.75,2240,1.5,0,0,2240,0,1965,500000.0
5.0,1.75,2330,1.0,0,1,1330,1000,1958,465000.0
5.0,2.25,2180,2.0,0,0,2180,0,1986,302000.0
2.0,1.0,1280,1.0,0,0,1280,0,1913,195000.0
3.0,2.5,2140,2.0,0,0,2140,0,1991,640000.0
6.0,2.5,2890,1.0,0,0,1630,1260,1977,502000.0
3.0,2.5,1480,2.0,0,0,1480,0,1998,360000.0
4.0,2.5,1680,2.0,0,0,1680,0,2003,290500.0
4.0,3.0,2163,2.0,0,0,2163,0,2006,248000.0
4.0,2.5,2280,2.0,0,0,2280,0,2001,433000.0
2.0,1.0,820,1.0,0,0,820,0,1980,480000.0
3.0,1.0,1330,1.0,0,0,1120,210,1957,410000.0
4.0,2.75,2310,2.0,0,0,2310,0,2006,309950.0
3.0,2.0,1290,1.0,0,0,1290,0,1990,253000.0
3.0,1.75,1630,1.0,0,0,1630,0,1971,280000.0
3.0,1.0,1410,1.0,0,0,1410,0,1958,440000.0
5.0,1.75,1240,1.0,0,0,1240,0,1954,333000.0
3.0,2.5,3100,2.0,0,0,3100,0,2002,759950.0
3.0,2.25,2020,2.0,0,0,2020,0,1979,345000.0
4.0,2.5,2500,2.0,0,0,2500,0,2007,350000.0
2.0,1.0,790,1.0,0,0,790,0,1951,198000.0
3.0,1.75,2040,1.0,0,0,1340,700,1952,730000.0
3.0,1.5,1430,1.0,0,0,1430,0,1966,266200.0
4.0,2.5,2250,2.0,0,0,2250,0,1967,1060000.0
2.0,1.0,1070,1.0,0,0,1070,0,1948,95000.0
3.0,1.75,1300,1.0,0,0,1300,0,1981,430000.0
4.0,2.25,2560,2.0,0,0,2560,0,1973,650000.0
3.0,2.5,2190,2.0,0,0,2190,0,2004,379900.0
2.0,1.5,940,2.0,0,0,860,80,2004,325000.0
4.0,2.25,1740,1.0,0,0,1170,570,1958,455000.0
4.0,3.75,2220,1.5,0,0,1330,890,1917,392000.0
3.0,1.75,1310,1.0,0,0,1310,0,1976,373000.0
5.0,3.0,2710,1.0,0,2,1910,800,1953,951250.0
3.0,2.0,1300,1.0,0,0,1300,0,1955,502000.0
3.0,2.0,1940,1.0,0,0,1940,0,2000,362500.0
2.0,1.0,1080,1.0,0,3,1080,0,1924,525000.0
4.0,2.5,2110,1.0,0,0,1420,690,1977,580000.0
3.0,2.25,1590,1.0,0,0,1170,420,1985,278000.0
2.0,1.0,910,1.0,0,0,910,0,1923,422500.0
4.0,2.0,1590,1.0,0,2,990,600,1900,783200.0
4.0,2.5,3290,2.0,0,0,3290,0,2003,715000.0
3.0,2.5,2010,2.0,0,0,1390,620,2014,472217.0
3.0,2.5,2060,2.0,0,0,2060,0,1999,244615.0
3.0,1.75,1560,1.0,0,0,780,780,1944,385000.0
3.0,1.0,1120,1.0,0,0,1120,0,1943,549995.0
4.0,3.75,3550,2.0,0,0,3550,0,2004,959900.0
6.0,4.5,3300,2.0,0,0,3300,0,1980,510000.0
3.0,1.75,2000,1.0,0,3,1200,800,1965,367000.0
5.0,3.0,2680,2.0,0,0,1810,870,1990,375000.0
2.0,2.25,1290,3.0,0,0,1290,0,2007,500000.0
2.0,2.25,1290,3.0,0,0,1290,0,2007,489000.0
3.0,2.0,1150,2.0,0,0,800,350,2000,340000.0
3.0,1.75,1880,1.0,0,0,940,940,1957,562000.0
3.0,2.5,2400,2.0,0,0,2400,0,2002,489950.0
3.0,2.25,1920,1.0,0,0,1560,360,1968,652000.0
4.0,3.25,4350,2.0,0,0,2870,1480,1999,472000.0
4.0,2.5,1910,1.0,0,0,1910,0,1963,333000.0
3.0,1.5,2000,1.0,0,0,2000,0,1953,560000.0
4.0,3.5,3290,2.0,0,4,2220,1070,1990,799000.0
5.0,2.25,3480,2.0,0,0,3480,0,1979,860000.0
4.0,2.5,2410,2.0,0,0,2410,0,1989,449500.0
4.0,3.0,2820,2.0,0,0,2820,0,1991,692500.0
4.0,1.75,2710,1.0,0,0,1430,1280,1976,925000.0
3.0,2.25,2080,1.5,0,0,1550,530,2003,267500.0
4.0,2.5,2200,2.0,0,0,2200,0,2010,396800.0
4.0,1.5,1180,1.0,0,0,1180,0,1969,220000.0
3.0,1.75,2120,1.0,0,1,1720,400,1959,892500.0
3.0,2.0,1460,1.0,0,0,1460,0,1975,455500.0
3.0,1.75,2110,1.0,0,0,2110,0,1961,743000.0
4.0,1.5,1790,1.0,0,0,1790,0,1951,338000.0
3.0,1.75,1340,1.0,0,0,1340,0,1978,332000.0
3.0,1.0,2460,1.5,0,0,1370,1090,1918,563225.0
4.0,3.5,3760,2.0,0,0,3760,0,1990,1150000.0
2.0,1.0,1240,1.0,0,0,1000,240,1920,645000.0
3.0,2.5,2750,2.0,0,0,2560,190,1981,739000.0
3.0,2.5,2530,2.0,0,0,2530,0,1993,435000.0
3.0,2.25,3200,2.0,0,0,2650,550,1914,995000.0
4.0,2.75,2020,1.0,0,0,1350,670,1986,520000.0
4.0,2.5,3030,2.0,0,0,2030,1000,1987,400000.0
3.0,1.75,2350,1.0,0,0,1510,840,1978,440000.0
3.0,1.5,1690,1.0,0,0,1230,460,1946,440000.0
3.0,1.0,1280,1.0,0,0,1280,0,1921,738000.0
3.0,1.5,1170,1.0,0,0,1170,0,1963,250000.0
4.0,2.25,2700,2.0,0,0,2700,0,1992,338150.0
3.0,2.25,1800,1.0,0,0,1280,520,1979,425000.0
4.0,2.5,3670,2.0,0,0,3670,0,1999,883000.0
3.0,2.0,2350,1.5,0,0,2350,0,1983,510000.0
4.0,1.75,3100,1.0,0,1,3100,0,1962,950000.0
3.0,1.0,1120,1.0,0,0,1120,0,1955,435000.0
5.0,1.5,1900,1.0,0,0,1130,770,1961,415000.0
2.0,2.5,1350,2.0,0,0,870,480,2004,439000.0
5.0,1.0,1410,1.0,0,0,960,450,1955,295832.0
3.0,1.75,1560,1.0,0,0,1560,0,1967,285000.0
3.0,1.5,1090,1.0,0,0,1090,0,1962,350000.0
2.0,2.75,1465,2.0,0,0,1050,415,2006,489000.0
3.0,2.25,1790,1.0,0,0,1390,400,1974,304500.0
3.0,1.5,1300,1.0,0,0,1300,0,1968,288000.0
3.0,1.75,1920,1.0,0,0,1440,480,1980,417000.0
3.0,3.0,1420,2.0,0,0,1040,380,2005,615000.0
5.0,3.5,3760,2.0,0,3,2820,940,2004,730000.0
2.0,1.0,930,1.0,0,0,930,0,1978,178500.0
4.0,2.0,1580,1.0,0,0,1050,530,1965,300000.0
4.0,2.5,2170,1.0,0,3,1350,820,1955,415000.0
3.0,1.75,2040,1.0,0,0,2040,0,1959,452500.0
4.0,2.75,3430,1.0,0,4,3430,0,2005,1010000.0
4.0,2.5,2160,2.0,0,0,2160,0,1989,653000.0
4.0,2.25,2060,1.0,0,0,1360,700,1941,715000.0
3.0,1.75,1410,1.5,0,0,1410,0,1927,541000.0
4.0,1.5,1850,1.5,0,0,1850,0,1960,245000.0
2.0,1.0,1370,1.5,0,0,1370,0,1922,547000.0
5.0,2.75,3330,1.0,0,0,1740,1590,1976,750000.0
5.0,2.5,1970,1.0,0,0,1570,400,1959,575000.0
3.0,1.75,1310,1.0,0,0,1310,0,1984,216000.0
3.0,1.75,1640,1.0,0,0,1640,0,1916,443000.0
4.0,2.25,1600,2.0,0,0,1600,0,1986,257700.0
3.0,1.0,1230,1.0,0,0,1230,0,1978,278000.0
3.0,2.5,2240,2.0,0,0,2240,0,2003,300000.0
3.0,2.5,2190,2.0,0,0,2190,0,1995,269100.0
3.0,1.0,990,1.5,0,0,990,0,1929,402500.0
2.0,1.5,1010,2.0,0,0,1010,0,1981,306888.0
4.0,2.5,2920,2.0,0,0,2920,0,1978,795000.0
4.0,2.5,2310,2.0,0,0,2310,0,2003,525000.0
3.0,2.5,3470,2.0,0,3,2560,910,1988,1050000.0
2.0,1.0,1220,1.0,0,0,880,340,1938,452000.0
3.0,2.25,1550,2.0,0,0,1550,0,2000,350000.0
4.0,2.5,2070,2.0,0,0,2070,0,2007,410000.0
3.0,1.75,2060,1.5,0,0,1180,880,1905,595000.0
3.0,2.5,1690,2.0,0,0,1690,0,2004,499000.0
4.0,2.5,2550,2.0,0,0,2550,0,2001,340000.0
5.0,3.25,3370,2.0,0,0,3370,0,2001,1065000.0
4.0,3.0,2230,2.0,0,0,2230,0,1991,460000.0
4.0,2.5,2382,2.0,0,0,2382,0,2011,345000.0
3.0,2.25,1620,2.0,0,0,1620,0,1990,280500.0
3.0,1.0,1140,1.5,0,0,1140,0,1926,704000.0
3.0,2.5,2140,2.0,0,0,2140,0,1990,545000.0
3.0,1.5,1900,1.0,0,0,1900,0,1962,335000.0
4.0,3.0,3370,1.0,0,3,1860,1510,1988,1325000.0
3.0,2.75,2300,1.0,0,0,1430,870,1965,420000.0
4.0,2.0,2040,1.0,0,0,1160,880,1937,705000.0
4.0,1.75,1840,1.0,0,0,1210,630,1990,274900.0
4.0,2.5,2860,2.0,0,0,2190,670,2004,499950.0
3.0,1.5,1400,1.0,0,0,1400,0,1953,415250.0
3.0,1.0,990,1.0,0,0,990,0,1958,222000.0
3.0,2.0,3120,1.0,0,0,2150,970,1980,375000.0
3.0,2.5,1640,2.0,0,0,1640,0,1995,300000.0
3.0,1.75,2820,1.0,0,0,1540,1280,1920,456700.0
3.0,2.75,1970,1.5,0,3,1970,0,1915,925500.0
5.0,2.5,2840,1.0,0,0,1470,1370,1975,375000.0
3.0,2.5,2370,2.0,0,2,2370,0,1993,420000.0
3.0,2.5,2610,2.0,0,0,2610,0,2004,575000.0
3.0,2.0,1340,1.0,0,0,670,670,1915,335000.0
4.0,2.0,1300,1.0,0,0,1300,0,1958,428000.0
4.0,2.5,3340,1.0,0,0,2060,1280,1977,655000.0
3.0,3.0,2630,2.0,0,0,2630,0,2006,738000.0
5.0,1.75,1960,1.0,0,0,980,980,1965,415000.0
3.0,1.0,1090,1.0,0,0,790,300,1945,392000.0
2.0,1.0,1550,1.0,0,0,1050,500,1941,555000.0
3.0,2.5,1770,2.0,0,0,1770,0,2005,260000.0
3.0,1.0,1390,1.5,0,0,1390,0,1940,392500.0
3.0,2.5,2979,2.0,0,2,2979,0,1993,912000.0
2.0,1.0,830,1.0,0,0,830,0,1943,135000.0
3.0,2.75,1560,1.0,0,0,1400,160,1978,500000.0
3.0,1.5,1360,1.0,0,0,1050,310,1975,238000.0
4.0,2.0,1650,1.0,0,0,860,790,1972,251000.0
2.0,1.75,1510,2.0,0,0,1510,0,1978,406500.0
4.0,2.25,3010,2.0,0,0,3010,0,1988,433495.0
3.0,2.25,1510,1.0,0,0,1150,360,1985,265000.0
3.0,1.75,1950,1.0,0,0,1520,430,1957,360000.0
4.0,1.0,1800,1.0,0,0,950,850,1955,425000.0
2.0,2.75,2810,1.0,0,0,1510,1300,1968,450000.0
3.0,1.75,1760,1.0,0,0,1760,0,1954,449900.0
4.0,2.5,2040,2.0,0,0,2040,0,2004,345000.0
4.0,2.0,1690,1.0,0,0,1690,0,1967,612500.0
3.0,1.75,1530,1.0,0,0,1530,0,1977,317000.0
3.0,1.5,1810,1.5,0,0,1310,500,1929,585000.0
3.0,1.75,1180,1.0,0,0,1180,0,1981,455000.0
4.0,4.0,4090,2.0,0,0,4090,0,1991,1035000.0
4.0,2.25,2250,2.0,0,0,2250,0,1968,497000.0
3.0,1.75,1070,1.0,0,0,1070,0,1992,226750.0
4.0,2.0,1820,1.0,0,0,1220,600,1950,385000.0
3.0,0.75,1080,1.0,0,0,1080,0,1948,205000.0
4.0,2.5,2760,2.0,0,0,2760,0,1989,745000.0
4.0,2.5,2550,2.0,0,0,2550,0,2005,371000.0
4.0,2.5,2080,2.0,0,0,2080,0,1991,545000.0
3.0,1.0,1280,1.5,0,0,1280,0,1931,443000.0
2.0,1.0,950,1.0,0,0,950,0,1951,287000.0
3.0,1.0,1050,1.0,0,0,1050,0,1983,194000.0
3.0,1.0,1800,1.0,0,0,1800,0,1957,265000.0
4.0,2.75,3840,1.0,0,2,2110,1730,1963,1135000.0
4.0,3.25,3674,2.0,0,1,3674,0,1987,699950.0
4.0,1.0,1710,1.5,0,0,1710,0,1950,433000.0
2.0,1.75,910,1.0,0,0,910,0,2003,200000.0
3.0,1.5,1340,1.0,0,0,1340,0,1968,289571.0
4.0,2.75,2340,1.0,0,0,1720,620,1967,440000.0
3.0,1.5,1510,1.0,0,0,1120,390,1960,400000.0
4.0,2.5,2630,2.0,0,0,2630,0,1962,589000.0
5.0,2.25,3100,2.0,0,0,3100,0,1986,850000.0
3.0,1.0,940,1.5,0,0,940,0,1903,520000.0
2.0,2.25,1370,2.0,0,0,1200,170,2000,555000.0
3.0,2.5,2480,2.0,0,0,2480,0,2004,470000.0
2.0,1.5,1068,2.0,0,0,1068,0,1990,207000.0
4.0,2.75,2390,1.0,0,2,1620,770,1976,379750.0
4.0,1.75,2170,1.0,0,0,1270,900,1950,709000.0
3.0,2.5,1520,1.0,0,0,1160,360,1993,240000.0
4.0,1.5,2210,1.0,0,0,1650,560,1953,445500.0
5.0,2.5,3200,1.0,0,3,1600,1600,1959,1308000.0
3.0,1.5,1160,1.0,0,0,1160,0,1959,210000.0
4.0,2.5,2670,2.0,0,0,2670,0,1999,603000.0
3.0,2.5,2520,2.0,0,0,2520,0,1987,720000.0
2.0,1.0,760,1.5,0,0,760,0,1947,92000.0
3.0,1.75,1310,2.0,0,0,1310,0,1901,600000.0
4.0,2.5,2750,1.0,0,3,1380,1370,1948,725000.0
5.0,2.25,1790,1.0,0,0,1270,520,1961,409950.0
3.0,2.5,1790,2.0,0,0,1790,0,1989,515000.0
4.0,2.5,2400,1.0,0,0,1800,600,1968,495000.0
4.0,2.25,2420,2.0,0,0,2420,0,1973,998000.0
3.0,1.75,1710,1.0,0,0,1710,0,1986,630000.0
3.0,1.75,2000,1.0,0,0,1320,680,1972,410000.0
3.0,2.25,1580,1.0,0,0,1580,0,1979,602000.0
4.0,2.75,2310,1.0,0,0,1310,1000,1980,750000.0
4.0,3.0,3580,2.5,0,0,2370,1210,1991,711600.0
4.0,4.0,4320,2.0,0,0,3190,1130,2006,1050000.0
3.0,2.5,2560,2.0,0,0,2560,0,1981,700500.0
4.0,2.5,3220,2.0,0,1,3220,0,1991,710000.0
3.0,2.0,1660,1.0,0,0,1010,650,1985,250000.0
4.0,1.75,2420,1.0,0,0,1620,800,1964,350000.0
7.0,3.5,2870,1.0,0,0,1520,1350,1961,475000.0
2.0,1.0,830,1.0,0,0,830,0,1920,200000.0
4.0,2.25,1710,1.0,0,0,1040,670,1972,450000.0
5.0,2.5,2600,2.0,0,0,2600,0,2005,316000.0
1.0,1.0,670,1.0,0,0,670,0,1920,310000.0
3.0,1.5,1500,1.0,0,0,1500,0,1970,392000.0
3.0,3.25,1460,3.0,0,0,1460,0,2000,521000.0
2.0,2.0,1540,1.0,0,0,960,580,1949,495000.0
3.0,1.75,1250,1.0,0,0,1250,0,1967,209000.0
4.0,2.0,2230,1.5,0,0,2230,0,1959,809950.0
2.0,1.75,1800,1.0,0,0,1420,380,1950,400000.0
4.0,2.5,2400,1.0,0,0,1530,870,1980,415000.0
4.0,2.0,2370,2.0,0,0,2370,0,1978,411000.0
2.0,2.0,1830,1.0,0,0,1230,600,1926,825000.0
3.0,2.25,1480,3.0,0,0,1480,0,2008,436000.0
4.0,2.5,2620,2.0,0,0,2620,0,1991,460000.0
3.0,1.0,1300,1.0,0,0,1300,0,1959,281000.0
4.0,1.5,3120,1.0,0,3,1660,1460,1956,976000.0
4.0,2.5,2400,2.0,0,0,2400,0,1995,485000.0
3.0,2.5,1430,2.0,0,0,1430,0,1984,429000.0
3.0,2.5,2480,2.0,0,0,2480,0,1990,729000.0
3.0,2.5,2280,2.0,0,0,2280,0,2003,625000.0
3.0,1.75,1390,1.0,0,0,1390,0,1987,218500.0
3.0,1.0,1030,1.0,0,0,1030,0,1960,175000.0
3.0,1.0,1120,1.0,0,0,1120,0,1938,442500.0
3.0,2.0,1300,2.0,0,0,1300,0,1986,480000.0
3.0,2.25,2410,1.0,0,1,1540,870,1965,715500.0
3.0,1.75,1470,1.0,0,0,1470,0,1963,432500.0
5.0,4.25,4720,2.0,0,0,3210,1510,2005,875000.0
5.0,2.75,2910,2.0,0,0,2910,0,1940,605000.0
4.0,4.0,5000,3.0,0,2,5000,0,2002,1688000.0
3.0,2.25,1690,1.0,0,0,1090,600,1982,318000.0
2.0,1.0,1000,1.0,0,0,1000,0,1947,311300.0
5.0,2.75,2400,1.0,0,0,1450,950,1992,325000.0
5.0,3.5,3330,2.0,0,0,2610,720,2008,795000.0
4.0,2.25,2060,1.0,0,0,1320,740,1962,558000.0
4.0,2.5,3090,2.0,0,0,3090,0,1995,370000.0
4.0,2.5,2350,2.0,0,0,2350,0,1993,598850.0
3.0,2.5,2180,2.0,0,0,2180,0,1994,515700.0
3.0,2.5,1870,2.0,0,0,1870,0,2003,458000.0
3.0,2.25,3530,2.5,0,0,3530,0,1985,583500.0
4.0,2.5,2460,2.0,0,0,2460,0,2003,653750.0
3.0,2.5,1650,2.0,0,0,1650,0,2011,299000.0
5.0,3.0,3480,1.0,0,0,2340,1140,1976,532000.0
3.0,2.75,3176,2.0,0,3,2726,450,1985,819000.0
4.0,2.25,2420,1.0,0,4,2000,420,1967,945000.0
4.0,2.5,2260,1.0,0,0,2260,0,1983,608700.0
4.0,2.0,2380,1.0,0,2,1310,1070,1949,812000.0
5.0,2.5,3400,1.0,0,0,1700,1700,1959,464000.0
4.0,2.5,3770,2.0,0,0,3770,0,1989,950000.0
4.0,2.5,2672,2.0,0,0,2020,652,2005,700000.0
3.0,1.0,1180,1.0,0,0,1060,120,1939,435000.0
3.0,1.5,1810,1.0,0,0,1810,0,1954,229500.0
3.0,3.0,2610,1.5,1,4,2610,0,1952,1575000.0
3.0,2.25,1450,1.0,0,0,1180,270,1963,265000.0
2.0,2.0,1600,1.0,0,0,1600,0,1950,995000.0
3.0,2.5,2650,1.0,0,0,1680,970,1975,590000.0
4.0,2.75,2490,2.0,0,2,1490,1000,1979,740000.0
2.0,0.75,850,1.0,0,2,550,300,1909,360000.0
4.0,2.0,1820,1.0,0,0,1300,520,1976,548500.0
3.0,1.75,1960,1.0,0,0,1090,870,1920,599000.0
3.0,1.75,2350,1.0,0,0,1800,550,1978,615000.0
3.0,1.75,1320,1.0,0,0,1320,0,1988,292000.0
4.0,2.5,3720,2.0,0,0,3720,0,1988,899000.0
3.0,1.5,2210,1.0,0,0,1030,1180,1912,500000.0
3.0,2.5,1910,1.5,0,0,1910,0,2003,580000.0
4.0,2.5,2840,2.0,0,0,2840,0,1998,580000.0
3.0,1.0,1320,1.0,0,0,1090,230,1920,594000.0
3.0,2.5,2440,1.0,0,0,1420,1020,1981,500000.0
4.0,2.5,2420,1.0,0,0,1680,740,1988,550000.0
3.0,1.75,1180,1.0,0,0,1180,0,1993,275000.0
3.0,2.25,1820,2.0,0,0,1820,0,1983,390000.0
3.0,3.0,3760,2.5,0,3,3060,700,1910,1250000.0
3.0,2.25,1560,2.0,0,0,1560,0,1997,250000.0
2.0,2.5,1790,2.0,0,0,1790,0,1979,405000.0
3.0,1.0,1430,1.0,0,0,1430,0,1968,213950.0
3.0,1.5,1390,1.0,0,0,1390,0,1963,232000.0
3.0,1.0,990,1.0,0,0,990,0,1959,207000.0
3.0,1.75,1880,1.0,0,0,1880,0,1988,310000.0
3.0,2.5,2520,3.0,0,0,2520,0,1990,540000.0
4.0,1.5,2060,1.5,0,2,1580,480,1920,750000.0
4.0,2.5,2150,2.0,0,0,2150,0,2005,392500.0
5.0,2.5,2500,1.0,0,0,1690,810,1962,305000.0
3.0,2.5,2390,2.0,0,0,2390,0,1984,735000.0
4.0,2.5,2400,2.0,0,0,2400,0,1990,575000.0
2.0,1.0,660,1.0,0,0,660,0,1915,175000.0
4.0,2.5,1580,2.0,0,0,1580,0,1984,291000.0
4.0,2.5,3250,2.0,0,0,3250,0,1994,791500.0
3.0,2.0,1880,1.0,0,0,1180,700,1951,475000.0
2.0,1.0,1190,1.0,0,0,1190,0,1951,238950.0
3.0,3.5,1280,2.0,0,0,1040,240,2000,470000.0
4.0,1.75,2380,1.0,0,0,1610,770,1978,420000.0
3.0,2.5,2040,2.0,0,0,2040,0,1996,440000.0
4.0,1.75,1440,1.5,0,0,1290,150,1929,656000.0
3.0,2.5,2120,2.0,0,0,2120,0,2001,559950.0
2.0,2.0,990,1.0,0,0,990,0,1935,600000.0
3.0,1.0,1710,1.0,0,0,1710,0,1972,255000.0
4.0,1.5,1840,1.5,0,0,1840,0,1957,210750.0
4.0,1.0,1150,1.5,0,0,1150,0,1909,485000.0
3.0,2.5,2250,2.0,0,0,2250,0,1995,390000.0
3.0,2.5,2460,1.0,0,0,1810,650,1970,405000.0
4.0,1.0,1540,1.5,0,0,1540,0,1905,462500.0
4.0,2.25,2210,1.0,0,0,1630,580,1978,435000.0
3.0,2.5,1440,2.0,0,0,1440,0,2003,440000.0
3.0,1.75,1790,1.0,0,3,1790,0,1978,299950.0
2.0,1.5,1120,2.0,0,0,1120,0,1970,440000.0
3.0,2.5,1260,1.0,0,0,1260,0,1975,312620.0
3.0,1.5,1180,1.0,0,0,800,380,1981,372500.0
3.0,2.5,1730,2.0,0,0,1730,0,1994,297262.0
4.0,3.0,2250,1.0,0,0,1250,1000,1963,735000.0
3.0,1.5,1550,2.0,0,0,1550,0,1922,430000.0
2.0,1.75,1070,1.5,0,0,1070,0,1995,241000.0
3.0,1.0,1460,1.0,0,0,1460,0,1969,201000.0
2.0,1.0,1060,1.0,0,0,1060,0,1910,570000.0
4.0,1.75,1840,1.0,0,0,1220,620,1967,538000.0
3.0,2.5,2440,2.0,0,0,2440,0,2011,729000.0
4.0,1.75,1700,1.0,0,0,850,850,1955,331500.0
2.0,1.0,680,1.0,0,0,680,0,1941,110700.0
3.0,2.0,1700,1.0,0,0,1700,0,1996,245000.0
3.0,1.75,2000,1.0,0,0,1360,640,1956,427000.0
4.0,1.75,2340,1.0,0,0,1290,1050,1953,650500.0
2.0,1.0,1120,1.0,0,0,1120,0,1939,335900.0
2.0,2.0,1510,1.5,0,0,1510,0,1939,535000.0
5.0,2.0,2120,1.0,0,0,1080,1040,1906,360000.0
3.0,2.25,1500,1.0,0,0,1210,290,1968,294900.0
2.0,1.0,1030,1.0,0,0,1030,0,1928,460000.0
4.0,3.5,5440,2.0,0,0,5440,0,1990,1769000.0
2.0,1.0,1150,1.0,0,0,1150,0,1905,463000.0
5.0,1.5,2420,1.0,0,2,1500,920,1962,332000.0
4.0,2.0,1750,1.0,0,0,1750,0,1943,199500.0
4.0,2.0,1750,1.0,0,0,1750,0,1943,247000.0
4.0,2.5,2170,2.0,0,0,2170,0,1992,442500.0
3.0,2.0,2540,1.0,0,0,2540,0,2007,600000.0
3.0,2.5,1690,2.0,0,0,1690,0,2005,449000.0
4.0,1.0,1600,1.5,0,0,1600,0,1926,725000.0
3.0,1.0,1060,1.0,0,0,1060,0,1961,215000.0
2.0,1.75,1990,1.0,0,0,1170,820,1948,582500.0
4.0,2.25,2210,2.0,0,0,2210,0,1968,305000.0
4.0,2.75,3090,2.0,0,2,2340,750,1959,734000.0
3.0,2.0,1050,1.0,0,0,1050,0,1986,300000.0
5.0,1.75,2550,1.0,0,0,1810,740,1960,525888.0
4.0,2.5,2095,1.5,0,0,1295,800,1910,711000.0
3.0,1.75,1520,1.0,0,0,1220,300,1978,360000.0
5.0,2.5,2750,2.0,0,0,2750,0,1987,357000.0
3.0,1.75,1200,1.0,0,0,1200,0,1960,235000.0
3.0,1.75,1830,1.0,0,1,1150,680,1928,550000.0
3.0,1.0,1160,1.0,0,0,1160,0,1957,324000.0
3.0,2.0,1750,1.0,0,0,1410,340,1989,420000.0
4.0,2.5,2400,2.0,0,0,2400,0,2003,450000.0
5.0,3.5,4140,2.0,0,0,3030,1110,2004,825000.0
4.0,2.25,2115,2.0,0,0,2115,0,1998,272000.0
3.0,2.0,2580,1.5,0,0,2580,0,1990,481000.0
3.0,1.0,1220,1.0,0,0,1060,160,1927,500000.0
2.0,1.5,1630,1.0,0,0,890,740,1940,448000.0
2.0,2.0,1350,1.0,0,0,1350,0,2004,480000.0
3.0,2.5,1690,2.0,0,0,1690,0,2004,475000.0
2.0,2.25,1700,2.0,0,0,1700,0,2005,472500.0
4.0,2.25,1890,1.0,0,0,1260,630,1979,291000.0
2.0,1.0,850,1.0,0,0,850,0,1950,294000.0
4.0,2.5,2480,1.0,0,0,1820,660,1967,1013050.0
3.0,2.5,1690,2.0,0,0,1690,0,2002,442500.0
2.0,1.0,810,1.0,0,0,810,0,1959,170000.0
4.0,2.5,3980,1.0,0,1,2480,1500,1968,1582500.0
3.0,2.25,2580,2.0,0,0,1780,800,1925,665000.0
5.0,4.5,6085,3.0,0,0,6085,0,2000,1610000.0
2.0,1.75,2140,1.0,0,0,1000,1140,1930,675000.0
2.0,1.75,1360,1.0,0,0,1360,0,1957,279900.0
4.0,1.5,1800,1.5,0,0,1800,0,1929,875000.0
3.0,2.5,1920,2.0,0,0,1920,0,2005,571000.0
3.0,1.0,860,1.5,0,0,860,0,1927,320000.0
3.0,2.5,2340,1.0,0,0,2340,0,1986,525000.0
8.0,2.75,4040,1.0,0,0,2020,2020,1962,1650000.0
3.0,1.75,1160,1.0,0,0,580,580,1942,137900.0
3.0,2.25,1680,2.0,0,0,1680,0,1989,440000.0
3.0,1.0,1280,1.0,0,0,640,640,1945,360000.0
4.0,1.5,1800,1.0,0,0,1800,0,1977,271000.0
6.0,3.25,4250,1.0,0,3,2150,2100,1967,465000.0
4.0,2.5,2400,2.0,0,0,2400,0,2004,280000.0
2.0,1.0,940,1.0,0,0,940,0,1942,283000.0
3.0,1.0,1110,1.0,0,0,1110,0,1980,411500.0
3.0,2.25,2420,1.0,0,0,1370,1050,1967,282000.0
3.0,2.5,1850,2.5,0,0,1790,60,2005,535000.0
4.0,2.5,2020,2.0,0,0,1730,290,1943,554729.0
4.0,2.5,2020,2.0,0,0,1730,290,1943,868000.0
3.0,2.5,1830,1.0,0,0,1520,310,1991,427000.0
4.0,1.75,1920,1.0,0,0,960,960,1954,455000.0
2.0,1.75,1280,1.0,0,0,1280,0,1953,595000.0
4.0,2.5,3130,2.0,0,0,3130,0,2004,400000.0
4.0,2.5,3920,2.0,0,0,3920,0,1997,770000.0
4.0,2.75,3100,2.0,0,0,2000,1100,1919,742500.0
4.0,2.5,3220,1.0,0,0,1680,1540,1973,1250000.0
3.0,2.0,1670,1.0,0,0,1670,0,1968,375000.0
4.0,2.5,2700,2.0,0,0,2700,0,1960,1557600.0
4.0,2.0,5461,1.0,0,0,3265,2196,1964,545000.0
4.0,3.25,4400,2.0,0,0,4400,0,2003,1050000.0
3.0,1.75,2190,1.0,0,0,2190,0,1957,1565000.0
4.0,1.5,1200,1.5,0,0,1200,0,1970,178000.0
3.0,1.75,1470,1.0,0,0,1470,0,1989,262500.0
3.0,1.75,1650,1.5,0,0,1650,0,1900,730000.0
5.0,1.75,1840,1.0,0,2,1360,480,1948,395000.0
3.0,1.0,1210,1.0,0,0,1210,0,1959,355000.0
3.0,2.5,1870,2.0,0,0,1870,0,1989,299990.0
4.0,3.25,3890,1.5,0,0,3150,740,2001,1125000.0
4.0,2.25,2660,2.0,0,0,2660,0,1972,425000.0
2.0,1.0,1150,1.0,0,0,1150,0,1951,349000.0
4.0,1.75,1740,1.0,0,0,870,870,1942,554950.0
6.0,3.0,2580,1.5,0,0,1880,700,1913,326000.0
4.0,1.75,1720,1.0,0,0,1420,300,1975,580000.0
3.0,2.5,2740,2.0,0,1,1510,1230,1977,699000.0
3.0,2.75,2610,1.0,0,0,1630,980,1985,757000.0
3.0,1.75,1400,1.0,0,0,1400,0,1965,335000.0
3.0,2.0,2570,1.0,0,0,1970,600,1983,660000.0
4.0,2.75,2830,2.0,0,0,2830,0,2005,540000.0
5.0,2.25,2630,2.0,0,0,2630,0,1966,320000.0
3.0,2.5,1580,2.0,0,0,1580,0,1994,280000.0
3.0,2.0,1540,1.0,0,3,1540,0,1989,324000.0
3.0,1.0,2120,1.0,0,0,1060,1060,1967,300000.0
3.0,1.75,1830,2.0,0,0,1830,0,1913,360000.0
3.0,2.5,2260,2.0,0,0,2260,0,1987,600000.0
4.0,1.75,2500,1.0,0,0,1500,1000,1970,950000.0
3.0,3.25,1830,3.0,0,0,1830,0,2014,599950.0
4.0,1.0,1190,1.0,0,0,890,300,1951,190000.0
4.0,1.75,2310,1.0,0,0,1780,530,1970,350000.0
3.0,1.0,1230,1.5,0,0,1230,0,1929,522000.0
3.0,2.5,2940,2.0,0,0,2940,0,1992,850000.0
3.0,1.0,1010,1.0,0,0,1010,0,1954,308000.0
6.0,2.25,2550,2.0,0,0,2550,0,1907,1020000.0
3.0,1.0,1480,1.5,0,0,1480,0,1938,397500.0
3.0,1.75,1460,1.0,0,0,1040,420,1977,186000.0
5.0,3.0,3110,1.0,0,0,1790,1320,1977,436500.0
3.0,2.0,2140,1.0,0,0,1070,1070,1928,710000.0
5.0,3.25,3450,2.0,0,0,1860,1590,1905,1378600.0
3.0,2.25,1960,1.0,0,0,1960,0,1957,450000.0
4.0,2.75,1890,1.0,0,0,980,910,1981,375000.0
2.0,1.0,2080,1.0,0,0,1040,1040,1960,315000.0
3.0,1.0,1700,1.5,0,0,1700,0,1918,467500.0
3.0,1.0,1140,1.0,0,0,1140,0,1959,330000.0
3.0,2.5,3136,1.5,0,0,3136,0,1910,665000.0
4.0,3.25,2590,3.0,0,0,2590,0,2013,760000.0
3.0,1.75,1480,2.0,0,0,1000,480,2014,469000.0
3.0,3.0,1500,2.0,0,0,1120,380,2000,408000.0
3.0,2.75,2660,1.0,0,4,1330,1330,1971,851000.0
2.0,2.0,1350,1.0,0,0,1350,0,2007,410000.0
2.0,1.0,860,1.0,0,0,860,0,1943,235000.0
2.0,1.0,1000,1.0,0,0,1000,0,1916,207100.0
4.0,2.5,2480,1.0,0,0,1510,970,1959,560000.0
3.0,2.75,3860,2.0,0,0,3860,0,1984,903000.0
3.0,1.75,2140,2.0,0,0,1690,450,1905,998500.0
4.0,1.75,1820,1.5,0,0,1120,700,1959,268500.0
2.0,1.75,2220,1.0,0,0,2220,0,1970,494950.0
4.0,2.5,2660,2.0,0,0,2660,0,1999,1130000.0
3.0,2.0,1470,1.0,0,0,1470,0,1942,250000.0
4.0,1.75,2350,1.0,0,0,1250,1100,1971,449000.0
3.0,2.25,2980,1.0,0,0,2530,450,1964,1225000.0
4.0,2.0,1870,1.0,0,0,1870,0,1966,325000.0
5.0,3.0,2430,1.0,0,0,1370,1060,1957,506000.0
4.0,2.5,2790,2.0,0,0,2790,0,2003,751000.0
3.0,2.5,1370,2.0,0,0,1370,0,1993,280000.0
4.0,2.25,4470,2.0,0,0,4470,0,1988,1120000.0
3.0,1.75,2040,1.0,0,0,2040,0,1980,580000.0
4.0,2.25,2340,1.0,0,0,1700,640,1963,665000.0
4.0,2.5,2520,2.0,0,0,2520,0,1999,450000.0
4.0,1.0,1710,1.5,0,0,1710,0,1942,389900.0
3.0,1.0,1200,1.0,0,0,1200,0,1962,427000.0
3.0,1.75,1330,1.0,0,3,1330,0,1983,265000.0
3.0,1.5,1310,2.0,0,0,1310,0,1998,398000.0
6.0,3.5,3020,2.0,0,0,3020,0,1941,354000.0
4.0,2.5,2260,2.0,0,0,2260,0,1999,339950.0
2.0,1.0,790,1.0,0,0,790,0,1948,399000.0
2.0,2.0,970,1.0,0,0,970,0,1983,325000.0
3.0,2.0,2250,1.0,0,2,2250,0,1955,998800.0
4.0,2.5,1530,1.5,0,0,1530,0,1914,350000.0
4.0,1.75,1780,1.0,0,0,1780,0,1967,1000000.0
3.0,2.5,2120,2.0,0,0,2120,0,2005,561000.0
2.0,1.0,1500,1.0,0,0,1190,310,1926,245000.0
2.0,1.0,1500,1.0,0,0,1190,310,1926,570000.0
4.0,3.0,2390,1.5,0,0,1460,930,1931,845000.0
4.0,2.5,2390,2.0,0,0,2390,0,1996,314500.0
3.0,1.75,2920,1.0,0,0,1620,1300,1981,650000.0
2.0,1.0,850,1.0,0,0,850,0,1907,298000.0
2.0,1.0,930,1.0,0,0,930,0,1904,500000.0
4.0,2.5,3340,2.0,0,1,2470,870,1998,870000.0
2.0,1.0,710,1.0,0,0,710,0,1942,299000.0
3.0,2.25,2240,1.0,0,0,1440,800,1979,527000.0
3.0,1.0,1060,1.0,0,0,1060,0,1966,420000.0
3.0,2.5,2360,2.0,0,0,2360,0,1991,290000.0
4.0,2.75,3520,1.0,1,4,1950,1570,1951,1662000.0
3.0,1.75,1730,1.0,0,0,1220,510,1977,499990.0
3.0,1.75,1170,1.0,0,0,720,450,1943,315000.0
4.0,2.25,3680,2.0,0,0,3680,0,1981,425000.0
3.0,2.5,2900,2.0,0,0,2900,0,1987,630000.0
3.0,1.75,1290,1.5,0,0,1290,0,1971,365000.0
4.0,2.75,2010,2.0,0,0,2010,0,1901,774000.0
3.0,1.5,1490,1.0,0,0,1490,0,1950,368888.0
4.0,2.5,1930,2.0,0,0,1930,0,1994,339500.0
4.0,1.75,2240,1.0,0,0,1120,1120,1956,344950.0
3.0,2.0,2320,1.0,0,0,2320,0,1952,450000.0
4.0,2.75,2990,2.0,0,0,2990,0,2014,814950.0
4.0,2.5,2200,2.0,0,0,2200,0,2003,299900.0
3.0,2.0,1500,1.0,0,0,1500,0,1967,315000.0
3.0,1.75,3860,1.0,0,2,1930,1930,1970,880000.0
3.0,1.5,1430,1.0,0,0,1030,400,1977,195000.0
5.0,2.75,3750,2.0,0,0,3750,0,2001,910000.0
5.0,2.5,3100,2.0,0,0,3100,0,2002,540000.0
3.0,2.5,1870,2.0,0,0,1870,0,2005,306000.0
4.0,2.25,2040,1.0,0,0,1580,460,1978,272000.0
5.0,3.5,3700,2.0,0,0,2750,950,1950,1295000.0
3.0,1.75,3150,1.0,0,1,2370,780,1970,450000.0
3.0,2.5,1990,2.0,0,0,1990,0,1993,450000.0
4.0,1.0,1740,1.5,0,0,1740,0,1965,310000.0
2.0,2.25,2080,1.0,0,0,1180,900,1954,530000.0
4.0,2.5,2060,2.0,0,0,1560,500,1979,435000.0
3.0,2.0,1590,1.0,0,0,1590,0,1948,485000.0
3.0,1.5,1760,2.0,0,0,1760,0,1922,690000.0
4.0,2.5,1620,2.0,0,0,1620,0,2008,305000.0
3.0,1.75,1210,1.0,0,0,1210,0,1975,300000.0
4.0,3.0,2040,1.0,0,0,1490,550,1993,289950.0
3.0,2.5,2270,2.0,0,0,2270,0,1990,575000.0
4.0,4.5,6640,2.0,0,0,6640,0,1993,1820000.0
3.0,1.5,1060,1.0,0,0,1060,0,1962,219000.0
4.0,3.0,1940,1.0,0,0,1940,0,1948,265000.0
5.0,3.25,3070,2.0,0,0,2050,1020,2006,1105000.0
3.0,1.0,930,1.0,0,0,820,110,1943,200000.0
4.0,2.75,2180,1.0,0,3,1210,970,1959,545000.0
3.0,2.5,2130,2.0,0,0,2130,0,1991,378000.0
2.0,1.75,800,1.0,0,0,800,0,1922,388000.0
4.0,2.25,2200,1.0,0,0,1250,950,1959,425000.0
2.0,1.5,1130,2.0,0,0,1030,100,2009,536000.0
3.0,2.5,1970,1.0,1,4,1100,870,1937,1175000.0
3.0,2.5,1680,2.0,0,0,1120,560,2014,629950.0
4.0,1.75,1470,1.0,0,0,980,490,1955,465000.0
4.0,2.25,2390,1.0,0,0,2390,0,1969,545000.0
4.0,2.5,2300,2.0,0,0,2300,0,1979,592000.0
4.0,2.0,2280,1.0,0,0,1140,1140,1957,446000.0
3.0,2.5,1330,3.0,0,0,1330,0,2004,375000.0
5.0,2.5,2640,2.0,0,0,2640,0,2003,632500.0
4.0,1.75,2430,1.0,0,0,1780,650,1974,459950.0
4.0,2.5,2470,2.0,0,0,2470,0,1989,485000.0
3.0,1.0,1440,1.0,0,0,1440,0,1965,255000.0
3.0,2.0,1320,1.0,0,0,1320,0,1975,251750.0
3.0,2.5,2810,2.0,0,0,2810,0,2001,725000.0
3.0,3.25,1370,3.0,0,0,1370,0,2005,460000.0
3.0,2.5,2000,1.0,0,0,1040,960,1981,625000.0
3.0,1.75,1980,1.0,0,0,1980,0,1973,530000.0
3.0,2.5,2050,2.0,0,0,2050,0,2002,394950.0
4.0,1.75,2320,1.0,0,0,1160,1160,1959,324950.0
3.0,2.25,1960,2.0,0,0,1750,210,2003,330000.0
4.0,1.75,1910,1.0,0,0,1910,0,1986,220000.0
3.0,3.25,2030,2.0,0,0,2030,0,1980,685000.0
3.0,2.25,2210,1.0,0,2,1730,480,1972,500000.0
4.0,2.75,2610,1.0,0,0,1360,1250,1965,368000.0
3.0,2.25,2520,2.0,0,0,1550,970,1990,825000.0
6.0,1.75,1840,1.0,0,0,1060,780,1900,660000.0
3.0,1.75,1570,1.0,0,0,1570,0,1971,253000.0
4.0,2.75,2400,1.0,0,0,1320,1080,1953,392500.0
3.0,1.75,1930,2.0,0,2,1930,0,1978,605000.0
3.0,1.0,1160,1.0,0,0,1160,0,1969,215000.0
4.0,2.5,2820,2.0,0,0,2820,0,1985,650000.0
4.0,2.0,3060,2.0,0,0,2040,1020,1922,877500.0
3.0,1.0,1320,1.0,0,0,880,440,1961,232500.0
2.0,2.0,1200,2.0,0,0,1200,0,2003,234000.0
3.0,1.75,1560,1.0,0,0,1250,310,1970,380000.0
5.0,2.25,3070,1.0,0,0,2730,340,1983,420000.0
3.0,1.0,1040,1.0,0,0,1040,0,1978,399950.0
3.0,2.5,1990,1.0,0,0,1570,420,1969,256750.0
3.0,2.5,1690,2.0,0,0,1690,0,1984,535000.0
3.0,2.0,1810,2.0,0,0,1810,0,1979,515000.0
4.0,1.75,2520,1.0,0,0,1640,880,1953,770000.0
3.0,2.5,1570,1.0,0,0,1090,480,1996,256000.0
3.0,1.0,1680,1.0,0,0,1680,0,1940,489900.0
3.0,1.5,1250,1.0,0,0,1250,0,1978,165000.0
3.0,1.5,1280,1.0,0,0,1280,0,1962,220000.0
4.0,2.5,4620,2.0,0,0,4620,0,1991,575000.0
3.0,2.5,1580,2.0,0,0,1580,0,2004,375000.0
3.0,1.75,1650,2.0,0,0,1300,350,1977,422250.0
3.0,1.75,1660,1.0,0,0,1380,280,1981,420000.0
4.0,2.5,2410,2.0,0,0,2410,0,1993,608000.0
3.0,2.25,1720,1.5,0,0,1450,270,1921,620000.0
3.0,2.5,3120,2.0,0,2,1940,1180,1983,850000.0
4.0,2.5,2680,1.0,0,0,1340,1340,1974,463000.0
5.0,1.75,2640,1.0,1,4,1400,1240,1954,750000.0
3.0,3.25,3730,2.0,0,0,3730,0,1989,1070000.0
3.0,2.0,1700,1.0,0,0,1700,0,1986,290000.0
4.0,1.75,2280,1.0,0,0,1250,1030,1947,525000.0
3.0,2.25,1220,2.0,0,0,1220,0,1986,319000.0
6.0,4.5,3500,2.0,0,0,3500,0,1980,592500.0
3.0,2.5,2010,2.0,0,0,2010,0,1977,350000.0
3.0,1.75,2130,1.0,0,0,1430,700,1973,454900.0
4.0,2.25,1800,2.0,0,0,1800,0,1992,272000.0
3.0,1.0,1070,1.0,0,0,1070,0,1961,357500.0
3.0,1.75,1020,1.0,0,0,1020,0,1954,285000.0
4.0,2.0,1600,1.0,0,0,1600,0,1994,280000.0
4.0,1.5,1380,1.0,0,0,1080,300,1928,477000.0
3.0,2.25,3270,2.0,0,0,3270,0,1982,750000.0
4.0,2.5,2100,2.0,0,2,1400,700,1907,595000.0
3.0,2.25,2110,3.0,0,0,2110,0,2001,525000.0
3.0,1.75,1640,1.0,0,0,1640,0,1966,319000.0
3.0,2.0,1320,1.0,0,0,1320,0,1986,225000.0
4.0,2.5,2420,1.0,0,0,1210,1210,1958,485000.0
3.0,1.0,1390,1.5,0,0,1390,0,1908,341000.0
3.0,3.25,2320,2.0,0,0,1930,390,2014,674000.0
3.0,2.5,2170,2.0,0,0,2170,0,2003,442250.0
4.0,2.25,2710,2.0,0,0,2710,0,1977,591000.0
3.0,2.0,1450,1.0,0,0,1450,0,1998,276000.0
3.0,2.5,1370,1.0,0,0,1370,0,1988,394000.0
3.0,2.5,1810,1.0,0,0,1070,740,2001,355000.0
3.0,2.5,1420,1.0,0,0,1020,400,1963,260000.0
3.0,2.75,2090,1.0,0,0,1340,750,1987,300000.0
3.0,2.75,2090,1.0,0,0,1340,750,1987,310000.0
3.0,1.0,1330,1.0,0,0,1330,0,1976,209000.0
3.0,2.0,1330,1.0,0,0,1330,0,1985,344950.0
5.0,2.0,1910,1.0,0,0,1110,800,1951,230000.0
3.0,1.75,2310,1.0,0,0,1410,900,1978,336950.0
3.0,2.75,2500,1.0,0,0,1390,1110,1948,700000.0
3.0,2.0,1310,1.0,0,0,1310,0,1987,230000.0
4.0,2.5,2040,2.0,0,0,2040,0,1994,443500.0
4.0,2.5,2040,2.0,0,0,2040,0,1994,471000.0
3.0,2.25,2400,1.0,0,0,1400,1000,1962,595000.0
3.0,1.0,1400,1.5,0,0,1400,0,1929,470000.0
4.0,1.75,1700,1.0,0,0,1700,0,1975,600000.0
4.0,3.75,3160,2.5,0,0,3160,0,1997,1381000.0
3.0,1.75,1340,1.0,0,2,1340,0,1985,427800.0
4.0,2.0,1470,1.0,0,0,1470,0,1965,445000.0
3.0,1.75,1790,1.0,0,0,1790,0,1953,382000.0
3.0,1.5,1560,1.0,0,0,1200,360,1989,577000.0
3.0,2.5,2620,2.0,0,0,2620,0,1990,427000.0
3.0,1.0,1580,1.0,0,0,1100,480,1962,255000.0
3.0,1.0,1090,1.0,0,0,1090,0,1961,240000.0
5.0,3.25,3240,1.5,0,4,2500,740,1939,1234580.0
4.0,1.75,2520,1.0,0,2,1260,1260,1955,435000.0
3.0,1.75,2230,1.0,0,0,2230,0,1949,1450000.0
4.0,3.0,2430,2.0,0,0,2430,0,2002,425000.0
2.0,1.0,1020,1.0,0,0,1020,0,1923,393000.0
4.0,1.0,1810,1.0,0,0,1410,400,1959,264950.0
4.0,2.5,3460,2.0,0,0,3460,0,1987,746500.0
3.0,1.0,2020,1.0,0,0,1170,850,1956,450000.0
3.0,2.0,1410,1.0,0,0,1410,0,1983,229950.0
2.0,1.0,750,1.0,0,0,750,0,1933,425000.0
4.0,2.5,5300,2.0,1,2,4570,730,1923,2555000.0
4.0,3.5,4380,1.5,0,0,4380,0,1993,1400000.0
3.0,2.25,2290,2.0,0,0,2290,0,1984,753000.0
2.0,1.0,720,1.0,0,0,720,0,1943,310000.0
2.0,1.0,1200,1.0,0,0,600,600,1949,395000.0
3.0,2.5,2620,1.0,0,0,2620,0,1985,725000.0
4.0,3.0,2120,2.0,0,0,2120,0,1964,295000.0
3.0,1.75,1580,1.0,0,0,1580,0,1967,225000.0
3.0,3.25,4160,3.0,0,2,3690,470,2001,1699000.0
3.0,2.25,1830,1.0,0,0,1460,370,1979,431000.0
3.0,2.5,2000,1.0,0,0,1360,640,1998,358500.0
2.0,1.0,980,1.0,0,0,980,0,1907,595000.0
4.0,2.5,3040,2.0,0,0,3040,0,2000,468000.0
4.0,1.0,1740,1.0,0,0,1020,720,1962,260000.0
3.0,2.0,1450,1.5,0,0,1450,0,1955,375000.0
3.0,2.5,1560,2.0,0,0,1560,0,2003,295000.0
4.0,2.5,2050,1.0,0,2,1690,360,1986,403900.0
3.0,1.75,1760,1.0,0,0,1460,300,1956,269950.0
3.0,3.5,1740,2.0,0,3,1310,430,1998,640000.0
3.0,1.0,910,1.0,0,0,910,0,1966,221000.0
3.0,1.75,1700,1.0,0,0,1700,0,1987,255000.0
4.0,2.5,2620,2.0,0,0,2620,0,2008,300000.0
3.0,2.25,1500,1.0,0,0,1500,0,1973,270000.0
4.0,1.75,1630,1.0,0,0,1160,470,1947,575000.0
3.0,1.5,1370,1.0,0,0,1370,0,1968,246900.0
2.0,2.5,1390,2.0,0,0,1130,260,2006,635000.0
3.0,2.0,1540,1.0,0,0,1540,0,1900,450000.0
3.0,1.0,1190,1.0,0,0,1190,0,1968,215000.0
3.0,3.5,4500,2.0,0,0,4500,0,2004,785000.0
4.0,3.0,2370,1.0,0,0,1380,990,1977,522500.0
2.0,1.5,1360,2.0,0,0,1360,0,1978,150000.0
2.0,1.75,870,1.0,0,0,870,0,1946,199950.0
4.0,4.25,4850,2.0,1,4,3850,1000,1989,3000000.0
3.0,2.0,3110,2.0,0,0,3020,90,1999,379900.0
4.0,2.5,3700,2.0,0,0,3700,0,2006,950000.0
6.0,2.75,3500,2.0,0,0,2430,1070,1909,865000.0
3.0,1.75,1670,1.0,0,0,1670,0,1961,785000.0
3.0,2.25,1640,1.0,0,0,1180,460,1968,245700.0
3.0,2.25,3400,1.0,0,1,3400,0,1961,951000.0
3.0,1.75,2060,1.0,0,0,1030,1030,1951,499950.0
3.0,1.75,1330,1.0,0,0,1330,0,1989,257000.0
3.0,2.0,2330,1.5,0,0,1580,750,1900,549000.0
3.0,2.75,3040,2.0,0,0,3040,0,1980,1600000.0
5.0,3.75,3700,3.0,0,4,2900,800,1983,1400000.0
3.0,2.0,1990,1.5,0,2,1430,560,1927,619000.0
5.0,3.0,2020,1.0,0,0,1220,800,1993,311000.0
5.0,2.25,2980,1.0,0,0,1580,1400,1960,600000.0
4.0,3.5,3990,2.0,0,0,3990,0,2008,1080000.0
2.0,1.0,790,1.0,0,0,790,0,1949,436000.0
2.0,1.0,1060,1.0,0,0,1060,0,1941,205000.0
3.0,2.25,2260,1.0,0,0,1450,810,1962,514000.0
2.0,2.5,1900,2.0,0,0,1900,0,2006,530000.0
5.0,2.5,3361,2.0,0,0,3361,0,2006,511000.0
4.0,1.75,3550,2.0,0,0,3550,0,1962,2100000.0
5.0,2.5,2740,2.0,0,0,2740,0,2005,370000.0
4.0,1.75,2040,1.0,0,0,1020,1020,1943,500000.0
4.0,2.5,4070,2.0,0,0,4070,0,1998,710000.0
1.0,1.0,720,1.0,0,0,720,0,1911,270000.0
3.0,1.75,2000,1.5,0,0,2000,0,1959,415000.0
5.0,4.5,4400,2.0,0,0,3390,1010,2003,1800000.0
3.0,1.75,1300,1.0,0,0,1300,0,1967,236000.0
2.0,2.5,1420,2.0,0,0,1420,0,2004,278000.0
3.0,2.25,1540,1.0,0,0,770,770,1954,312000.0
3.0,2.25,1540,1.0,0,0,770,770,1954,539000.0
3.0,3.0,2360,2.0,0,1,1780,580,1983,498000.0
4.0,3.0,3720,2.0,0,0,3720,0,1991,857000.0
3.0,1.75,1690,1.0,0,0,1690,0,1978,780000.0
3.0,2.0,2300,1.0,0,0,1150,1150,1938,650000.0
4.0,1.75,1650,1.0,0,0,1650,0,1973,559500.0
2.0,1.0,990,1.0,0,0,990,0,1948,219950.0
4.0,2.25,2130,2.0,0,0,2130,0,1977,671500.0
4.0,2.5,3320,2.0,0,0,3320,0,1999,813000.0
3.0,2.25,1960,1.0,0,0,1290,670,1965,182000.0
2.0,1.0,770,1.0,0,0,770,0,1913,203700.0
4.0,1.75,2010,1.5,0,0,2010,0,1902,740000.0
2.0,1.0,800,1.0,0,0,800,0,1942,230000.0
3.0,1.0,910,1.0,0,0,910,0,1955,128000.0
3.0,1.0,1200,1.0,0,0,1200,0,1952,345000.0
4.0,2.5,3570,2.0,0,0,3570,0,2005,663000.0
3.0,2.5,1820,2.0,0,0,1820,0,1983,329950.0
3.0,2.25,2930,3.0,0,2,2670,260,1999,1047500.0
3.0,1.75,1480,1.0,0,0,870,610,1926,402300.0
4.0,2.5,3305,1.5,0,0,2245,1060,1922,492000.0
4.0,2.5,2230,1.0,0,0,1650,580,2006,448000.0
3.0,1.0,1560,1.0,0,0,1560,0,1955,273000.0
3.0,1.0,1030,1.0,0,0,880,150,1948,335000.0
3.0,3.75,2380,1.5,0,0,1690,690,1927,695000.0
3.0,1.0,1010,1.0,0,0,1010,0,1948,279000.0
2.0,1.75,2060,1.0,0,0,1030,1030,1929,485000.0
4.0,2.5,2370,2.0,0,0,2370,0,1966,383000.0
4.0,2.5,2242,2.0,0,0,2242,0,1995,490000.0
2.0,1.5,1078,2.0,0,0,1078,0,1990,240000.0
2.0,1.0,890,1.0,0,0,890,0,1943,285000.0
3.0,1.5,2700,2.0,0,0,2120,580,1977,524950.0
4.0,2.5,2450,2.0,0,0,2450,0,1985,729000.0
3.0,1.75,1420,1.0,0,0,1420,0,1960,460000.0
3.0,1.5,1280,1.5,0,0,1280,0,1904,687500.0
5.0,2.75,2910,1.0,0,0,1780,1130,1972,1168000.0
4.0,2.25,2430,2.0,0,0,2430,0,1979,825000.0
2.0,2.5,1860,2.0,0,0,1860,0,2003,314950.0
3.0,2.0,1800,1.0,0,0,1800,0,1956,470000.0
3.0,1.5,1960,1.0,0,0,1020,940,1958,500000.0
3.0,1.5,1550,1.5,0,0,1550,0,1925,313000.0
2.0,1.0,840,1.0,0,0,840,0,1926,445000.0
4.0,1.75,2080,1.0,0,0,1330,750,1967,300000.0
4.0,2.5,2210,1.5,0,0,1480,730,1912,619500.0
3.0,1.5,1210,1.0,0,0,610,600,1983,305000.0
3.0,2.5,1350,3.0,0,0,1350,0,2007,874000.0
3.0,2.0,1860,2.0,0,0,1860,0,1991,477500.0
3.0,2.0,1940,1.0,0,3,1090,850,1926,700000.0
4.0,3.5,3400,2.0,0,0,3400,0,2005,515000.0
4.0,2.5,2240,2.0,0,0,2240,0,1991,590000.0
3.0,1.75,1170,1.0,0,0,1170,0,1981,205000.0
3.0,3.25,3130,2.0,0,0,2190,940,1987,310000.0
2.0,2.25,1510,2.0,0,0,1510,0,1987,442500.0
4.0,3.5,3740,2.0,0,2,3740,0,2000,1078500.0
4.0,2.5,2690,2.0,0,0,2690,0,1980,530000.0
4.0,1.75,1760,1.0,0,2,1180,580,1950,343500.0
4.0,1.75,2180,1.5,0,0,1270,910,1911,334900.0
4.0,1.75,1560,1.0,0,0,1560,0,1969,544300.0
3.0,2.5,1780,2.0,0,0,1780,0,2001,370000.0
3.0,1.75,1260,1.0,0,0,1260,0,1994,245000.0
4.0,1.75,1570,1.5,0,0,1570,0,1928,535000.0
2.0,1.0,740,1.0,0,0,740,0,1946,202000.0
4.0,2.25,2020,2.0,0,0,1710,310,1938,490000.0
4.0,1.5,1500,2.0,0,0,1420,80,1929,651500.0
4.0,2.5,1670,1.0,0,0,1170,500,1961,270000.0
3.0,3.5,3620,2.0,0,0,2920,700,1999,1164000.0
2.0,1.5,1010,2.0,0,0,860,150,2007,289000.0
3.0,1.5,1460,1.0,0,0,1460,0,1977,240000.0
3.0,1.75,1790,1.0,0,2,1350,440,1940,790000.0
3.0,2.25,1760,2.0,0,0,1760,0,1995,350000.0
3.0,3.5,1790,2.0,0,0,1480,310,2006,246950.0
3.0,1.0,1050,1.0,0,0,1050,0,1952,400000.0
4.0,2.5,2590,2.0,0,0,2590,0,2003,533000.0
3.0,1.0,1040,1.0,0,0,1040,0,1962,198400.0
4.0,2.5,4060,2.0,0,0,2790,1270,2007,495000.0
4.0,2.5,3190,2.0,0,0,3190,0,1990,862000.0
4.0,2.5,3190,2.0,0,0,3190,0,1990,870000.0
4.0,1.75,2180,1.0,0,0,2180,0,1966,875000.0
6.0,3.5,2120,2.0,0,0,2120,0,1979,317000.0
4.0,2.75,2110,2.0,0,0,2110,0,1991,325000.0
2.0,1.5,1210,1.5,0,0,1210,0,1907,615000.0
4.0,2.5,2410,2.0,0,0,2410,0,1992,334950.0
3.0,2.5,1980,2.0,0,0,1980,0,1989,775000.0
4.0,2.5,2370,1.0,0,0,1600,770,1967,600000.0
3.0,1.75,1720,1.5,0,0,1270,450,1931,565000.0
2.0,1.0,750,1.0,0,0,750,0,1942,292500.0
3.0,2.25,2510,1.0,0,0,1810,700,1968,825000.0
3.0,2.5,2577,2.0,0,0,2577,0,2000,495000.0
3.0,1.5,1540,2.0,0,0,1540,0,1941,525000.0
1.0,1.0,720,1.0,0,0,720,0,1910,438600.0
3.0,2.25,1810,1.0,0,0,1450,360,1984,507000.0
3.0,1.75,1380,1.0,0,0,1380,0,1967,275900.0
4.0,2.5,2570,2.0,0,0,2570,0,2000,1170000.0
4.0,1.75,1690,1.0,0,0,1690,0,1957,275000.0
3.0,0.75,1420,1.0,0,0,860,560,1923,355000.0
4.0,2.0,2130,1.0,0,0,1250,880,1968,233000.0
3.0,2.5,3000,1.5,0,0,2110,890,1918,666000.0
4.0,2.5,2150,1.0,0,0,1360,790,1979,317500.0
4.0,2.0,2280,1.0,0,3,1270,1010,1989,420000.0
4.0,2.0,1560,2.0,0,0,1560,0,1942,290000.0
3.0,2.0,1880,1.0,0,0,940,940,1952,320000.0
3.0,2.5,2320,2.0,0,0,2320,0,2004,650000.0
3.0,1.75,1010,1.0,0,0,1010,0,1967,325000.0
3.0,1.0,1120,1.0,0,0,1120,0,1917,165000.0
3.0,1.75,1560,1.0,0,0,1560,0,1961,500000.0
4.0,1.5,1860,1.0,0,0,1860,0,1964,443000.0
3.0,1.5,1150,1.0,0,0,1150,0,1963,213400.0
4.0,1.75,1920,1.0,0,0,1920,0,1964,480000.0
4.0,2.25,2490,1.0,0,0,1460,1030,1978,275000.0
3.0,2.5,1460,2.0,0,0,1460,0,2000,299880.0
3.0,3.5,1820,2.0,0,0,1430,390,2014,499950.0
5.0,3.0,4290,1.0,0,3,2480,1810,1972,1705000.0
4.0,2.75,2230,1.0,0,0,1480,750,1960,550000.0
4.0,2.5,2070,2.0,0,0,2070,0,2003,300000.0
3.0,1.75,2480,1.0,0,0,1240,1240,1948,920000.0
4.0,3.25,4110,2.0,1,4,2720,1390,2001,2300000.0
4.0,2.75,2290,1.5,0,0,1550,740,1928,620000.0
3.0,1.0,1220,1.0,0,0,1220,0,1959,253500.0
4.0,2.75,2620,1.5,0,2,1720,900,1926,978000.0
4.0,2.5,3190,2.0,0,0,3190,0,1979,387500.0
3.0,1.0,850,1.0,0,0,850,0,1948,325000.0
3.0,2.5,1740,3.0,0,0,1740,0,2008,568000.0
4.0,2.5,2140,2.0,0,0,2140,0,1996,525000.0
3.0,2.5,2070,2.0,0,0,2070,0,1996,560000.0
3.0,2.5,1680,2.0,0,0,1680,0,2008,394000.0
2.0,1.0,1000,1.0,0,2,1000,0,1916,484950.0
3.0,2.75,3340,1.0,0,0,2550,790,1956,1295000.0
3.0,2.5,1260,2.0,0,0,1260,0,1999,315000.0
4.0,2.25,2430,1.0,0,0,2430,0,1993,590000.0
1.0,1.0,560,1.0,0,0,560,0,1947,106000.0
3.0,2.5,3380,2.0,0,0,3380,0,1994,751000.0
2.0,1.0,1100,1.0,0,0,1100,0,1908,474000.0
2.0,2.0,1700,1.0,0,0,850,850,1927,189000.0
3.0,2.5,1600,2.0,0,0,1600,0,2002,440500.0
3.0,2.5,2605,2.0,0,2,2090,515,1979,1017000.0
2.0,2.0,1850,1.0,0,0,1850,0,2010,589000.0
3.0,2.25,1830,2.0,0,0,1830,0,1986,273000.0
3.0,3.25,3050,1.0,1,4,1650,1400,1962,950000.0
2.0,1.5,1240,2.0,0,0,1200,40,1967,277700.0
3.0,2.25,2100,2.0,0,0,2100,0,1984,299900.0
3.0,1.0,1250,1.0,0,0,1250,0,1959,235000.0
2.0,2.0,1230,2.0,0,0,1230,0,1952,464000.0
3.0,1.75,1690,1.0,0,0,1690,0,1988,281000.0
3.0,1.0,1520,1.5,0,0,1520,0,1951,320000.0
4.0,2.0,1890,2.0,0,0,1890,0,1997,282000.0
4.0,1.75,1990,1.0,0,0,1990,0,1972,745000.0
3.0,1.75,1480,1.0,0,0,1480,0,1980,245000.0
3.0,1.75,1480,1.0,0,0,1480,0,1980,250000.0
3.0,2.5,2120,2.0,0,0,1770,350,2005,470000.0
3.0,3.5,1480,2.0,0,0,1300,180,2007,216650.0
3.0,1.0,1250,1.0,0,0,1250,0,1975,440000.0
4.0,2.5,2010,2.0,0,0,2010,0,1989,590000.0
5.0,2.5,3150,1.0,0,0,1800,1350,1975,935000.0
3.0,3.5,3010,2.0,0,0,3010,0,2000,848000.0
5.0,4.25,3920,2.0,0,0,3000,920,2000,827500.0
6.0,3.0,2880,2.0,0,0,2180,700,1919,1125000.0
2.0,2.25,2550,1.0,0,0,1720,830,2011,630000.0
5.0,1.0,1120,1.5,0,0,1120,0,1962,340000.0
4.0,2.75,3140,1.0,0,0,1900,1240,1968,570000.0
4.0,4.0,4130,2.0,1,4,2860,1270,1993,2750000.0
4.0,2.5,2990,1.0,0,2,1740,1250,1976,514500.0
2.0,1.0,1120,1.0,0,3,1120,0,1940,360000.0
4.0,1.5,1570,1.0,0,0,1570,0,1943,228900.0
3.0,2.75,2210,2.0,0,0,2210,0,2008,660000.0
4.0,2.5,2390,2.0,0,0,2390,0,2000,647000.0
3.0,1.75,1520,1.0,0,0,1520,0,1976,366000.0
5.0,1.75,1830,1.0,0,0,1060,770,1962,354000.0
4.0,3.5,2640,2.0,0,2,2640,0,1937,850000.0
3.0,2.5,1740,2.0,0,0,1740,0,1989,496700.0
3.0,2.0,1550,1.0,0,0,1550,0,1965,300000.0
3.0,1.0,1040,1.0,0,0,1040,0,1961,390000.0
3.0,2.25,1640,2.0,0,0,1640,0,1985,350000.0
3.0,2.25,1640,2.0,0,0,1640,0,1985,561000.0
3.0,1.75,1260,1.0,0,0,1260,0,1954,475000.0
3.0,1.5,1170,2.0,0,0,840,330,2007,275000.0
3.0,1.75,1590,1.0,0,0,1090,500,1980,290000.0
3.0,2.5,1750,1.0,0,0,1330,420,1993,199000.0
4.0,2.5,1770,2.0,0,0,1770,0,2001,279900.0
4.0,2.25,3530,2.0,0,0,2860,670,1940,1655000.0
3.0,2.5,2160,1.0,0,0,1360,800,1978,405000.0
4.0,2.25,2360,1.0,0,0,2360,0,1977,615000.0
3.0,1.75,1980,1.0,0,0,1180,800,1978,268000.0
4.0,1.5,1620,1.5,0,0,1620,0,1955,451000.0
2.0,2.75,2700,1.0,0,0,2700,0,2012,850000.0
5.0,2.25,3270,2.0,0,2,2470,800,1968,1180000.0
2.0,1.0,870,1.0,0,0,870,0,1941,245000.0
2.0,1.75,840,1.0,0,0,700,140,1912,450000.0
3.0,3.5,1340,2.0,0,2,1080,260,2002,370350.0
3.0,2.5,1540,3.0,0,0,1540,0,2004,543000.0
2.0,2.0,1650,1.0,0,0,1650,0,1942,265000.0
3.0,2.5,2630,2.0,0,0,2630,0,2001,497000.0
4.0,2.25,1880,1.0,0,0,1100,780,1979,419000.0
4.0,2.5,1980,2.0,0,0,1980,0,1989,545800.0
3.0,1.0,1500,1.0,0,0,1000,500,1977,403000.0
3.0,2.0,1230,1.5,0,0,1230,0,1959,195000.0
4.0,2.5,2520,2.0,0,0,1670,850,1925,1125000.0
5.0,1.75,1970,1.0,0,0,1170,800,1977,255000.0
2.0,1.5,1520,1.0,0,0,1520,0,1951,500000.0
4.0,2.75,2600,1.0,0,0,1300,1300,1960,855000.0
4.0,2.0,2290,1.5,0,0,2290,0,1920,390000.0
3.0,2.0,1979,1.0,0,2,1329,650,1956,339000.0
4.0,3.5,2170,2.0,0,0,2170,0,1905,1325000.0
4.0,1.5,1820,1.0,0,0,1190,630,1962,429900.0
3.0,1.5,1200,1.0,0,0,1200,0,1975,370900.0
3.0,1.0,1210,1.0,0,0,1210,0,1952,457500.0
4.0,2.5,1970,2.0,0,0,1440,530,1999,499000.0
2.0,1.0,1040,1.0,0,0,1040,0,1947,225000.0
3.0,1.75,1920,1.0,0,0,1070,850,1950,615000.0
2.0,1.5,1020,3.0,0,0,1020,0,2001,455000.0
3.0,1.0,1660,1.0,0,0,1060,600,1940,458000.0
3.0,2.25,1670,1.0,0,0,1220,450,1974,580000.0
5.0,4.5,3810,2.0,0,0,3810,0,2008,966000.0
4.0,1.75,2020,1.0,0,0,1010,1010,1954,240000.0
1.0,1.0,420,1.0,0,0,420,0,1949,229050.0
3.0,2.25,1390,3.0,0,0,1390,0,2004,328500.0
3.0,1.5,2010,1.0,0,0,1110,900,1964,319000.0
4.0,2.0,1820,1.5,0,1,1640,180,1945,650000.0
3.0,2.5,1630,2.0,0,0,1630,0,1996,398500.0
1.0,1.0,800,1.0,0,0,680,120,1931,250000.0
3.0,2.0,2270,1.0,0,0,2270,0,1968,815000.0
3.0,2.75,2290,2.0,0,0,1950,340,1995,1065000.0
3.0,2.25,2750,2.0,0,0,1870,880,1981,510000.0
2.0,1.75,590,1.0,0,0,590,0,1947,156000.0
4.0,2.75,2570,2.0,0,0,1720,850,1998,254500.0
3.0,2.5,2050,1.0,0,2,1600,450,1960,760000.0
3.0,2.5,1610,2.0,0,0,1610,0,1994,210000.0
3.0,2.5,2140,2.0,0,0,2140,0,1991,349950.0
3.0,2.0,1730,2.5,0,0,1730,0,1942,676000.0
4.0,3.5,2440,2.0,0,0,1940,500,2006,475000.0
4.0,2.75,3220,1.5,0,0,2320,900,1931,880000.0
4.0,3.25,4330,2.0,0,0,4330,0,1997,1209000.0
3.0,1.5,1780,1.0,0,4,1030,750,1958,420000.0
3.0,1.0,1230,1.0,0,0,1230,0,1951,607000.0
4.0,1.75,2160,2.0,0,0,2160,0,1981,475000.0
2.0,1.75,1400,1.0,0,0,710,690,1916,395000.0
4.0,1.75,1900,1.0,0,0,1180,720,1954,650000.0
5.0,2.75,2910,1.0,0,0,1510,1400,1966,625000.0
3.0,3.0,2960,2.0,0,0,2960,0,1995,849000.0
3.0,1.5,2010,1.0,0,0,1570,440,1951,429950.0
3.0,2.5,3760,2.0,0,0,3230,530,2002,825000.0
2.0,1.0,1020,1.0,0,0,1020,0,1916,505000.0
2.0,1.0,1290,2.0,0,0,1290,0,2008,265000.0
3.0,1.0,890,1.0,0,0,890,0,1954,283000.0
3.0,2.75,1620,1.0,0,0,1140,480,1979,560000.0
4.0,2.5,3360,2.0,0,0,3360,0,1987,765000.0
5.0,2.75,2930,1.0,0,0,1520,1410,1975,610000.0
3.0,2.5,2940,1.0,0,0,1710,1230,1996,589000.0
3.0,1.0,1080,1.5,0,0,1080,0,1900,192500.0
3.0,3.25,4560,1.0,0,4,2760,1800,1995,3200000.0
3.0,1.0,1010,1.0,0,0,860,150,1940,550000.0
2.0,1.5,1790,1.5,0,0,1280,510,1928,460000.0
4.0,2.25,2060,1.0,0,0,1200,860,1962,264500.0
3.0,1.0,1150,1.0,0,0,1010,140,1947,339000.0
4.0,3.5,4030,3.0,0,0,4030,0,1992,950000.0
3.0,1.75,2020,1.0,0,0,2020,0,1956,677500.0
4.0,2.5,2740,2.0,0,0,2740,0,1999,690000.0
4.0,2.25,1930,1.0,0,0,1430,500,1984,312000.0
5.0,1.75,2500,1.0,0,0,1560,940,1966,840000.0
3.0,3.5,2080,2.0,0,0,2080,0,2004,357500.0
3.0,1.5,1460,1.0,0,2,980,480,1940,675000.0
3.0,2.75,3290,2.0,0,0,3290,0,1988,515000.0
4.0,2.5,1540,2.0,0,0,1540,0,2014,491234.0
3.0,2.0,1310,1.0,0,0,1310,0,1988,290000.0
4.0,2.5,2120,1.0,0,0,1280,840,1975,490000.0
4.0,2.0,2920,1.0,0,0,1520,1400,1964,810000.0
3.0,1.5,1150,1.0,0,0,1150,0,1956,252000.0
3.0,2.5,2380,2.0,0,0,2380,0,2001,299999.0
3.0,2.75,2220,2.0,0,0,2220,0,1993,400000.0
5.0,2.0,3020,1.5,0,0,1860,1160,1925,530000.0
3.0,2.0,2460,1.0,1,4,2460,0,1955,357000.0
3.0,1.75,1820,1.0,0,0,1030,790,1939,365000.0
4.0,2.5,2620,2.0,0,0,2620,0,2005,804000.0
3.0,2.0,1750,1.0,0,0,1010,740,1914,808250.0
4.0,2.5,2020,2.0,0,0,2020,0,1994,360000.0
3.0,1.75,1240,1.0,0,0,1240,0,1987,240000.0
2.0,2.0,1380,1.0,0,0,1380,0,1988,335000.0
3.0,1.75,1920,1.0,0,0,1920,0,1953,380000.0
3.0,1.75,1680,1.0,0,0,1070,610,1940,350000.0
3.0,1.0,1400,1.0,0,0,1400,0,1964,194000.0
3.0,1.0,1240,1.0,0,0,1090,150,1936,310000.0
3.0,1.75,1410,1.0,0,0,1410,0,1980,315000.0
3.0,1.75,1440,1.0,0,0,1440,0,1985,258950.0
2.0,2.25,1230,2.0,0,0,1020,210,2004,479000.0
5.0,1.5,1550,1.0,0,0,1550,0,1966,510000.0
3.0,2.0,1760,1.0,0,0,1760,0,1967,400000.0
4.0,3.5,5000,2.0,0,0,3610,1390,2004,1450000.0
5.0,2.0,2140,1.5,0,0,2020,120,1913,680000.0
6.0,3.0,3510,2.5,0,0,3510,0,1906,1750000.0
3.0,1.75,2010,1.0,0,0,1500,510,1967,335000.0
5.0,2.5,3390,1.0,0,0,1750,1640,1978,460000.0
4.0,2.25,2160,1.0,0,0,1080,1080,1966,440000.0
2.0,2.0,1300,1.0,0,0,1300,0,2006,412250.0
3.0,1.5,1280,2.0,0,0,1280,0,1985,185000.0
3.0,2.0,1840,1.0,0,0,1040,800,1975,286500.0
4.0,2.5,3200,2.0,0,0,3200,0,2002,422000.0
3.0,2.25,2800,2.0,0,0,2800,0,1985,408000.0
2.0,1.0,1390,1.0,0,2,1390,0,1949,306500.0
4.0,2.5,2600,2.0,0,0,2600,0,2005,359900.0
3.0,2.5,1960,2.0,0,0,1960,0,2002,560000.0
3.0,1.0,1250,1.0,0,0,1250,0,1970,259875.0
3.0,1.0,1250,1.0,0,0,1250,0,1970,385000.0
1.0,1.0,550,1.0,0,0,550,0,1945,188000.0
4.0,3.25,2500,1.5,0,0,1960,540,1926,1142000.0
3.0,1.0,1250,1.0,0,0,1250,0,1927,255000.0
4.0,2.75,3020,2.0,0,0,3020,0,1976,1185000.0
4.0,1.75,1640,1.0,0,0,920,720,1921,635200.0
3.0,1.75,1870,2.0,0,0,1870,0,1956,355000.0
3.0,2.5,1760,3.5,0,0,1760,0,1998,544000.0
3.0,1.5,1320,2.0,0,0,1320,0,1998,402000.0
4.0,1.5,1430,1.5,0,0,1430,0,1910,575000.0
3.0,1.75,1580,1.0,0,0,1580,0,1977,216000.0
4.0,3.5,4170,2.0,0,0,4170,0,2004,1200000.0
4.0,3.25,3090,2.0,0,4,3090,0,1923,850000.0
3.0,2.0,1020,2.0,0,0,720,300,2004,238000.0
4.0,1.75,2180,1.5,0,0,2020,160,1912,625000.0
5.0,3.25,3350,2.0,0,0,2510,840,1997,1110000.0
3.0,2.5,2510,2.0,0,2,2510,0,1995,820000.0
3.0,2.5,1880,1.0,0,0,1250,630,1974,355000.0
4.0,1.5,1810,1.0,0,0,1210,600,1960,495000.0
5.0,2.5,4170,2.0,0,0,4170,0,1991,1300000.0
3.0,2.5,2230,2.0,0,0,2230,0,1954,398750.0
4.0,2.5,3650,2.0,0,0,3650,0,2006,835000.0
6.0,2.75,2830,1.0,0,0,1430,1400,1967,705000.0
4.0,1.5,2120,2.0,0,0,2120,0,1900,625000.0
4.0,2.5,2090,2.0,0,0,2090,0,1990,550000.0
3.0,1.5,2600,1.0,0,0,1400,1200,1940,540000.0
2.0,1.0,830,1.0,0,0,830,0,1920,519000.0
4.0,2.5,1975,2.0,0,0,1975,0,1996,311000.0
4.0,2.5,1900,1.0,0,0,1420,480,1968,305000.0
4.0,2.75,2640,1.5,0,0,2640,0,1963,395000.0
4.0,1.5,1610,1.0,0,0,1010,600,1969,275000.0
3.0,3.25,1770,2.0,0,0,1430,340,2003,450000.0
2.0,1.0,1070,1.0,0,0,1070,0,1955,324000.0
5.0,3.25,4590,2.0,0,2,3590,1000,1928,2795000.0
4.0,1.0,1540,1.5,0,0,1540,0,1906,565000.0
4.0,1.75,1590,2.0,0,0,1590,0,1960,373000.0
2.0,2.0,1170,1.5,0,1,1170,0,1927,613000.0
4.0,2.25,2880,1.0,0,0,1920,960,1981,614000.0
4.0,1.75,2510,1.0,0,0,1680,830,1964,595000.0
2.0,1.0,1280,1.0,0,0,850,430,1983,440000.0
3.0,1.5,1570,1.0,0,3,1570,0,1954,425000.0
2.0,1.0,740,1.0,0,0,740,0,1912,407000.0
3.0,1.5,1740,1.0,0,0,1740,0,1955,472000.0
3.0,2.5,1180,3.0,0,0,1180,0,2010,472000.0
5.0,2.75,2960,1.0,0,3,2160,800,1959,1250000.0
3.0,1.75,1880,1.0,0,0,940,940,1945,412000.0
3.0,1.0,1150,1.0,0,0,1150,0,1959,717000.0
3.0,1.0,1320,1.0,0,0,1320,0,1959,425000.0
4.0,2.0,1640,1.0,0,0,820,820,1944,299999.0
3.0,2.0,1470,1.0,0,0,1470,0,1992,254000.0
3.0,1.0,900,1.0,0,0,900,0,1961,178500.0
3.0,1.75,1510,1.0,0,0,1230,280,1910,800000.0
3.0,1.0,1440,1.0,0,0,720,720,1922,420000.0
2.0,1.0,1380,1.0,0,0,1380,0,1940,319900.0
2.0,1.5,1150,1.0,0,1,1150,0,1944,350000.0
6.0,2.75,3610,1.0,0,4,2070,1540,1959,968000.0
3.0,2.0,1250,3.0,0,0,1250,0,2000,491000.0
3.0,2.5,3510,2.0,0,0,3510,0,2002,948000.0
3.0,2.5,2260,2.0,0,0,1700,560,1925,900000.0
3.0,1.75,2840,1.0,0,0,1420,1420,1977,270000.0
3.0,1.5,1430,1.0,0,0,820,610,1980,198000.0
2.0,1.0,1420,1.0,0,0,1420,0,1953,250000.0
4.0,2.5,2120,2.0,0,0,2120,0,2004,615000.0
3.0,2.5,2080,2.0,0,0,2080,0,1988,550000.0
2.0,2.5,1370,2.0,0,0,1370,0,1987,190000.0
4.0,2.25,1900,1.0,0,0,1280,620,1984,629000.0
3.0,1.75,1660,1.0,0,0,1660,0,1955,434000.0
3.0,1.0,1310,1.0,0,0,1310,0,1964,415885.0
3.0,2.5,1840,1.0,0,0,920,920,1926,550000.0
1.0,0.75,1040,1.0,0,1,580,460,1991,272000.0
3.0,2.5,2610,2.0,0,0,2610,0,1988,665000.0
3.0,2.0,1990,1.0,0,0,1990,0,1971,510000.0
3.0,2.0,3080,1.0,0,0,1740,1340,1965,530000.0
3.0,1.0,1200,1.0,0,0,1200,0,1970,355000.0
4.0,1.0,1250,1.0,0,0,1250,0,1955,255000.0
4.0,2.75,2640,2.0,0,0,2640,0,1990,790000.0
5.0,1.75,1790,2.0,0,0,1790,0,1952,695000.0
2.0,2.0,1140,1.0,0,0,1140,0,1954,255000.0
3.0,2.25,1790,1.5,0,0,1380,410,1985,410000.0
4.0,2.75,1910,1.0,0,0,1420,490,1940,650000.0
4.0,1.75,1530,1.5,0,0,1530,0,1913,675000.0
2.0,2.5,1050,2.0,0,0,950,100,2007,332888.0
3.0,1.75,1730,1.0,0,0,1130,600,1976,300000.0
4.0,1.5,1100,1.0,0,0,1100,0,1954,320000.0
5.0,2.25,2100,1.0,0,0,1050,1050,1963,342500.0
4.0,2.5,2800,2.0,0,0,2800,0,1992,752875.0
5.0,3.5,5000,2.0,0,3,3410,1590,2008,1730000.0
1.0,0.5,880,1.0,0,0,500,380,1910,255000.0
3.0,2.5,1470,2.0,0,0,1470,0,1991,244000.0
5.0,3.25,3950,2.0,0,2,3430,520,2006,1420000.0
3.0,1.0,980,1.0,0,0,980,0,1956,218000.0
4.0,1.0,2180,1.5,0,0,2180,0,1950,359000.0
4.0,2.75,3040,2.0,0,0,3040,0,2003,840000.0
5.0,3.75,4130,2.0,0,0,3170,960,1985,900000.0
4.0,1.75,1850,1.5,0,0,1850,0,1972,205000.0
3.0,2.5,1600,2.0,0,0,1600,0,1993,205000.0
2.0,1.5,2070,2.0,0,0,1370,700,1951,500000.0
4.0,2.5,3180,2.0,0,0,3180,0,2001,510000.0
6.0,4.25,6900,2.0,0,0,4820,2080,2002,1135000.0
4.0,2.25,2640,2.0,0,0,2080,560,1908,1545000.0
3.0,1.5,1920,1.0,0,0,1920,0,1953,210000.0
3.0,1.75,2030,1.0,0,0,1600,430,1981,597500.0
2.0,1.0,1140,1.5,0,0,1140,0,1932,400000.0
3.0,1.0,1660,1.0,0,0,1260,400,1952,412000.0
2.0,1.5,1390,3.0,0,0,1390,0,2005,299950.0
4.0,3.0,2490,1.5,0,0,1690,800,1922,1081000.0
4.0,2.5,2550,2.0,0,0,2550,0,1990,422500.0
3.0,2.0,1270,1.0,0,0,1270,0,1968,410000.0
4.0,3.25,2980,2.0,0,3,2140,840,1900,1400000.0
3.0,2.0,1470,1.0,0,0,1470,0,1974,245000.0
4.0,3.0,3550,1.5,0,0,2180,1370,1990,720000.0
2.0,1.0,780,1.0,0,0,780,0,1935,315000.0
2.0,2.5,1390,2.0,0,0,1390,0,1987,191950.0
4.0,2.5,2440,2.0,0,0,2440,0,2005,455000.0
3.0,1.5,1260,1.5,0,0,1260,0,1931,523000.0
3.0,2.25,1640,2.0,0,0,1640,0,1918,250000.0
3.0,3.0,1670,1.5,0,0,1140,530,1929,294000.0
3.0,2.25,2380,1.0,0,0,2040,340,1961,490000.0
4.0,1.0,1030,1.0,0,0,1030,0,1971,310000.0
3.0,1.5,1560,1.0,0,0,1560,0,1961,265000.0
4.0,1.75,1640,1.0,0,0,1010,630,1968,402000.0
2.0,2.5,2200,1.0,0,3,2200,0,2007,705000.0
4.0,2.5,3190,2.0,0,0,3190,0,2005,589450.0
3.0,1.5,1200,1.0,0,0,1200,0,1964,219950.0
3.0,2.25,2250,2.0,0,0,1510,740,1975,750000.0
2.0,1.75,1960,1.0,0,0,980,980,1904,478000.0
3.0,1.0,1250,1.0,0,0,1250,0,1958,170000.0
4.0,2.25,2640,1.0,0,0,2640,0,1986,489950.0
2.0,2.25,2460,1.5,0,4,1930,530,1936,1370000.0
3.0,2.5,1700,2.0,0,0,1700,0,1996,319950.0
2.0,1.0,840,1.0,0,0,840,0,1938,208417.0
4.0,2.0,1900,1.0,0,0,950,950,1914,410000.0
4.0,2.75,2160,1.0,0,3,1080,1080,1969,590000.0
3.0,1.75,1610,1.0,0,0,1610,0,1961,648000.0
3.0,2.5,1720,2.0,0,0,1720,0,1998,255000.0
4.0,2.75,2190,2.0,0,0,2190,0,2004,465000.0
4.0,1.75,3020,1.0,0,0,1510,1510,1958,622000.0
3.0,1.75,1980,1.0,0,0,1980,0,1991,306000.0
3.0,2.5,1880,2.0,0,0,1880,0,1947,617000.0
3.0,1.75,1610,1.0,0,0,1610,0,1947,438750.0
4.0,3.0,3260,2.0,0,0,2300,960,1930,1280000.0
5.0,3.25,3970,2.0,0,2,2970,1000,1979,995000.0
4.0,2.5,4570,2.0,0,4,4570,0,1948,1580000.0
5.0,2.75,2620,1.5,0,0,1710,910,1911,635000.0
3.0,1.0,1180,1.0,0,0,1180,0,1970,215000.0
3.0,2.5,1365,3.0,0,0,1315,50,2003,530000.0
2.0,1.0,720,1.0,0,0,720,0,1943,295000.0
3.0,2.25,1350,1.0,0,0,930,420,1981,245000.0
6.0,2.5,3060,1.0,0,0,1530,1530,1967,400000.0
3.0,2.75,1850,2.0,0,0,1850,0,1993,303000.0
3.0,1.75,1320,1.5,0,0,1320,0,1970,330000.0
3.0,1.75,1990,2.0,0,3,1990,0,1980,700000.0
1.0,1.0,610,1.0,0,0,610,0,1922,126000.0
4.0,1.0,2500,1.5,0,0,2500,0,1955,850000.0
3.0,2.0,1440,1.0,0,0,1440,0,1965,405000.0
6.0,4.5,2750,2.0,0,0,1770,980,1987,869900.0
3.0,1.75,1790,1.0,0,2,1790,0,1951,485000.0
2.0,2.0,1050,2.0,0,0,720,330,2004,400000.0
3.0,2.5,1780,2.0,0,0,1780,0,2011,299950.0
4.0,2.5,2200,2.0,0,0,2200,0,1994,585000.0
4.0,2.0,1720,2.0,0,0,1470,250,1938,495000.0
5.0,4.5,5840,2.0,0,0,4570,1270,2006,2200000.0
3.0,2.25,1520,2.0,0,0,1520,0,1984,447000.0
3.0,1.0,1320,1.0,0,0,1320,0,1968,206000.0
3.0,1.0,1070,1.0,0,0,950,120,1930,500000.0
4.0,2.5,1990,2.0,0,0,1990,0,1994,302500.0
4.0,4.25,4980,2.0,0,3,3080,1900,1982,1250000.0
2.0,1.0,890,1.0,0,0,890,0,1946,391000.0
3.0,2.0,1440,2.0,0,0,1440,0,1986,250000.0
4.0,2.5,2440,2.0,0,0,2440,0,2003,435000.0
4.0,2.25,1800,1.0,0,0,1440,360,1962,160000.0
5.0,3.0,2260,1.0,0,0,1330,930,2003,451000.0
2.0,1.0,810,1.0,0,0,810,0,1944,206000.0
4.0,2.75,2240,2.0,0,0,1540,700,1940,590000.0
3.0,2.5,4560,2.0,0,0,3800,760,1986,695000.0
3.0,1.5,1550,1.0,0,0,1550,0,1954,350000.0
5.0,3.5,3180,2.0,0,0,2420,760,2001,1236300.0
6.0,2.25,2950,1.0,0,0,1700,1250,1970,395000.0
5.0,3.0,2190,2.0,0,0,2190,0,1999,419000.0
2.0,2.0,1570,1.0,0,0,1570,0,2006,592350.0
5.0,3.25,3420,2.0,0,0,2620,800,2003,855000.0
4.0,2.5,2420,2.0,0,0,2420,0,1991,771000.0
3.0,2.25,1570,1.0,0,3,1570,0,1967,325000.0
5.0,3.25,3680,2.0,0,0,2630,1050,1925,1850000.0
4.0,1.75,1910,1.0,0,0,1210,700,1953,545000.0
3.0,1.75,1780,1.0,0,0,990,790,1927,615000.0
2.0,1.0,2160,1.0,0,0,1300,860,1953,625500.0
3.0,1.5,1460,1.0,0,0,1460,0,1966,232000.0
3.0,1.5,1370,1.0,0,0,1370,0,1963,168000.0
3.0,1.5,1370,1.0,0,0,1370,0,1963,238000.0
3.0,2.5,1500,2.0,0,0,1500,0,1998,260000.0
3.0,1.75,1210,1.0,0,0,1210,0,1951,460000.0
3.0,2.5,2850,1.0,0,1,1680,1170,1952,900000.0
3.0,1.0,1090,1.0,0,0,1090,0,1947,289950.0
3.0,1.75,1450,1.0,0,0,1450,0,1991,265000.0
4.0,2.25,1820,1.0,0,0,1340,480,1977,465000.0
3.0,1.5,1320,1.0,0,0,1320,0,1971,370000.0
2.0,1.5,1670,1.0,0,0,1670,0,1941,240000.0
4.0,2.0,1440,1.0,0,0,1440,0,1943,232000.0
3.0,1.0,980,1.0,0,0,980,0,1951,237502.0
4.0,3.5,4340,2.0,0,0,2850,1490,2008,1280000.0
4.0,2.25,2860,1.0,0,0,1430,1430,1966,957000.0
3.0,1.5,1140,1.0,0,0,1140,0,1970,218000.0
3.0,1.5,1120,1.0,0,0,1120,0,1968,205000.0
3.0,3.25,1460,2.0,0,0,1130,330,2006,350000.0
4.0,2.5,2050,2.0,0,0,2050,0,2002,256000.0
3.0,1.0,1250,1.0,0,0,1000,250,1952,275000.0
4.0,2.5,2520,2.0,0,0,2520,0,1990,372000.0
3.0,3.25,2580,1.5,0,1,1760,820,1978,688888.0
2.0,1.0,1200,2.0,0,0,1200,0,1976,170000.0
5.0,2.25,2140,1.0,0,0,1070,1070,1962,530000.0
4.0,3.25,3440,2.0,0,0,3440,0,2006,905000.0
4.0,2.5,1800,1.0,0,0,1080,720,1979,365000.0
4.0,2.5,1790,1.0,0,0,1290,500,1981,312000.0
2.0,1.75,1250,1.0,0,0,1250,0,1922,400000.0
2.0,2.0,800,1.0,0,0,800,0,1936,278750.0
3.0,2.0,1410,1.0,0,0,1410,0,1965,510000.0
2.0,2.25,1330,3.0,0,0,1330,0,2009,527700.0
4.0,2.75,2890,1.5,0,0,2190,700,1931,740000.0
4.0,2.5,2550,2.0,0,0,2550,0,1996,512000.0
5.0,2.5,2880,2.0,0,0,2880,0,2001,362000.0
3.0,1.0,660,1.0,0,0,660,0,1940,225000.0
3.0,2.25,1470,2.0,0,0,1470,0,1985,491500.0
4.0,1.75,1700,1.0,0,0,1320,380,1959,429950.0
3.0,1.0,1040,1.0,0,0,1040,0,1955,375000.0
2.0,1.0,880,1.0,0,0,880,0,1916,199400.0
4.0,2.5,2490,2.0,0,2,2490,0,1996,364900.0
3.0,1.5,1210,1.0,0,0,1210,0,1941,324950.0
5.0,2.0,2080,1.0,0,0,1040,1040,1909,467000.0
3.0,1.0,1380,1.0,0,0,1380,0,1954,380000.0
3.0,2.25,1620,1.0,0,0,1620,0,1966,250000.0
4.0,1.0,1680,1.5,0,0,1680,0,1921,700000.0
3.0,1.0,1330,1.0,0,0,1330,0,1976,206990.0
3.0,1.75,1730,1.0,0,0,970,760,1928,670000.0
2.0,1.0,790,1.0,0,0,790,0,1955,315000.0
3.0,2.5,2240,2.0,0,0,2240,0,1985,319950.0
3.0,1.5,1500,1.0,0,0,1500,0,1958,419000.0
3.0,2.0,1800,1.0,0,0,1800,0,1989,205000.0
4.0,2.5,1980,2.0,0,0,1980,0,2004,335000.0
3.0,1.75,1340,1.0,0,0,1340,0,1953,397000.0
2.0,1.0,750,1.0,0,0,750,0,1908,370000.0
4.0,2.25,1790,1.0,0,0,1170,620,1969,330000.0
4.0,3.5,5490,1.0,0,4,2910,2580,1996,1785000.0
3.0,2.0,1940,1.0,0,0,1140,800,1978,399000.0
4.0,1.75,2670,2.0,0,4,2670,0,1972,400000.0
3.0,2.0,1220,1.0,0,0,1220,0,1994,249900.0
3.0,1.5,1310,1.0,0,0,1090,220,1956,717000.0
4.0,2.5,1930,2.0,0,0,1930,0,1995,319000.0
4.0,3.0,2100,2.0,0,0,2100,0,1972,635000.0
3.0,1.0,1180,1.0,0,0,1180,0,1977,355000.0
5.0,3.25,4320,2.0,0,0,4320,0,1990,1600000.0
4.0,1.75,3140,1.0,0,0,2320,820,1951,585000.0
3.0,2.0,2320,1.0,0,0,1160,1160,1960,320000.0
3.0,1.75,2110,2.0,0,0,2110,0,1966,305495.0
4.0,2.0,1790,1.0,0,1,1670,120,1960,240000.0
5.0,2.5,1740,1.0,0,0,1740,0,1959,199950.0
4.0,3.25,3820,2.0,0,0,3820,0,2005,1620000.0
3.0,3.5,2050,2.0,1,4,1750,300,1930,770000.0
4.0,2.25,1680,2.0,0,0,1680,0,2002,255000.0
4.0,2.25,1930,1.0,0,0,1930,0,1974,289000.0
4.0,3.0,3760,2.0,0,0,2470,1290,2002,494500.0
3.0,2.25,2370,1.0,0,0,1650,720,1973,746000.0
4.0,3.0,2120,2.0,0,0,2120,0,1978,385000.0
4.0,2.5,2370,2.0,0,0,2370,0,1987,688100.0
4.0,2.5,2350,1.5,0,0,1690,660,1910,870300.0
3.0,1.0,1180,1.5,0,0,1180,0,1956,310000.0
3.0,2.5,2270,2.0,0,0,2270,0,1999,500000.0
3.0,2.25,1830,1.0,0,0,1400,430,1977,255000.0
3.0,2.75,3910,1.0,0,0,1970,1940,1949,1475000.0
3.0,1.0,890,1.0,0,0,890,0,1957,154500.0
3.0,2.25,1820,1.0,0,0,1260,560,1974,425000.0
4.0,2.5,2440,2.0,0,0,2440,0,1988,700000.0
2.0,1.0,1110,1.0,0,0,740,370,1916,410500.0
3.0,2.0,1870,1.0,0,0,1210,660,1969,432000.0
3.0,1.5,1240,1.5,0,0,1240,0,1914,530000.0
3.0,2.0,1560,1.0,0,0,1560,0,1967,465000.0
3.0,2.5,1910,2.0,0,0,1910,0,1989,498688.0
3.0,1.0,2200,1.0,0,0,1600,600,1952,573500.0
4.0,2.75,2530,2.0,0,0,2530,0,1994,349900.0
3.0,1.0,1130,1.0,0,0,1130,0,1958,220000.0
2.0,1.0,820,1.0,0,0,820,0,1918,260000.0
2.0,1.0,960,1.0,0,0,960,0,1918,290000.0
4.0,1.5,1980,1.5,0,0,1780,200,1930,615000.0
4.0,3.5,3370,2.0,0,0,2250,1120,2001,730000.0
4.0,3.25,7420,2.0,0,3,7420,0,2002,1950000.0
3.0,2.25,1800,2.0,0,0,1800,0,1995,332500.0
5.0,3.5,3990,2.0,0,0,2820,1170,1990,650000.0
4.0,2.5,4070,3.0,0,0,3390,680,2002,1400000.0
4.0,1.75,1640,1.5,0,0,1480,160,1915,465000.0
4.0,3.25,3730,2.0,0,0,2460,1270,1990,690000.0
3.0,1.75,1220,1.0,0,0,1220,0,1966,289900.0
3.0,3.5,3490,2.0,0,0,2570,920,2009,1620000.0
3.0,2.5,1730,2.0,0,0,1730,0,1999,339950.0
4.0,2.75,3430,1.5,0,0,3430,0,1972,367999.0
4.0,2.5,2320,2.0,0,0,2320,0,1994,380000.0
3.0,1.75,2030,1.0,0,0,2030,0,1953,440000.0
5.0,4.0,4850,2.0,0,0,4850,0,1977,975000.0
3.0,1.5,1340,1.0,0,0,1340,0,1968,309500.0
3.0,1.0,1130,1.0,0,0,1130,0,1948,350000.0
2.0,2.0,1180,2.0,0,0,1180,0,2005,215000.0
2.0,1.0,910,1.0,0,0,910,0,1943,254000.0
3.0,1.75,1630,1.5,0,3,1630,0,1908,567000.0
2.0,1.0,710,2.0,0,0,710,0,1943,402000.0
4.0,1.0,1520,1.0,0,0,1520,0,1948,365000.0
4.0,2.5,2820,2.0,0,0,2820,0,2014,625000.0
4.0,1.75,1970,1.5,0,0,1970,0,1942,432000.0
5.0,3.0,2240,1.0,0,0,1700,540,1968,335500.0
2.0,1.75,1860,1.0,0,2,1020,840,1956,672500.0
4.0,1.0,1780,1.5,0,0,1780,0,1919,336000.0
4.0,2.5,1788,2.0,0,0,1788,0,1990,294400.0
3.0,2.5,1880,2.0,0,0,1880,0,1988,541900.0
3.0,1.75,2300,1.0,0,0,1520,780,1977,505000.0
3.0,2.5,1610,2.0,0,0,1610,0,1994,255000.0
6.0,2.5,2270,1.0,0,0,1470,800,1964,435000.0
2.0,1.75,1230,1.5,0,0,1230,0,1925,636000.0
4.0,3.5,3420,2.0,0,0,3420,0,2004,655000.0
3.0,1.5,1670,1.0,0,0,1370,300,1953,280500.0
2.0,1.0,1120,1.0,0,0,900,220,1946,520000.0
4.0,2.5,2580,2.0,0,0,2580,0,2005,354000.0
5.0,2.75,3847,1.0,0,2,2299,1548,1975,810000.0
4.0,2.5,3630,1.5,0,0,2300,1330,1979,400000.0
4.0,2.75,3580,1.0,0,0,1840,1740,1979,879900.0
5.0,4.0,4050,2.0,0,0,2780,1270,1980,1288000.0
3.0,3.5,3240,2.0,0,0,2130,1110,1992,902500.0
3.0,1.75,1540,1.5,0,0,1540,0,1902,900000.0
4.0,2.5,2550,2.0,0,2,2550,0,2003,419500.0
4.0,2.0,2340,1.0,0,0,1270,1070,1953,685000.0
4.0,2.5,2320,2.0,0,0,2320,0,2004,429950.0
4.0,2.5,1640,2.0,0,0,1640,0,2011,464950.0
2.0,1.0,910,1.0,0,0,910,0,1983,239900.0
4.0,3.25,2550,2.0,0,0,2550,0,1990,406250.0
4.0,2.5,2660,2.0,0,0,2660,0,1997,447000.0
3.0,2.5,1480,2.0,0,0,1480,0,1996,466800.0
4.0,2.5,2810,1.0,0,0,1740,1070,1962,674000.0
1.0,1.0,830,1.0,0,0,830,0,1924,525000.0
3.0,2.75,3510,2.0,0,0,3510,0,1990,674950.0
3.0,2.5,2480,2.0,0,0,2480,0,2004,374900.0
4.0,3.0,3720,2.5,0,0,2720,1000,1905,1443920.0
3.0,2.25,2150,2.0,0,0,2150,0,1984,559500.0
3.0,2.5,2370,2.0,0,0,2370,0,2003,522500.0
5.0,2.5,4310,2.0,0,0,4310,0,1988,1130000.0
5.0,2.75,2990,2.0,0,0,2990,0,1996,498500.0
4.0,1.0,1350,1.5,0,0,1350,0,1930,571000.0
2.0,2.0,2370,1.5,0,0,1600,770,1992,543000.0
3.0,2.0,1410,1.0,0,0,1410,0,1985,271920.0
2.0,1.0,1170,1.0,0,0,1170,0,1949,104950.0
4.0,2.5,1800,2.0,0,0,1800,0,1999,485500.0
4.0,2.75,3650,2.0,0,2,2530,1120,1951,1210000.0
3.0,1.75,1490,1.0,0,0,1490,0,1993,260250.0
4.0,2.5,3610,2.0,0,0,3610,0,1996,875909.0
4.0,1.75,2050,1.0,0,0,1250,800,1959,455000.0
3.0,1.0,1092,1.5,0,0,1092,0,1918,309000.0
4.0,2.25,2010,1.0,0,0,1170,840,1979,229000.0
3.0,2.0,1680,2.0,0,0,1680,0,1953,250000.0
4.0,2.0,2510,1.0,0,0,2510,0,1960,600000.0
4.0,2.5,2280,2.0,0,0,2280,0,2004,535000.0
3.0,2.5,2510,2.0,0,0,2510,0,2001,571000.0
5.0,2.75,3190,1.0,0,3,1690,1500,1976,1030000.0
4.0,3.25,4690,2.0,0,2,3680,1010,1995,600000.0
3.0,2.25,1850,1.0,0,0,1300,550,1977,469500.0
4.0,3.0,4160,2.0,0,0,3040,1120,2001,1150000.0
4.0,1.5,2220,1.5,0,0,1970,250,1925,785000.0
3.0,2.5,2870,2.0,0,0,2870,0,1991,872750.0
4.0,2.75,3950,1.0,0,3,2050,1900,1955,900000.0
2.0,1.75,1740,1.5,0,0,1740,0,2002,350000.0
5.0,3.0,4780,1.0,0,0,3660,1120,1975,2575000.0
4.0,2.5,3160,1.0,0,0,3160,0,1980,940000.0
5.0,1.75,1990,1.0,0,0,1990,0,1955,185000.0
4.0,3.5,3920,2.0,0,0,3920,0,1996,850000.0
3.0,1.0,960,1.0,0,0,960,0,1963,201000.0
2.0,1.5,1540,2.0,0,0,1540,0,1980,499000.0
4.0,2.5,1970,2.0,0,0,1970,0,2002,315000.0
3.0,2.5,1880,2.0,0,0,1880,0,1993,509950.0
3.0,2.75,2000,1.0,0,0,1260,740,1964,286300.0
3.0,2.5,1990,2.0,0,0,1310,680,1997,590000.0
4.0,1.0,1400,1.5,0,0,1400,0,1948,325000.0
4.0,2.5,3190,2.0,0,0,3190,0,1997,625000.0
3.0,1.5,1000,1.0,0,0,1000,0,1947,378000.0
3.0,1.75,1670,1.0,0,0,1170,500,1978,239950.0
4.0,2.0,2100,1.0,0,0,1060,1040,1924,550000.0
2.0,1.0,1010,1.0,0,0,1010,0,1903,325000.0
4.0,2.5,2030,1.5,0,0,1630,400,1926,831000.0
3.0,1.0,1090,1.0,0,0,1090,0,1950,249000.0
4.0,1.75,2440,1.0,0,0,1390,1050,1976,484000.0
4.0,3.0,2500,2.0,0,0,2500,0,2002,395000.0
4.0,2.5,3420,2.0,0,0,3420,0,2002,839900.0
4.0,2.5,2850,2.0,0,0,2850,0,1998,760000.0
4.0,1.5,2030,1.5,0,0,1530,500,1927,750000.0
5.0,3.75,4590,2.0,0,0,3450,1140,1927,3000000.0
3.0,2.5,2230,2.0,0,0,2230,0,2004,440000.0
2.0,1.75,1810,1.0,0,0,1170,640,1962,501000.0
6.0,4.5,4000,2.0,0,0,4000,0,1978,739000.0
3.0,1.75,1490,1.0,0,0,1490,0,1958,685650.0
4.0,4.5,4225,2.0,0,0,4225,0,1985,1005000.0
4.0,1.75,2120,1.5,0,0,1920,200,1929,980000.0
3.0,1.5,1030,1.0,0,0,1030,0,1968,275000.0
4.0,1.75,2310,1.0,0,0,1650,660,1976,319950.0
3.0,2.25,1830,2.0,0,0,1830,0,1985,448500.0
5.0,2.0,2120,1.5,0,0,2120,0,1913,437000.0
4.0,1.5,2500,1.0,0,0,1250,1250,1966,330000.0
3.0,2.5,2470,2.0,0,0,2470,0,1990,365000.0
2.0,1.0,940,1.0,0,0,940,0,1916,329000.0
5.0,2.75,3260,1.0,0,0,1630,1630,1964,681500.0
3.0,2.25,1660,1.0,0,0,1370,290,1980,566000.0
4.0,3.0,4370,2.0,0,0,4370,0,1984,897500.0
3.0,2.5,2620,2.0,0,0,2620,0,1995,738000.0
3.0,1.75,1500,1.0,0,0,1500,0,1968,185000.0
2.0,1.0,910,1.0,0,1,830,80,1936,445000.0
3.0,1.75,1430,1.0,0,0,1430,0,1957,175000.0
2.0,1.0,900,1.0,0,0,760,140,1941,315000.0
4.0,1.75,1250,1.0,0,0,1250,0,1959,445000.0
5.0,3.0,3850,1.0,0,0,2290,1560,1964,1400000.0
4.0,2.5,3450,2.0,0,0,3450,0,1987,832500.0
4.0,3.5,3950,2.0,0,0,3950,0,2001,771150.0
4.0,1.5,1950,1.5,0,0,1950,0,1939,225000.0
3.0,2.5,1700,2.0,0,0,1700,0,2003,389950.0
3.0,2.5,2370,2.0,0,0,2370,0,2004,435000.0
3.0,1.75,1600,2.0,0,0,1600,0,1929,845000.0
4.0,1.75,4060,2.0,0,0,2660,1400,1924,1300000.0
3.0,2.25,1322,2.0,0,0,1087,235,2005,350000.0
3.0,1.75,1140,1.0,0,0,1140,0,1983,250000.0
2.0,1.5,1280,2.0,0,0,1080,200,2007,370000.0
4.0,2.5,3080,2.5,0,0,3080,0,2008,750000.0
2.0,1.75,1210,1.0,0,0,910,300,1906,439950.0
4.0,1.75,1950,1.0,0,0,1950,0,1962,395000.0
4.0,1.0,1450,1.5,0,0,1450,0,1947,375000.0
3.0,2.25,1590,2.0,0,0,1590,0,1991,263000.0
3.0,1.0,1240,1.5,0,0,1240,0,1959,185000.0
3.0,1.0,1440,1.0,0,0,790,650,1974,500000.0
4.0,2.5,3470,2.0,0,0,3470,0,1993,920000.0
7.0,3.75,5100,2.0,0,0,3640,1460,2001,936000.0
3.0,1.75,2430,1.0,0,2,1340,1090,1952,1500000.0
3.0,2.25,2420,1.0,0,0,1420,1000,1948,1100000.0
3.0,2.5,1510,1.0,0,0,1150,360,1990,247000.0
3.0,1.0,1200,1.0,0,0,1200,0,1947,289500.0
3.0,2.5,2240,2.0,0,0,2240,0,2002,432500.0
3.0,1.75,1870,1.0,0,0,970,900,1920,680000.0
3.0,1.0,1110,1.5,0,0,1110,0,1932,589000.0
4.0,2.0,3210,1.5,0,0,2040,1170,1914,756450.0
3.0,1.75,2090,1.0,0,0,1230,860,1975,536650.0
3.0,2.25,1320,2.0,0,0,1320,0,1994,540000.0
3.0,1.75,1340,1.0,0,0,1340,0,1960,385000.0
3.0,1.0,1020,1.0,0,0,1020,0,1941,485000.0
3.0,2.0,1220,1.0,0,0,1220,0,1980,240000.0
3.0,2.0,1220,1.0,0,0,1220,0,1980,415500.0
3.0,2.0,1390,1.5,0,0,1390,0,1915,550000.0
4.0,2.0,2970,2.5,0,0,2970,0,1900,1260000.0
2.0,2.0,1440,2.0,0,0,1440,0,1990,430000.0
2.0,1.75,1550,1.0,0,3,830,720,1953,415000.0
4.0,2.5,1904,2.0,0,0,1904,0,1999,365000.0
4.0,1.5,1400,2.0,0,0,1400,0,1975,257000.0
3.0,2.5,2140,2.0,0,0,2140,0,2005,420000.0
3.0,1.75,1320,1.0,0,0,1320,0,1943,338995.0
3.0,1.75,2620,1.0,0,0,1330,1290,1948,615000.0
4.0,0.5,2300,2.0,0,0,2300,0,1996,312500.0
4.0,2.5,2000,2.0,0,0,2000,0,1996,513000.0
4.0,2.75,2960,2.0,0,3,2210,750,1952,857500.0
3.0,2.75,2700,1.5,0,1,2700,0,1977,1060000.0
3.0,1.75,1740,1.0,0,3,1150,590,1958,585000.0
2.0,2.5,1770,1.0,0,0,1770,0,2003,350500.0
3.0,2.0,1290,1.0,0,0,1290,0,1947,215000.0
4.0,2.0,1450,1.5,0,0,1450,0,1962,440000.0
3.0,2.25,1420,1.0,0,0,1130,290,1985,270000.0
3.0,0.75,1330,1.0,0,0,1330,0,1924,385000.0
3.0,1.75,1760,1.5,0,3,1760,0,1927,688500.0
3.0,1.75,2010,1.0,0,0,1230,780,1912,700000.0
5.0,2.0,2560,1.0,0,0,1280,1280,1960,585000.0
2.0,1.5,1260,2.0,0,0,1260,0,1983,401000.0
4.0,2.25,2420,1.0,0,0,1890,530,1972,655000.0
3.0,1.0,1010,1.0,0,0,1010,0,1959,317000.0
4.0,2.5,1770,1.5,0,0,1770,0,1970,500000.0
2.0,1.0,890,1.0,0,0,890,0,1943,314963.0
3.0,1.5,1670,2.0,0,2,1670,0,1925,715000.0
3.0,2.25,1360,2.0,0,0,1360,0,1992,280000.0
3.0,2.5,2120,2.0,0,0,2120,0,1988,531000.0
3.0,2.5,1910,2.0,0,0,1910,0,1998,617000.0
4.0,1.0,1480,1.5,0,0,1480,0,1940,440000.0
3.0,1.0,1090,1.0,0,0,1090,0,1955,140000.0
4.0,1.75,1670,1.0,0,0,1670,0,1973,661000.0
4.0,1.75,1670,1.0,0,0,1670,0,1973,697000.0
5.0,2.75,3650,2.0,0,0,2750,900,1969,1195000.0
4.0,2.0,1970,1.0,0,0,1030,940,1969,535000.0
2.0,2.0,1320,1.5,0,0,1320,0,1910,404500.0
3.0,1.0,1710,1.0,0,0,1100,610,1954,396500.0
3.0,2.25,1740,1.0,0,0,1180,560,1977,450000.0
3.0,3.25,2200,2.0,0,0,1740,460,1988,605000.0
3.0,2.0,2010,2.0,0,2,2010,0,1999,699000.0
3.0,3.0,3910,2.0,0,0,3910,0,1985,805000.0
1.0,0.75,470,1.0,0,0,470,0,1947,156000.0
4.0,2.5,2330,1.0,0,0,1780,550,1984,595000.0
3.0,1.75,1930,1.5,0,0,1930,0,1929,285000.0
4.0,2.5,3270,2.0,0,0,3270,0,2007,725000.0
3.0,2.5,1650,2.0,0,0,1650,0,1985,216300.0
4.0,2.75,2220,1.0,0,0,1260,960,1983,410000.0
2.0,1.75,2470,1.0,0,3,1140,1330,1916,597000.0
3.0,1.0,1300,1.0,0,0,1300,0,1977,325000.0
5.0,2.75,2530,1.0,0,0,1530,1000,1966,355000.0
3.0,1.5,2400,1.0,0,0,1200,1200,1961,338000.0
4.0,2.25,1500,2.0,0,0,1500,0,1999,210000.0
4.0,1.75,1700,1.0,0,0,1700,0,1967,423000.0
4.0,1.5,2120,1.0,0,0,1170,950,1977,249500.0
4.0,2.5,2240,2.0,0,0,2240,0,2002,325000.0
3.0,1.75,1540,1.0,0,0,1070,470,1987,257000.0
3.0,1.75,1890,1.0,0,3,1890,0,1978,550000.0
3.0,1.0,1260,2.0,0,0,1260,0,1920,490000.0
2.0,1.5,1160,2.0,0,0,1160,0,1983,299000.0
2.0,1.0,1300,1.0,0,0,1300,0,1960,295000.0
4.0,2.5,3220,2.0,0,0,3220,0,1978,630000.0
4.0,1.5,2020,1.0,0,0,1010,1010,1962,320000.0
4.0,2.5,2990,1.0,0,0,2100,890,1959,1110000.0
4.0,1.0,1420,1.0,0,0,1420,0,1953,398000.0
3.0,1.0,1020,1.0,0,0,1020,0,1956,218000.0
4.0,2.75,2400,2.0,0,0,2400,0,1988,590000.0
5.0,3.0,3640,2.0,0,3,2540,1100,1982,1595000.0
2.0,2.25,1550,2.0,0,0,1550,0,2007,348500.0
2.0,2.0,1870,1.0,0,0,1870,0,2006,592500.0
3.0,2.5,2340,2.0,0,0,2340,0,1995,505000.0
5.0,4.25,3350,2.0,0,0,2260,1090,2014,1430000.0
3.0,1.0,1710,1.0,0,0,1140,570,1921,502000.0
2.0,2.0,1180,1.0,0,0,1180,0,1940,257500.0
3.0,1.5,1600,1.0,0,0,1600,0,1966,405000.0
3.0,1.75,1300,1.0,0,0,1300,0,1959,427000.0
3.0,1.5,1040,1.0,0,0,1040,0,1955,290000.0
3.0,1.0,1220,1.0,0,0,1220,0,1954,222000.0
3.0,2.5,2240,2.0,0,0,2240,0,2002,315000.0
3.0,1.5,1420,1.0,0,0,1420,0,1959,371000.0
3.0,1.75,1580,1.0,0,0,1580,0,1988,279900.0
3.0,1.5,2390,1.0,0,0,1890,500,1938,250000.0
4.0,2.25,2260,2.0,0,0,1400,860,1977,599000.0
3.0,1.75,1890,1.0,0,0,1890,0,1964,267300.0
2.0,1.75,1830,1.0,0,2,1070,760,1949,585000.0
3.0,1.75,1000,1.0,0,0,1000,0,1969,350000.0
3.0,1.75,2180,1.0,0,0,1480,700,1961,506000.0
6.0,2.0,2320,2.0,0,0,2320,0,1962,400000.0
3.0,1.0,840,1.0,0,0,840,0,1921,151100.0
3.0,1.0,840,1.0,0,0,840,0,1921,251000.0
4.0,2.25,2350,1.0,0,0,1430,920,1977,555000.0
3.0,1.75,2040,1.0,0,0,2040,0,1997,467500.0
4.0,2.5,2370,2.0,0,0,2370,0,1996,479000.0
5.0,2.0,1590,1.0,0,0,1060,530,1962,247000.0
3.0,1.0,1380,1.0,0,0,1380,0,1977,299500.0
4.0,1.5,1940,1.5,0,0,1270,670,1980,306888.0
4.0,2.5,3320,2.0,0,0,3320,0,2001,675000.0
2.0,1.0,1090,1.5,0,0,1090,0,1947,577000.0
3.0,1.5,1650,1.0,0,0,1090,560,1967,219950.0
3.0,1.5,1110,1.0,0,0,1110,0,1940,375000.0
4.0,2.5,2110,1.0,0,0,1530,580,1942,650000.0
3.0,3.0,1850,1.5,0,0,1850,0,1900,975000.0
1.0,1.0,600,1.0,0,0,600,0,1920,229000.0
5.0,2.5,2760,1.5,0,0,1730,1030,1926,575000.0
4.0,1.75,2970,1.0,0,4,1560,1410,1962,815000.0
3.0,1.75,2300,1.0,0,0,1350,950,1979,525000.0
3.0,2.5,2030,2.0,0,0,1720,310,2001,471000.0
4.0,1.75,2160,1.0,0,0,1260,900,1942,450000.0
3.0,2.0,1650,2.0,0,0,1650,0,1926,590000.0
4.0,2.5,3140,2.0,0,0,2200,940,2004,744000.0
4.0,2.25,2690,2.0,0,0,2690,0,1986,460000.0
5.0,2.5,1940,1.0,0,0,1290,650,1960,299000.0
4.0,1.0,1220,1.5,0,0,1220,0,1940,231000.0
3.0,1.0,1300,1.0,0,0,1300,0,1975,195000.0
3.0,1.75,1660,1.0,0,0,1130,530,1979,305000.0
4.0,1.5,3390,2.0,0,0,2530,860,1916,895000.0
4.0,1.5,2310,1.0,0,0,1890,420,1950,1110000.0
2.0,1.0,950,1.0,0,0,950,0,1941,339000.0
4.0,3.75,2400,1.0,0,0,1370,1030,1924,885000.0
3.0,1.0,1780,1.5,0,0,1050,730,1944,375000.0
4.0,1.5,1280,1.0,0,0,1280,0,1958,367400.0
4.0,2.0,1930,1.0,0,0,1430,500,1953,700000.0
5.0,2.25,2560,1.0,0,0,1870,690,1966,667000.0
2.0,1.0,920,1.0,0,0,920,0,1906,200000.0
3.0,2.5,1900,2.0,0,0,1900,0,1971,552775.0
3.0,2.0,2270,1.0,0,0,1270,1000,1900,452000.0
3.0,2.5,2080,1.0,0,0,1360,720,1978,418000.0
3.0,1.75,1460,1.0,0,0,1460,0,1968,601500.0
3.0,1.75,1670,1.0,0,0,1670,0,1976,600000.0
4.0,2.5,2810,2.0,0,0,2810,0,1998,340000.0
3.0,2.5,2370,2.0,0,0,2370,0,1994,310000.0
2.0,1.75,1700,1.0,0,0,1700,0,1972,290000.0
2.0,1.0,1630,1.0,0,0,1630,0,1941,438000.0
4.0,2.75,2930,1.0,0,0,1660,1270,1939,718000.0
2.0,1.0,860,1.0,0,0,860,0,1949,200000.0
3.0,2.0,1980,1.0,0,0,1980,0,1994,479900.0
3.0,2.5,2080,2.0,0,0,2080,0,1987,400000.0
3.0,1.0,1060,1.0,0,0,1060,0,1957,219950.0
3.0,2.5,1590,2.0,0,0,1590,0,2000,300000.0
3.0,2.25,1980,1.0,0,0,1290,690,1959,437000.0
4.0,2.0,1720,1.0,0,0,860,860,1971,350000.0
4.0,1.75,1350,1.0,0,0,1350,0,1954,626000.0
3.0,2.5,2080,2.0,0,0,2080,0,1978,490000.0
3.0,2.5,2090,2.0,0,0,2090,0,2002,289000.0
3.0,2.5,2030,2.0,0,0,2030,0,2008,595000.0
3.0,2.25,2680,1.0,0,0,2680,0,1989,676000.0
3.0,1.75,1820,1.0,0,0,1220,600,1980,389000.0
3.0,2.0,1300,1.0,0,0,1300,0,1983,240000.0
4.0,2.5,2210,2.0,0,0,2210,0,1993,382500.0
3.0,2.0,1400,1.0,0,0,1400,0,1963,511555.0
3.0,1.75,2040,1.5,0,0,1540,500,1917,710500.0
3.0,2.5,2420,2.0,0,0,1860,560,1985,429000.0
4.0,1.75,1920,1.0,0,0,1920,0,1962,170000.0
4.0,3.25,3860,1.0,0,4,2630,1230,1975,2135000.0
5.0,2.75,2760,1.0,0,0,1430,1330,1979,480000.0
4.0,3.75,3450,2.0,0,4,2640,810,1993,1665000.0
3.0,1.0,1040,1.0,0,0,1040,0,1947,225000.0
3.0,1.75,2220,1.0,0,2,2040,180,1975,615000.0
4.0,2.5,2470,2.0,0,3,2470,0,1991,438950.0
3.0,1.75,1300,1.0,0,0,1300,0,1962,242000.0
3.0,2.5,1960,1.0,0,0,1460,500,1989,560000.0
3.0,1.5,2040,2.0,0,2,2040,0,1928,857500.0
4.0,2.5,3030,2.0,0,0,3030,0,1999,685000.0
4.0,3.0,2260,2.0,0,0,2260,0,1977,486000.0
3.0,2.5,2670,2.0,0,0,2670,0,1987,749000.0
3.0,2.5,1520,2.0,0,0,1520,0,1986,260000.0
3.0,1.75,3610,1.5,0,2,2610,1000,1930,1015000.0
3.0,1.75,1130,1.0,0,0,930,200,1942,565000.0
3.0,2.0,1480,2.0,0,0,1480,0,1991,355000.0
5.0,2.0,3540,2.0,0,3,3540,0,1970,775000.0
4.0,2.25,2100,1.0,0,0,1050,1050,1963,335000.0
5.0,4.0,3366,2.5,0,2,2966,400,1937,1300000.0
3.0,1.75,1810,1.5,0,0,1810,0,1903,545000.0
3.0,1.75,1680,1.5,0,0,1680,0,1926,540000.0
3.0,1.75,2450,1.0,0,2,1540,910,1962,687500.0
1.0,2.0,1150,1.0,0,0,1150,0,1962,115000.0
1.0,2.0,1150,1.0,0,0,1150,0,1962,227000.0
4.0,2.5,3240,2.0,0,2,3240,0,2003,870000.0
4.0,2.5,3480,1.5,0,0,3480,0,1984,1190000.0
4.0,2.5,2800,2.0,0,0,2800,0,2006,375000.0
3.0,2.75,3240,1.0,0,2,1620,1620,1960,902000.0
2.0,1.5,1480,1.0,0,0,940,540,1978,269500.0
3.0,1.0,1700,1.5,0,0,1200,500,1909,570000.0
2.0,1.0,1240,1.0,0,0,1040,200,1939,359950.0
4.0,3.5,3720,2.0,0,0,2880,840,2008,1450000.0
3.0,2.5,1910,2.0,0,0,1910,0,2001,615000.0
4.0,2.0,2120,1.5,0,0,2120,0,1960,250000.0
4.0,2.5,3020,2.0,0,0,3020,0,2002,530000.0
3.0,2.0,2250,1.0,0,0,2250,0,1987,474950.0
4.0,2.0,1650,2.0,0,0,1650,0,1947,490000.0
2.0,1.5,880,2.0,0,0,880,0,2007,210000.0
3.0,1.0,1860,1.0,0,0,1860,0,1957,265500.0
5.0,3.25,3840,3.0,0,3,2750,1090,2008,1462500.0
4.0,2.25,2192,2.0,0,0,2192,0,2006,310000.0
3.0,2.5,1590,2.0,0,0,1590,0,2003,324500.0
4.0,4.75,3700,1.0,0,0,1840,1860,1962,599000.0
4.0,2.5,3670,2.0,0,0,3670,0,2005,525000.0
3.0,1.0,1630,1.0,0,0,1630,0,1953,400000.0
3.0,3.0,4230,2.0,0,3,3780,450,1951,887500.0
2.0,1.0,1060,1.5,0,0,770,290,1932,344000.0
3.0,2.5,2700,2.0,0,0,2700,0,1991,525000.0
3.0,2.25,2110,2.0,0,0,2110,0,1975,385000.0
4.0,2.5,3720,2.0,0,0,3720,0,1999,820000.0
4.0,3.5,3440,2.0,0,0,2560,880,2006,1305000.0
4.0,2.25,2420,1.0,0,0,1350,1070,1985,549000.0
3.0,1.0,1090,1.5,0,0,1090,0,1929,180000.0
4.0,2.5,2910,2.0,0,2,2910,0,1998,589000.0
3.0,1.0,1050,1.0,0,0,1050,0,1948,350000.0
3.0,2.0,1610,1.0,0,0,1110,500,1965,197400.0
3.0,2.5,1760,2.0,0,0,1760,0,1986,267000.0
3.0,1.5,1540,1.0,0,0,1540,0,1977,480000.0
4.0,2.5,2580,1.0,0,0,1660,920,1959,650000.0
2.0,1.0,1370,1.5,0,0,1370,0,1905,600000.0
2.0,1.75,1440,1.0,0,0,1440,0,2005,490000.0
3.0,1.0,1410,1.0,0,0,980,430,1962,225000.0
3.0,2.25,1980,1.0,0,0,1980,0,1959,640000.0
3.0,3.5,2440,2.0,0,0,1990,450,2000,710000.0
3.0,2.0,1350,1.0,0,0,1350,0,1986,325000.0
3.0,3.25,3130,1.0,0,0,2210,920,1985,595000.0
3.0,1.0,880,1.0,0,0,880,0,1950,128750.0
3.0,2.25,1920,1.0,0,0,1240,680,1961,465000.0
4.0,1.75,2700,1.0,0,0,1450,1250,1937,710000.0
4.0,2.75,1670,1.0,0,0,840,830,1917,605000.0
4.0,2.5,3470,2.0,0,0,3470,0,1963,994000.0
3.0,2.25,1820,2.0,0,0,1820,0,1983,489950.0
3.0,1.5,1310,1.0,0,0,1310,0,1950,365000.0
3.0,2.0,1790,1.0,0,0,1790,0,1998,359950.0
4.0,2.5,2460,2.0,0,0,2460,0,2006,495000.0
3.0,1.5,1060,1.0,0,0,1060,0,1973,255000.0
3.0,1.75,1340,1.0,0,0,1340,0,1961,330000.0
3.0,1.75,1480,1.0,0,0,1480,0,1971,450000.0
4.0,2.5,3500,2.0,0,2,3500,0,2005,655000.0
4.0,2.75,2910,1.0,0,2,2120,790,1969,485000.0
4.0,1.75,1940,1.0,0,0,970,970,1974,375000.0
4.0,2.5,2280,2.0,0,0,2280,0,2003,570000.0
3.0,2.25,1190,3.0,0,0,1190,0,1998,350000.0
3.0,1.0,1260,1.0,0,3,1260,0,1951,550000.0
5.0,2.0,2270,1.0,0,0,1150,1120,1965,513000.0
4.0,2.25,1990,1.0,0,0,1030,960,1965,450000.0
4.0,1.75,1500,1.0,0,0,750,750,1901,432500.0
5.0,2.75,2060,1.5,0,3,2060,0,1989,432000.0
3.0,2.25,1950,2.0,0,0,1950,0,1983,480000.0
3.0,1.75,1790,1.0,0,0,1330,460,1980,402200.0
3.0,1.0,1520,1.0,0,0,1520,0,1951,650000.0
4.0,2.5,3240,2.0,0,0,3240,0,1984,1199500.0
3.0,2.0,2440,1.0,0,0,1440,1000,1977,312000.0
4.0,2.0,2220,1.5,0,0,1380,840,1916,610000.0
5.0,1.75,2640,1.5,0,0,1650,990,1915,823000.0
4.0,1.75,1450,1.0,0,0,950,500,1925,471000.0
3.0,2.25,1550,2.0,0,0,1550,0,1987,481015.0
5.0,4.5,6200,3.0,0,1,5050,1150,1988,1959000.0
4.0,3.25,2810,1.0,0,0,1680,1130,1980,624000.0
4.0,2.5,2080,1.0,0,0,1200,880,1970,480000.0
3.0,1.5,1370,1.0,0,0,1370,0,1955,815000.0
4.0,2.25,2920,1.0,0,0,2920,0,1966,1650000.0
3.0,1.0,1000,1.0,0,0,1000,0,1940,180000.0
2.0,1.75,1210,1.0,0,0,1210,0,1984,156601.0
4.0,2.5,2790,2.0,0,0,2790,0,2004,374950.0
2.0,1.5,1660,1.0,0,0,830,830,1908,368000.0
3.0,2.0,1650,2.0,0,0,1650,0,1950,550000.0
3.0,1.75,1300,1.0,0,0,1300,0,1980,198000.0
3.0,1.75,1090,1.0,0,0,1090,0,1968,345000.0
5.0,2.5,2660,1.0,0,0,1960,700,1959,1712750.0
3.0,1.0,940,1.0,0,0,940,0,1909,185900.0
3.0,2.75,2750,1.0,0,2,1810,940,1978,950000.0
4.0,4.5,3850,2.0,0,2,3000,850,1998,995000.0
2.0,1.0,860,1.0,0,0,860,0,1940,345000.0
4.0,2.75,2070,1.0,0,0,1390,680,1962,741000.0
2.0,2.25,2290,1.0,0,0,2290,0,2007,737000.0
4.0,2.5,2340,1.0,0,2,1590,750,1964,668750.0
3.0,1.75,2680,1.0,0,0,1590,1090,1974,575000.0
4.0,2.0,1710,1.0,0,0,1030,680,1976,280000.0
3.0,1.5,1800,1.0,0,0,1800,0,1955,583000.0
3.0,2.25,1510,1.0,0,0,1090,420,1966,196000.0
3.0,2.5,1700,2.0,0,0,1700,0,1994,349950.0
4.0,1.0,1350,1.5,0,0,1350,0,1912,429000.0
5.0,2.5,2140,1.0,0,0,1330,810,1967,270000.0
6.0,4.0,2700,1.0,0,0,1350,1350,1969,385000.0
1.0,1.0,920,1.0,0,3,920,0,1906,535000.0
3.0,1.75,1500,1.0,0,0,1030,470,1958,352500.0
3.0,1.75,1510,1.0,0,0,860,650,1922,624000.0
5.0,1.5,1980,1.5,0,0,1980,0,1962,215000.0
4.0,3.0,4500,2.0,0,2,3040,1460,1980,870000.0
4.0,2.5,3220,2.0,0,0,2610,610,2006,440000.0
2.0,1.5,1140,2.0,0,0,940,200,2001,518000.0
3.0,2.25,1490,2.0,0,0,1490,0,1993,259500.0
4.0,3.25,4360,1.0,0,0,3360,1000,1993,795127.0
3.0,1.0,960,1.0,0,0,960,0,1955,290000.0
4.0,3.0,2253,2.0,0,0,2253,0,1957,385000.0
2.0,1.0,770,1.0,0,0,770,0,1948,259950.0
2.0,2.5,1310,2.0,0,0,1310,0,1999,330000.0
3.0,1.0,980,1.0,0,0,830,150,1948,280000.0
4.0,2.5,1820,2.0,0,0,1820,0,1987,595000.0
4.0,3.75,3980,2.0,0,0,3980,0,2001,925900.0
3.0,2.25,3010,2.0,0,0,2410,600,1978,499000.0
4.0,2.5,1830,2.0,0,0,1830,0,1993,325000.0
5.0,2.5,2550,1.0,0,0,1610,940,1953,895000.0
2.0,1.0,800,1.0,0,0,800,0,1944,162248.0
3.0,2.25,2890,2.0,0,4,1790,1100,1941,1072500.0
3.0,1.5,1810,1.0,0,0,1030,780,1958,430000.0
3.0,1.5,1810,1.0,0,0,1030,780,1958,615500.0
3.0,1.0,940,1.0,0,0,940,0,1949,260000.0
4.0,2.0,1810,1.0,0,0,1810,0,1973,295000.0
3.0,1.75,2550,2.0,0,0,1650,900,1951,1186040.0
4.0,2.5,2370,2.0,0,2,2080,290,2008,749950.0
6.0,1.0,1370,1.5,0,0,1120,250,1931,175000.0
6.0,1.0,1370,1.5,0,0,1120,250,1931,415000.0
3.0,1.0,1200,1.0,0,0,1200,0,1953,190000.0
3.0,1.75,2100,1.5,0,0,1350,750,1912,625000.0
3.0,2.25,2020,2.0,0,0,2020,0,1995,420000.0
4.0,1.5,1570,1.0,0,2,1400,170,1965,339900.0
2.0,1.0,1140,1.0,0,0,1140,0,1980,160000.0
4.0,2.5,1830,2.0,0,0,1830,0,2002,353000.0
3.0,2.0,1010,1.0,0,0,1010,0,1982,390000.0
4.0,2.5,1770,1.0,0,2,1770,0,1971,675000.0
3.0,2.5,2120,2.0,0,0,2120,0,2006,400000.0
4.0,3.5,3190,2.0,0,3,2160,1030,2003,1340000.0
4.0,2.5,2780,1.0,0,1,1730,1050,1951,1650000.0
5.0,3.0,3350,2.0,0,0,2180,1170,1912,1000000.0
5.0,3.5,3450,1.0,0,0,2350,1100,1972,850000.0
3.0,1.5,1060,1.0,0,0,1060,0,1983,275000.0
3.0,2.5,1670,2.0,0,0,1670,0,2000,450000.0
4.0,1.75,2251,1.0,0,1,1390,861,1957,305000.0
3.0,2.5,1770,1.5,0,0,1270,500,1929,643002.0
2.0,1.75,1510,1.0,0,0,1510,0,1978,468000.0
4.0,2.5,1770,2.0,0,0,1770,0,2004,324950.0
3.0,2.0,1260,1.0,0,0,1260,0,1987,290000.0
3.0,2.0,1710,1.0,0,0,1030,680,1981,488500.0
3.0,1.75,2290,1.0,0,0,1250,1040,1950,367950.0
2.0,1.0,790,1.0,0,0,790,0,1956,285000.0
3.0,2.75,1820,2.0,0,0,1820,0,1991,417000.0
4.0,2.5,3180,1.0,0,0,2390,790,1978,1115000.0
4.0,4.0,5280,2.0,0,3,3220,2060,1978,1550000.0
3.0,2.5,3240,2.0,0,2,3240,0,1995,604000.0
3.0,2.5,2390,2.0,0,0,2390,0,1986,380000.0
4.0,2.5,2500,2.0,0,0,2500,0,2003,336500.0
4.0,2.0,2290,1.5,0,3,2290,0,1900,685000.0
5.0,6.0,7440,2.0,0,0,5550,1890,2003,4208000.0
3.0,1.0,1600,1.0,0,1,990,610,1946,670000.0
2.0,1.0,1120,1.5,0,0,1120,0,1910,524000.0
3.0,1.0,1340,1.0,0,0,1340,0,1968,172000.0
6.0,2.0,1670,1.0,0,0,900,770,1911,680000.0
4.0,3.0,2830,2.0,0,0,2830,0,1987,549900.0
4.0,2.75,2700,1.0,0,0,2700,0,1988,357000.0
3.0,1.5,910,1.0,0,0,910,0,1973,107000.0
3.0,1.5,910,1.0,0,0,910,0,1973,232900.0
4.0,3.5,2370,2.0,0,0,1610,760,1926,800000.0
2.0,1.5,880,2.0,0,0,880,0,1999,248500.0
3.0,2.5,2050,1.0,0,3,1730,320,1956,670000.0
3.0,1.75,1180,1.0,0,0,1180,0,1958,207000.0
3.0,1.0,1070,1.0,0,0,1070,0,1961,164000.0
2.0,1.0,1380,2.0,0,0,1080,300,1954,570500.0
3.0,2.25,2680,1.0,0,0,1570,1110,1978,599990.0
5.0,1.75,2100,1.0,0,0,1060,1040,1961,395000.0
4.0,3.75,4133,2.0,0,0,4133,0,2000,979500.0
3.0,1.0,920,1.0,0,0,920,0,1928,207000.0
3.0,1.0,920,1.0,0,0,920,0,1928,237000.0
2.0,1.0,1750,1.0,0,0,1180,570,1973,650100.0
4.0,2.5,1950,1.0,0,0,1150,800,1963,385000.0
2.0,1.75,1660,2.0,0,0,1660,0,1958,335000.0
4.0,1.5,2670,2.0,0,0,2670,0,1996,347000.0
3.0,1.0,980,1.0,0,0,980,0,1954,204000.0
4.0,2.25,1780,2.0,0,0,1780,0,1971,615000.0
3.0,2.25,2370,2.0,0,0,2370,0,1980,943500.0
3.0,2.0,1640,1.0,0,0,1020,620,1941,560000.0
4.0,2.5,2610,1.0,0,0,1610,1000,1975,547500.0
4.0,1.75,2030,1.0,0,0,1450,580,1968,359500.0
3.0,2.5,2590,1.0,0,0,2590,0,1987,660000.0
3.0,1.75,1620,1.0,0,0,1310,310,1988,258000.0
3.0,1.75,2040,1.0,0,0,2040,0,1980,355000.0
2.0,1.0,810,1.0,0,0,810,0,1948,253500.0
3.0,1.0,1270,1.0,0,0,1270,0,1969,422500.0
2.0,2.0,1470,1.5,0,0,1470,0,1986,239000.0
3.0,2.25,1720,1.0,0,0,1140,580,1984,628000.0
2.0,2.5,1320,1.0,0,0,660,660,2004,352000.0
3.0,2.25,1358,3.0,0,0,1358,0,2007,311600.0
4.0,1.5,2070,1.0,0,0,1060,1010,1964,235000.0
5.0,2.25,2910,2.0,0,0,2910,0,1968,870000.0
4.0,1.5,1370,1.0,0,0,900,470,1970,190848.0
4.0,1.75,2340,1.0,0,0,1170,1170,1924,570000.0
4.0,4.0,2290,1.5,0,0,1690,600,1940,661254.0
4.0,2.0,1650,1.0,0,0,1650,0,1955,575000.0
2.0,0.75,650,1.0,0,0,650,0,1931,230000.0
3.0,2.25,2300,2.0,0,0,2300,0,1980,680000.0
1.0,1.0,620,1.0,0,0,620,0,1939,148000.0
1.0,1.0,620,1.0,0,0,620,0,1939,244900.0
3.0,1.0,1400,1.0,0,0,1280,120,1954,214950.0
3.0,1.5,1800,1.0,0,0,1420,380,1947,580000.0
3.0,1.5,1300,1.0,0,0,1300,0,1968,263000.0
5.0,2.5,2360,1.0,0,0,1180,1180,1962,317000.0
4.0,3.0,3320,1.0,0,0,1750,1570,1963,302000.0
3.0,1.0,1480,2.0,0,0,1480,0,1949,899000.0
3.0,2.5,2190,1.0,0,0,1550,640,1956,1289000.0
3.0,3.25,3740,2.5,0,0,3100,640,1990,710000.0
3.0,1.0,1360,1.0,0,0,1020,340,1980,230000.0
3.0,1.0,1210,1.0,0,0,1210,0,1941,430000.0
5.0,4.25,4610,2.0,0,4,4610,0,2004,1169000.0
3.0,1.0,860,1.5,0,0,860,0,1927,397000.0
3.0,2.5,2250,2.0,0,0,2250,0,2003,595000.0
3.0,1.75,2030,1.0,0,0,1330,700,1976,485000.0
5.0,2.5,3260,1.5,0,1,2310,950,1950,755000.0
3.0,1.0,1840,1.0,0,0,920,920,1953,185000.0
3.0,1.0,1840,1.0,0,0,920,920,1953,340000.0
4.0,2.75,2000,2.0,0,0,2000,0,1997,236000.0
4.0,2.5,2810,2.0,0,0,2810,0,1992,550000.0
3.0,2.0,1780,1.0,0,0,980,800,1925,680000.0
4.0,2.5,2540,2.0,0,0,2540,0,1997,630000.0
3.0,2.0,2340,1.0,0,1,1170,1170,1971,560000.0
3.0,2.0,1480,1.0,0,2,740,740,1943,385000.0
3.0,2.25,1358,3.0,0,0,1358,0,2007,280000.0
3.0,2.5,1750,1.0,0,0,1180,570,1979,225000.0
4.0,1.75,1830,2.0,0,0,1230,600,1990,610000.0
3.0,2.0,1170,1.0,0,0,800,370,1947,592500.0
4.0,2.75,3170,2.0,0,0,3170,0,1992,750000.0
4.0,1.0,1530,2.0,0,0,1530,0,1977,164000.0
2.0,1.0,1100,1.0,0,0,1100,0,1947,320000.0
4.0,2.5,2030,2.0,0,0,2030,0,1994,544000.0
3.0,1.75,1870,1.0,0,0,1320,550,1978,344950.0
3.0,2.5,3080,2.0,0,0,3080,0,1990,539500.0
4.0,1.75,2480,1.0,0,0,1600,880,1968,420000.0
2.0,1.0,910,1.0,0,0,910,0,1926,305000.0
2.0,1.0,810,1.0,0,0,810,0,1955,229000.0
5.0,3.5,3990,2.0,0,0,3990,0,2001,1068000.0
3.0,2.25,1430,3.0,0,0,1430,0,2005,397500.0
4.0,2.0,2190,2.0,0,0,2190,0,1928,540000.0
4.0,2.5,2290,2.0,0,0,2290,0,1985,650000.0
6.0,4.0,3020,2.0,1,4,2840,180,1942,1900000.0
2.0,1.75,2260,2.0,0,2,1890,370,2005,649000.0
5.0,2.0,2020,1.5,0,0,1620,400,1936,287500.0
4.0,2.75,2620,1.0,0,2,1310,1310,1949,815000.0
2.0,2.5,2830,2.0,0,0,2830,0,2001,795000.0
3.0,1.75,1700,1.0,0,0,1200,500,1976,502775.0
2.0,1.0,1110,1.0,0,0,1110,0,1944,222900.0
4.0,3.0,2150,1.0,0,0,1450,700,1969,399950.0
4.0,2.5,2650,2.0,0,0,2650,0,1994,728000.0
5.0,3.5,3870,2.0,0,0,3870,0,1994,850000.0
4.0,2.75,2530,2.0,0,0,2530,0,1998,525000.0
3.0,1.0,1450,1.5,0,0,1450,0,1910,257000.0
3.0,2.5,2200,2.0,0,0,2200,0,2009,433500.0
4.0,1.75,1890,1.0,0,0,1290,600,1969,314950.0
3.0,1.75,1530,1.0,0,0,1100,430,1977,500000.0
3.0,1.5,1590,1.0,0,0,1590,0,1956,300000.0
4.0,2.5,2690,2.0,0,0,2690,0,1985,645000.0
3.0,1.0,990,1.0,0,0,990,0,1972,222500.0
3.0,1.75,1300,1.0,0,0,1080,220,1976,275000.0
3.0,1.5,1720,1.5,0,0,1720,0,1909,498000.0
3.0,1.75,2080,1.0,0,0,2080,0,1958,800000.0
3.0,2.5,1840,2.0,0,0,1840,0,1994,297000.0
5.0,3.5,4010,2.0,0,3,2560,1450,1997,625000.0
4.0,2.5,3560,2.0,0,0,3560,0,2003,770000.0
3.0,2.25,1640,1.5,0,0,1540,100,1930,517000.0
1.0,1.0,530,1.0,0,0,530,0,1941,238000.0
3.0,1.0,1990,1.0,0,0,1140,850,1946,234550.0
3.0,2.25,1690,1.0,0,1,1160,530,1973,230500.0
5.0,2.5,2670,1.5,0,0,1620,1050,1920,585000.0
4.0,1.75,1930,1.5,0,0,1450,480,1924,733000.0
2.0,1.0,810,1.0,0,0,810,0,1952,357950.0
3.0,1.75,1550,1.0,0,0,1050,500,1927,530000.0
4.0,2.5,2640,2.0,0,0,2640,0,1999,377500.0
4.0,2.5,2320,2.0,0,0,2320,0,2006,475000.0
3.0,1.75,2170,1.0,0,0,2170,0,2008,399000.0
3.0,2.0,2080,1.0,0,0,1040,1040,1926,660000.0
5.0,2.25,2070,1.0,0,0,1080,990,1958,400000.0
2.0,1.0,800,1.0,0,0,800,0,1944,440000.0
4.0,2.25,2040,1.0,0,0,1270,770,1977,366400.0
4.0,2.5,2830,2.0,0,0,2830,0,1993,627250.0
3.0,1.75,1480,1.0,0,0,1100,380,1920,375950.0
3.0,2.25,1810,1.0,0,0,1280,530,1978,162000.0
3.0,2.75,1970,2.5,0,0,1970,0,1924,780000.0
4.0,2.5,2650,1.5,0,0,1520,1130,1905,705000.0
4.0,2.5,2820,1.0,0,2,1820,1000,1972,450000.0
3.0,2.75,1400,1.0,0,0,1000,400,1981,311000.0
3.0,2.5,1580,2.0,0,0,1580,0,1985,485000.0
3.0,2.5,1800,2.0,0,0,1800,0,1987,485000.0
5.0,3.75,3360,2.0,0,0,2640,720,1963,725000.0
3.0,1.0,1510,1.0,0,0,1510,0,1975,185000.0
4.0,4.25,4285,2.0,0,0,4285,0,2013,1890000.0
3.0,2.25,1610,2.0,0,0,1610,0,1990,260000.0
4.0,2.5,2470,2.0,0,0,2470,0,2004,356000.0
3.0,1.0,1200,1.0,0,0,1200,0,1977,225205.0
3.0,1.0,1260,1.0,0,0,1260,0,1949,445000.0
2.0,1.0,920,1.0,0,0,920,0,1914,356000.0
5.0,2.75,2540,1.0,0,0,1440,1100,1953,760250.0
2.0,2.0,1870,1.0,0,0,1870,0,2005,572000.0
3.0,2.25,3060,1.5,0,2,1810,1250,1930,970000.0
4.0,2.5,1950,2.0,0,0,1950,0,1994,348450.0
3.0,1.5,1730,2.0,0,0,1730,0,1983,535500.0
5.0,2.5,2570,1.0,0,2,1620,950,1956,710000.0
3.0,1.75,1490,1.0,0,0,1140,350,1947,745000.0
4.0,2.5,2040,2.0,0,0,2040,0,1996,355000.0
4.0,2.5,2690,2.0,0,0,2690,0,2004,333000.0
3.0,2.5,1610,2.0,0,0,1610,0,1993,282000.0
3.0,2.0,2520,1.5,0,0,1410,1110,1906,840500.0
3.0,1.75,1550,1.0,0,0,1550,0,1959,432000.0
3.0,1.0,1800,1.0,0,2,900,900,1927,625000.0
3.0,1.0,1170,1.0,0,0,1170,0,1948,209977.0
2.0,1.0,900,1.0,0,0,900,0,1979,174000.0
4.0,2.0,2800,1.0,0,0,1730,1070,1977,740000.0
3.0,1.75,1830,1.5,0,0,1830,0,1909,518000.0
3.0,1.75,1380,1.0,0,0,940,440,1915,539000.0
3.0,2.75,1990,1.0,0,0,1530,460,1978,575000.0
2.0,1.75,1170,2.0,0,0,780,390,2010,530000.0
4.0,1.75,1400,1.5,0,0,1400,0,1935,242025.0
4.0,2.5,2620,1.0,0,0,1770,850,1962,1030000.0
3.0,1.0,880,1.0,0,0,880,0,1978,230000.0
4.0,2.5,2260,1.0,0,0,1460,800,1965,350000.0
3.0,1.0,1300,1.0,0,0,1300,0,1958,595000.0
3.0,1.75,1450,1.0,0,0,1450,0,1983,440000.0
3.0,1.0,1110,1.0,0,0,1110,0,1904,550000.0
4.0,2.25,1890,1.0,0,1,1470,420,1963,940000.0
3.0,1.5,1100,2.0,0,0,940,160,2007,375000.0
2.0,1.5,1350,1.0,0,0,1070,280,1939,567500.0
3.0,2.5,3020,1.0,0,0,1510,1510,1968,735000.0
2.0,1.0,730,1.0,0,0,730,0,1928,114000.0
2.0,1.0,1390,1.0,0,0,1010,380,1913,608000.0
3.0,1.5,2710,1.5,0,0,2170,540,1980,442500.0
4.0,2.0,1530,1.0,0,0,1110,420,1981,381800.0
3.0,2.0,2170,1.0,0,0,1340,830,1919,330000.0
2.0,1.0,790,1.0,0,0,790,0,1973,90000.0
2.0,1.75,1160,1.0,0,0,1160,0,1941,312000.0
3.0,1.0,1080,1.0,0,0,1080,0,1955,339000.0
3.0,1.75,2190,1.0,0,0,2190,0,1967,313000.0
3.0,2.5,2030,2.0,0,0,2030,0,1988,618080.0
3.0,2.25,2480,2.0,0,0,2480,0,1979,325000.0
4.0,1.0,2240,1.0,0,0,1120,1120,1966,242000.0
2.0,1.5,1650,1.0,0,0,860,790,1978,364000.0
3.0,1.75,1700,1.5,0,2,1450,250,1925,545000.0
3.0,2.5,2790,2.0,0,0,2790,0,1988,445000.0
4.0,2.75,3010,2.0,0,3,3010,0,1980,1085500.0
4.0,2.5,2550,1.0,0,0,1290,1260,1964,660000.0
4.0,2.5,2880,1.0,0,0,2880,0,1989,845000.0
4.0,2.0,2090,1.0,0,0,1060,1030,1907,417000.0
2.0,1.0,740,1.0,0,0,740,0,1952,213800.0
2.0,1.75,960,1.0,0,0,960,0,1946,400000.0
4.0,3.5,2100,2.0,0,0,2100,0,2005,759950.0
4.0,2.5,2540,2.0,0,0,2540,0,2003,990000.0
3.0,1.75,1650,1.0,0,0,1650,0,1963,710000.0
1.0,0.75,770,1.0,0,0,770,0,1910,315000.0
4.0,2.5,2280,1.0,0,0,1500,780,1977,515000.0
3.0,2.0,1660,1.0,0,0,970,690,1922,638000.0
4.0,2.0,2020,1.5,0,0,1160,860,1946,370000.0
3.0,1.0,970,1.0,0,0,970,0,1968,184000.0
3.0,2.5,2480,2.0,0,0,2480,0,2002,583800.0
3.0,1.0,1250,1.0,0,0,1250,0,1968,309500.0
4.0,4.0,4430,2.0,0,0,4430,0,1998,1960000.0
1.0,1.0,740,1.0,0,0,740,0,1923,299000.0
2.0,1.0,710,1.0,0,0,710,0,1943,215000.0
4.0,2.0,1970,1.0,0,0,1820,150,1961,410000.0
2.0,1.0,820,1.0,0,0,820,0,1939,478000.0
2.0,1.0,1000,1.0,0,0,1000,0,1918,431000.0
4.0,2.5,3080,2.0,0,0,3080,0,1997,635000.0
5.0,2.25,2410,2.0,0,0,2410,0,1973,648000.0
3.0,2.5,2370,2.0,0,0,2370,0,1993,640000.0
5.0,4.5,4690,2.0,0,0,3450,1240,1995,932808.0
2.0,2.0,2280,1.0,0,0,2280,0,2002,835000.0
2.0,1.75,1530,1.0,0,0,1030,500,1942,469775.0
5.0,3.5,3610,2.0,0,0,3610,0,1989,587000.0
3.0,2.0,1740,1.0,0,0,990,750,1923,677915.0
4.0,3.0,3600,1.0,0,4,2100,1500,1976,1075000.0
4.0,3.0,3130,1.5,0,0,1750,1380,1953,671000.0
5.0,3.25,3940,2.0,0,0,3940,0,2007,695000.0
4.0,2.0,2200,1.0,0,0,1100,1100,1944,205000.0
4.0,1.0,1510,1.5,0,0,1510,0,1955,350000.0
3.0,1.75,1560,2.0,0,0,1560,0,1980,360000.0
4.0,2.25,1870,2.0,0,0,1870,0,2008,313999.0
3.0,2.25,2070,1.0,0,0,1690,380,1979,300000.0
2.0,1.75,1660,1.0,0,0,830,830,1981,452000.0
3.0,2.5,2010,1.0,0,0,2010,0,1978,495500.0
3.0,1.0,1410,1.0,0,0,1410,0,1961,288000.0
3.0,1.75,1820,1.0,0,0,1820,0,1967,227490.0
3.0,2.5,2560,2.0,0,0,2560,0,1989,470950.0
4.0,2.75,2450,2.0,0,2,2450,0,2010,735000.0
7.0,2.75,3110,1.5,0,0,2010,1100,1914,730000.0
3.0,2.5,2210,2.0,0,0,2210,0,1985,412000.0
4.0,2.5,2630,2.0,0,0,2630,0,2008,589500.0
7.0,1.0,2350,1.0,0,0,1550,800,1962,291000.0
5.0,3.75,4450,2.0,0,0,3460,990,2010,1300000.0
3.0,1.0,1200,1.0,0,0,1200,0,1961,190000.0
2.0,1.75,1210,1.0,0,0,1210,0,1904,456200.0
3.0,1.0,1290,1.0,0,0,970,320,1966,225000.0
3.0,2.5,3490,1.0,1,4,2290,1200,1968,2000000.0
4.0,2.5,3360,2.0,0,0,3360,0,1997,740000.0
3.0,1.75,2660,1.0,0,0,1330,1330,1948,467000.0
2.0,1.0,770,1.0,0,0,770,0,1946,385000.0
3.0,2.5,1800,2.0,0,0,1240,560,1985,670000.0
4.0,2.5,2900,1.0,0,0,1660,1240,1959,500000.0
3.0,2.0,1430,1.0,0,0,1430,0,1945,352450.0
4.0,2.75,2550,2.0,0,0,2550,0,1989,669888.0
3.0,2.75,1310,1.0,0,0,1310,0,1957,405000.0
3.0,1.5,1430,1.0,0,0,1430,0,1956,518000.0
4.0,1.0,1880,1.0,0,0,1120,760,1974,280000.0
3.0,2.5,1600,2.0,0,0,1600,0,2005,435000.0
3.0,2.0,1760,1.0,0,0,1760,0,1996,314950.0
2.0,2.0,1180,2.0,0,0,1180,0,2005,209900.0
4.0,2.5,2330,2.0,0,0,2330,0,1980,630000.0
4.0,1.5,1960,1.5,0,0,1960,0,1962,442000.0
4.0,1.0,1140,1.0,0,0,1140,0,1944,340000.0
3.0,1.75,1400,1.0,0,0,1400,0,1957,230000.0
5.0,2.25,2710,1.0,0,0,1410,1300,1955,495200.0
4.0,2.5,3510,2.0,0,0,3510,0,1998,900000.0
2.0,1.0,910,1.0,0,0,910,0,1917,265000.0
3.0,1.75,2090,1.0,0,0,1330,760,1977,489500.0
3.0,2.0,1410,1.0,0,0,1410,0,1985,335000.0
3.0,3.25,3050,2.0,0,0,2240,810,1990,585000.0
4.0,2.25,2010,1.0,0,1,1010,1000,1950,800000.0
4.0,2.25,2120,2.0,0,2,2120,0,1985,379500.0
3.0,1.0,1270,1.0,0,0,1270,0,1959,475000.0
3.0,2.0,1670,1.0,0,0,1150,520,1961,520000.0
4.0,2.5,1800,2.0,0,0,1800,0,2001,515000.0
2.0,1.0,1640,1.0,0,0,940,700,1926,577500.0
3.0,2.25,1740,1.0,0,0,1110,630,1963,269900.0
3.0,1.0,1600,1.0,0,0,1150,450,1964,329000.0
3.0,1.5,1280,1.5,0,0,1280,0,1905,458500.0
4.0,2.0,1480,1.5,0,0,1480,0,1947,890000.0
4.0,2.5,1980,2.0,0,0,1980,0,2003,361500.0
5.0,3.25,3730,1.0,0,4,3730,0,1963,2535000.0
2.0,1.0,900,1.0,0,0,900,0,1984,325000.0
4.0,3.25,3480,3.0,0,0,3480,0,2014,1850000.0
4.0,2.0,2840,1.0,0,0,1420,1420,1952,945000.0
3.0,2.5,2490,2.0,0,0,2490,0,2005,370000.0
,2.5,1490,2.0,0,0,1490,0,1999,320000.0
2.0,2.0,1510,1.0,0,0,1510,0,2006,450000.0
4.0,2.5,2900,2.0,0,0,2900,0,1994,800000.0
3.0,2.5,2240,2.0,0,0,2240,0,1995,676000.0
4.0,1.75,2040,2.0,0,0,2040,0,1921,1272500.0
3.0,1.75,1460,1.0,0,0,1460,0,1972,290000.0
3.0,1.5,990,1.0,0,0,990,0,1962,158000.0
4.0,1.75,1970,1.0,0,0,1140,830,1960,379950.0
4.0,2.5,2660,2.0,0,0,2660,0,2001,583000.0
2.0,1.0,870,1.0,0,0,870,0,1957,150000.0
3.0,2.5,1740,2.0,0,0,1740,0,1990,261500.0
4.0,2.5,2290,2.0,0,0,2290,0,2004,278000.0
4.0,2.75,2170,1.0,0,0,1290,880,1977,555000.0
3.0,1.75,2040,1.0,0,0,1470,570,1958,355000.0
4.0,1.5,1770,1.0,0,0,1770,0,1958,375000.0
3.0,1.75,2380,1.0,0,0,1380,1000,1918,227000.0
4.0,2.0,2030,1.0,0,0,2030,0,1969,335000.0
3.0,2.25,2270,1.0,0,0,1820,450,1975,680000.0
2.0,1.75,1390,1.5,0,0,1390,0,1928,686500.0
3.0,1.75,1530,1.0,0,0,1180,350,1988,410000.0
2.0,1.0,1430,1.5,0,0,1230,200,1921,425000.0
3.0,2.5,2030,1.0,0,0,2030,0,1988,562500.0
4.0,2.5,2390,2.0,0,0,2390,0,2003,345000.0
4.0,2.5,2540,1.0,0,0,1640,900,1979,627500.0
3.0,1.0,1890,1.0,0,0,1890,0,1962,355000.0
3.0,2.25,1870,2.0,0,0,1870,0,1986,335000.0
4.0,3.0,1780,1.0,0,0,1780,0,1953,350000.0
3.0,1.0,1610,1.0,0,0,1610,0,1978,590000.0
3.0,2.0,1420,2.0,0,0,1420,0,1990,252000.0
5.0,4.0,4440,1.0,0,0,2220,2220,1968,1295000.0
4.0,2.0,1820,2.0,0,0,1820,0,1947,705000.0
3.0,2.0,1620,1.0,0,0,1180,440,1968,498000.0
2.0,1.0,870,1.0,0,0,870,0,1948,312500.0
4.0,1.75,1830,1.0,0,0,1060,770,1962,260000.0
3.0,1.5,2290,1.0,0,0,2290,0,1967,209950.0
3.0,1.75,1110,1.0,0,0,1110,0,1967,610000.0
4.0,1.0,1440,1.5,0,0,1440,0,1906,500000.0
3.0,3.5,3070,1.0,0,3,1570,1500,1928,850000.0
4.0,2.5,2440,1.0,0,0,1480,960,1961,689000.0
4.0,2.0,2410,2.0,0,0,2410,0,1974,470000.0
3.0,3.0,2270,2.0,0,0,2130,140,2002,640000.0
4.0,1.75,2340,1.0,0,0,1590,750,1960,290000.0
3.0,2.5,1800,2.0,0,0,1800,0,1983,258500.0
4.0,3.5,2210,1.0,0,0,1550,660,1977,1100000.0
3.0,1.75,1820,1.0,0,0,1250,570,1977,420000.0
3.0,1.0,1190,1.0,0,0,1190,0,1955,230000.0
3.0,1.5,1400,1.0,0,0,1400,0,1986,252000.0
3.0,2.5,2600,2.0,0,0,2600,0,2003,515000.0
2.0,1.0,910,1.0,0,0,910,0,1905,425000.0
3.0,2.5,1760,2.0,0,2,1760,0,1994,575000.0
2.0,1.0,860,1.0,0,0,860,0,1909,390000.0
4.0,2.25,2310,1.0,0,0,1780,530,1968,561500.0
4.0,1.75,2000,1.5,0,0,1820,180,1926,1350000.0
5.0,2.75,2460,1.0,0,0,1490,970,1955,835000.0
2.0,1.0,1020,1.5,0,0,1020,0,1933,245000.0
3.0,2.5,1670,2.0,0,0,1670,0,2000,475200.0
2.0,1.0,790,1.0,0,0,790,0,1941,425000.0
2.0,1.5,2010,2.0,0,0,2010,0,1952,218000.0
4.0,2.5,2600,2.0,0,0,2600,0,1999,600000.0
4.0,2.25,1890,1.0,0,0,1890,0,1967,545000.0
5.0,2.5,4600,1.5,0,2,3600,1000,1918,2408000.0
5.0,3.0,2008,1.0,0,0,1216,792,1992,460000.0
2.0,1.0,880,1.0,0,0,880,0,1950,425000.0
3.0,1.75,1700,1.0,0,0,850,850,1955,455000.0
3.0,2.0,1730,1.0,0,0,1730,0,1994,313100.0
4.0,3.5,3910,2.0,0,0,2490,1420,1987,780000.0
4.0,2.5,2160,2.0,0,0,2160,0,1999,345500.0
3.0,1.75,1200,1.0,0,0,1200,0,1975,243000.0
5.0,3.5,3860,1.0,0,3,2660,1200,1973,670000.0
3.0,1.5,1320,1.0,0,0,840,480,1983,325000.0
2.0,1.0,1280,1.0,0,0,1060,220,1951,281000.0
3.0,1.0,1100,1.0,0,0,1100,0,1913,130000.0
3.0,2.5,2170,2.0,0,0,2170,0,1995,340000.0
4.0,2.75,2720,2.0,0,0,2720,0,1977,485000.0
4.0,2.75,2520,2.0,0,0,2520,0,2014,642860.0
3.0,1.75,2560,1.0,0,0,1280,1280,1911,747000.0
4.0,2.5,2650,2.0,0,0,2250,400,1979,559950.0
4.0,2.75,2870,2.0,0,0,2870,0,2008,577288.0
2.0,1.0,1230,1.5,0,0,880,350,1920,575000.0
3.0,1.0,1450,1.0,0,0,1450,0,1953,287000.0
4.0,3.75,3180,2.0,0,0,2500,680,2012,1149000.0
2.0,1.0,1800,1.0,0,0,900,900,1945,335000.0
4.0,2.25,2020,2.0,0,0,2020,0,1966,375000.0
2.0,1.0,620,1.0,0,0,620,0,1926,325000.0
3.0,2.25,2190,1.0,0,0,1330,860,1976,530000.0
4.0,2.25,1980,1.0,0,0,1470,510,1977,287000.0
5.0,3.0,2970,1.0,0,0,1810,1160,1979,320000.0
4.0,2.5,2270,2.0,0,0,2270,0,2006,425000.0
3.0,1.0,1630,1.0,0,3,1630,0,1954,550000.0
3.0,1.0,1520,1.0,0,0,1120,400,1961,135000.0
3.0,1.75,2080,1.5,0,0,2080,0,1924,695000.0
5.0,2.5,3020,1.0,0,2,1980,1040,1977,975000.0
4.0,1.75,2180,1.0,0,0,1180,1000,1950,210000.0
4.0,1.75,1780,1.0,0,0,1050,730,1951,518000.0
3.0,1.0,1370,2.0,0,0,1370,0,1930,335500.0
4.0,3.5,3050,2.0,0,3,2050,1000,1984,750000.0
3.0,1.75,1490,1.0,0,0,1490,0,1956,515000.0
4.0,2.75,1800,1.0,0,0,1050,750,2002,344500.0
3.0,1.5,1760,1.0,0,0,1160,600,1958,470000.0
4.0,1.75,1770,1.0,0,0,1370,400,1967,606150.0
4.0,2.75,2910,1.0,0,0,1600,1310,1998,292000.0
3.0,2.5,2880,2.0,0,3,2880,0,1979,450000.0
3.0,1.75,2520,1.0,0,0,1260,1260,1957,429000.0
4.0,2.5,3190,2.0,0,0,3190,0,1988,765000.0
2.0,1.0,540,1.0,0,0,540,0,1905,425000.0
4.0,2.5,3170,2.0,0,0,3170,0,2000,505000.0
3.0,1.75,1830,1.0,0,0,1830,0,1957,544950.0
3.0,2.0,1360,1.5,0,0,1360,0,1936,382000.0
3.0,1.75,1870,2.0,0,0,1870,0,1978,475000.0
3.0,1.5,1370,2.0,0,0,1370,0,1982,355000.0
4.0,2.5,1700,1.0,0,0,1700,0,1972,410000.0
4.0,2.0,1960,1.0,0,0,980,980,1900,450000.0
7.0,4.5,4140,1.0,0,0,2070,2070,1978,565000.0
2.0,1.0,1290,1.5,0,0,1290,0,1941,529100.0
4.0,2.5,2460,2.0,0,0,2460,0,2006,452500.0
4.0,2.0,1580,1.0,0,0,1040,540,1967,245000.0
1.0,1.0,700,1.0,0,0,700,0,1954,415000.0
4.0,2.5,2410,2.0,0,3,2410,0,1990,610000.0
4.0,1.75,2180,1.0,0,0,1090,1090,1962,363500.0
3.0,2.75,1950,1.0,0,0,1230,720,1969,510000.0
4.0,2.5,2630,2.0,0,0,2630,0,1996,650000.0
4.0,2.5,2050,2.0,0,0,2050,0,1973,290000.0
3.0,1.0,790,1.0,0,0,790,0,1944,170000.0
2.0,1.0,1070,1.0,0,0,1070,0,1900,510000.0
7.0,8.0,13540,3.0,0,4,9410,4130,1999,2280000.0
4.0,2.5,2320,2.0,0,0,2320,0,1987,316000.0
4.0,2.5,2670,2.0,0,0,2670,0,1989,690000.0
2.0,1.0,700,1.0,0,0,700,0,1952,199950.0
3.0,1.0,860,1.0,0,0,860,0,1960,207000.0
4.0,2.25,3490,1.5,0,0,3490,0,1976,449950.0
3.0,1.75,1160,1.0,0,0,1160,0,1980,361550.0
4.0,3.5,3650,2.0,0,0,3650,0,1996,824000.0
3.0,1.75,1550,1.0,0,0,1550,0,1957,537000.0
4.0,2.5,2620,2.5,0,0,2620,0,1974,838400.0
2.0,1.0,720,1.0,0,0,720,0,1947,225000.0
3.0,2.0,1380,1.0,0,0,1380,0,1982,329900.0
4.0,1.0,1170,1.0,0,0,1170,0,1942,282500.0
3.0,1.75,1170,1.0,0,0,1170,0,1969,229950.0
2.0,1.0,1630,1.0,0,0,1270,360,1947,500000.0
3.0,1.75,1890,1.0,0,0,1890,0,1967,495000.0
3.0,1.0,1010,1.0,0,0,1010,0,1959,149500.0
3.0,2.5,2040,1.0,0,0,1420,620,1974,726000.0
4.0,2.5,4080,2.0,0,0,4080,0,1998,899000.0
3.0,1.0,1270,1.0,0,0,1270,0,1955,317000.0
1.0,1.0,790,1.0,0,0,790,0,1953,395000.0
4.0,3.0,2580,2.0,0,0,2580,0,1999,360000.0
4.0,2.5,2290,2.0,0,0,2290,0,1996,570000.0
4.0,2.5,3490,2.0,0,0,3490,0,2003,320000.0
3.0,1.75,1510,1.5,0,0,1510,0,1976,320000.0
5.0,2.5,2400,2.0,0,0,2400,0,2004,268000.0
2.0,1.0,900,1.0,0,0,900,0,1905,191000.0
2.0,1.0,1270,1.0,0,0,910,360,1949,400000.0
2.0,1.0,1050,1.0,0,0,1050,0,1907,515000.0
4.0,2.5,2950,2.0,0,0,2950,0,2004,610000.0
2.0,1.75,1850,1.0,0,0,1060,790,1929,538000.0
3.0,2.5,1970,2.0,0,0,1970,0,2003,432000.0
4.0,2.25,2400,2.0,0,0,2400,0,1978,335000.0
5.0,1.75,2360,1.5,0,0,2060,300,1926,302000.0
4.0,1.75,1580,1.0,0,0,1080,500,1963,787500.0
3.0,1.0,1790,1.0,0,0,1520,270,1937,420000.0
3.0,2.5,2840,2.0,0,0,2840,0,1991,560000.0
3.0,2.5,1970,2.0,0,0,1970,0,1989,535000.0
3.0,2.5,1780,1.0,0,0,1230,550,1990,310000.0
5.0,2.0,3920,1.5,0,0,2560,1360,1910,760000.0
3.0,1.75,1550,2.0,0,0,1550,0,2005,242500.0
6.0,3.0,2980,1.5,0,2,2980,0,1911,1313000.0
3.0,1.0,1270,1.0,0,0,1270,0,1949,235000.0
4.0,2.25,3040,1.0,0,0,1520,1520,1963,598780.0
3.0,2.5,2075,2.0,0,0,2075,0,2002,433200.0
2.0,1.0,1110,1.0,0,0,700,410,1942,343000.0
2.0,1.0,800,1.0,0,0,800,0,1964,145000.0
1.0,1.0,680,1.0,0,0,680,0,1952,291970.0
3.0,1.0,1680,1.0,0,0,1680,0,1949,599950.0
4.0,2.5,3910,1.5,0,0,3910,0,1908,1749000.0
4.0,1.75,2780,1.0,0,0,1560,1220,1964,870000.0
4.0,2.75,2000,2.0,0,0,2000,0,1992,323000.0
4.0,3.0,3150,2.0,0,0,3150,0,2001,727000.0
1.0,1.0,1120,1.0,0,0,1120,0,1988,166000.0
4.0,1.75,1740,1.0,0,0,1270,470,1961,450000.0
3.0,2.5,2970,1.0,0,0,1510,1460,1967,400000.0
3.0,2.5,2970,1.0,0,0,1510,1460,1967,599000.0
3.0,1.0,1150,1.0,0,0,1150,0,1908,165000.0
2.0,1.0,1190,1.0,0,0,830,360,1941,229000.0
1.0,1.0,900,1.0,0,0,900,0,1946,305000.0
3.0,3.25,2950,2.0,0,0,2450,500,2001,930000.0
3.0,2.5,1990,1.0,0,0,1540,450,1964,542000.0
3.0,1.0,1020,1.0,0,0,1020,0,1900,214000.0
3.0,2.5,2070,2.0,0,0,2070,0,2001,718000.0
3.0,2.5,1430,3.0,0,0,1430,0,2002,349000.0
3.0,2.5,2030,2.0,0,0,2030,0,1997,305000.0
3.0,2.5,1620,2.0,0,0,1620,0,1900,498000.0
4.0,3.5,4220,2.0,0,0,4220,0,1993,799950.0
3.0,2.5,2300,2.0,0,2,2300,0,1997,737000.0
4.0,3.25,3830,2.0,0,0,3830,0,2001,860000.0
3.0,2.5,2390,1.0,0,0,1840,550,1984,339950.0
3.0,2.25,1440,1.0,0,0,940,500,1982,249000.0
2.0,1.0,910,1.0,0,0,910,0,1910,370000.0
3.0,2.0,1550,1.0,0,0,1550,0,1964,725000.0
5.0,2.5,2380,1.0,0,0,1580,800,1976,529000.0
4.0,2.75,2060,1.0,0,0,1310,750,1988,310000.0
4.0,2.25,1880,2.0,0,0,1880,0,1981,315000.0
4.0,2.5,3470,2.0,0,0,2480,990,1927,1300000.0
3.0,2.0,2360,2.0,0,0,2360,0,1964,435000.0
3.0,1.75,1970,1.0,0,0,1300,670,1979,350000.0
3.0,1.0,1040,1.0,0,0,1040,0,1948,240000.0
3.0,2.25,1420,2.0,0,0,1420,0,1987,410000.0
4.0,2.75,2290,2.0,0,0,2290,0,2003,430000.0
4.0,2.5,1530,1.0,0,0,1020,510,1974,446000.0
3.0,1.5,1360,1.5,0,0,1360,0,1984,240000.0
4.0,3.0,3680,1.5,0,0,2320,1360,1970,595000.0
3.0,1.0,920,1.0,0,0,920,0,1969,215150.0
2.0,1.0,1070,1.0,0,2,1070,0,1949,319950.0
3.0,2.0,1590,2.0,0,0,1590,0,2000,385000.0
3.0,2.5,1600,2.0,0,0,1600,0,1991,280000.0
3.0,2.5,1510,1.0,0,0,1040,470,1974,399950.0
3.0,1.0,1080,1.0,0,0,1080,0,1967,132500.0
2.0,0.75,1330,1.0,0,0,930,400,1916,399950.0
2.0,1.0,850,1.0,0,0,850,0,1948,290000.0
5.0,2.25,1960,1.0,0,0,1290,670,1958,860000.0
6.0,4.25,6980,3.0,0,4,5330,1650,1999,3100000.0
4.0,1.0,1530,1.5,0,0,1400,130,1948,245000.0
3.0,1.5,1320,1.0,0,0,1320,0,1956,255000.0
4.0,3.0,2320,2.0,0,0,2320,0,1976,310000.0
3.0,1.0,960,1.0,0,0,960,0,1955,299000.0
4.0,2.5,2040,2.0,0,0,2040,0,1996,575000.0
3.0,1.0,1080,1.0,0,0,1080,0,1944,284000.0
3.0,1.75,2020,1.0,0,0,1090,930,1926,840000.0
3.0,1.75,1780,1.0,0,0,1290,490,1980,442573.0
3.0,1.0,1140,1.0,0,0,1140,0,1931,560000.0
3.0,2.0,1610,1.0,0,0,1010,600,1917,485000.0
4.0,1.75,1440,1.0,0,0,1440,0,1961,472500.0
4.0,2.75,4270,2.0,0,0,4270,0,1996,1610000.0
8.0,3.75,3460,2.0,0,0,2860,600,1987,808000.0
3.0,1.75,1890,1.5,0,0,1890,0,1950,398000.0
3.0,2.5,2240,2.0,0,0,2240,0,2003,340000.0
2.0,1.0,760,1.5,0,0,760,0,1910,380000.0
3.0,1.0,1020,1.0,0,0,780,240,1948,235000.0
3.0,1.5,1330,1.0,0,0,1330,0,1956,400000.0
5.0,2.5,2780,1.0,0,0,1590,1190,1968,582000.0
2.0,1.0,1070,1.0,0,0,1070,0,1962,209000.0
5.0,3.0,2660,1.5,0,0,1670,990,1962,335000.0
2.0,1.0,710,1.0,0,0,710,0,1942,285950.0
5.0,2.25,3340,2.0,0,0,3340,0,1975,645000.0
2.0,1.0,1160,1.5,0,0,1160,0,1916,312000.0
3.0,2.25,2840,1.0,0,0,1580,1260,1967,663000.0
3.0,1.75,2000,1.0,0,0,2000,0,1946,443950.0
3.0,2.0,1060,1.0,0,0,1060,0,1981,315000.0
4.0,1.5,1730,1.0,0,0,1730,0,1964,302200.0
3.0,2.5,2190,2.0,0,3,2190,0,1979,770000.0
4.0,1.75,1660,1.0,0,0,1660,0,1974,374950.0
3.0,2.5,2210,2.0,0,0,2210,0,1989,330000.0
2.0,1.0,870,1.0,0,0,570,300,1942,230000.0
4.0,2.5,3100,2.0,0,0,3100,0,2010,967000.0
4.0,2.5,1720,2.0,0,2,1470,250,2000,536500.0
6.0,4.0,3120,2.0,0,2,2090,1030,1993,315000.0
3.0,1.0,1040,1.0,0,0,860,180,1924,626000.0
4.0,2.0,1650,1.0,0,0,1650,0,1960,334009.0
2.0,1.0,1010,1.0,0,0,1010,0,1924,429000.0
4.0,2.5,4020,2.0,0,0,4020,0,1987,818000.0
5.0,2.75,2166,2.0,0,0,2166,0,2013,326000.0
5.0,3.0,1880,1.0,0,0,1100,780,1997,310000.0
4.0,2.0,2260,1.0,0,0,1130,1130,1947,525000.0
3.0,2.25,2010,1.5,0,0,2010,0,1986,350000.0
4.0,2.5,3330,2.0,0,0,3330,0,2001,936000.0
3.0,1.0,1520,1.0,0,0,1030,490,1954,226000.0
5.0,3.5,3510,2.0,0,0,2700,810,2008,1250000.0
3.0,1.75,1580,1.0,0,2,1580,0,1985,428000.0
3.0,1.5,1460,1.0,0,0,1100,360,1971,329932.0
3.0,1.5,1460,1.0,0,0,1100,360,1971,539000.0
3.0,1.75,1650,1.0,0,0,1650,0,1977,275000.0
4.0,2.5,2660,2.0,0,2,2660,0,1993,590000.0
4.0,2.5,3510,2.0,0,0,3510,0,1997,782000.0
4.0,2.5,2120,2.0,0,0,2120,0,1985,575000.0
3.0,2.25,1780,2.0,0,0,1780,0,1996,509000.0
4.0,2.5,2000,1.0,0,0,1200,800,1968,290000.0
3.0,1.0,1300,1.0,0,0,1300,0,1956,305240.0
3.0,2.0,2180,1.5,0,2,1680,500,1930,555000.0
3.0,2.0,1790,1.0,0,0,1390,400,1980,317000.0
3.0,2.0,1910,1.5,0,0,1910,0,1971,430000.0
2.0,1.5,1800,1.0,0,4,900,900,1962,850000.0
3.0,2.25,2620,1.0,0,0,1660,960,1976,469000.0
2.0,2.0,1440,1.0,0,0,1440,0,1942,327200.0
3.0,3.0,2790,2.0,1,4,1600,1190,1977,835000.0
4.0,2.5,2340,2.0,0,0,2340,0,1990,360000.0
4.0,2.5,2070,2.0,0,0,2070,0,1999,372000.0
3.0,1.0,2160,1.5,0,0,2160,0,1968,453000.0
2.0,1.75,2090,1.0,0,0,1090,1000,1931,275000.0
4.0,2.5,2040,2.0,0,0,2040,0,1963,475000.0
4.0,2.75,1950,1.0,0,0,1400,550,1986,310000.0
4.0,2.0,1200,1.0,0,0,1200,0,1957,173000.0
5.0,3.0,2240,1.0,0,0,2240,0,1985,313500.0
3.0,2.5,1360,2.0,0,0,1360,0,2007,345000.0
3.0,1.5,1500,1.0,0,0,1300,200,1955,436000.0
2.0,1.75,1300,1.0,0,0,650,650,1939,244500.0
3.0,1.75,1140,1.0,0,0,1140,0,1968,206000.0
4.0,2.5,2930,2.0,0,0,2930,0,2005,890000.0
4.0,2.25,2140,2.0,0,0,2140,0,1986,329950.0
3.0,1.75,1628,1.0,0,0,1628,0,1996,250000.0
3.0,2.0,1990,1.0,0,0,1990,0,1949,246000.0
3.0,1.75,1950,1.0,0,0,1150,800,1979,440000.0
4.0,1.75,1910,1.0,0,0,1460,450,1975,395000.0
3.0,1.0,820,1.0,0,0,820,0,1918,305000.0
3.0,2.25,1470,1.0,0,0,1160,310,1985,160000.0
3.0,2.25,1470,1.0,0,0,1160,310,1985,269000.0
3.0,1.0,1060,1.0,0,0,1060,0,1962,169500.0
4.0,2.75,3130,2.0,0,0,3130,0,2014,690500.0
2.0,1.5,1260,1.0,0,0,1260,0,1957,245560.0
4.0,2.75,2200,2.0,0,0,2200,0,1987,345000.0
4.0,1.75,2580,1.0,0,2,1290,1290,1958,383000.0
3.0,2.25,1350,2.0,0,0,1050,300,2007,388500.0
3.0,1.75,1350,1.0,0,0,1350,0,1985,250000.0
3.0,1.75,2290,1.0,0,0,1650,640,1973,455500.0
3.0,1.0,1220,1.0,0,0,1220,0,1954,672000.0
4.0,1.5,2750,1.0,0,0,1500,1250,1958,550000.0
3.0,1.75,1430,1.0,0,0,1430,0,1959,487000.0
4.0,2.5,2220,2.0,0,0,2220,0,2001,291375.0
3.0,1.0,1490,1.0,0,0,1490,0,1946,225000.0
5.0,3.5,2440,2.0,0,0,2440,0,1974,519950.0
3.0,2.5,2070,2.0,0,0,2070,0,1990,250000.0
3.0,1.0,1500,1.5,0,0,1500,0,1900,614950.0
4.0,2.25,2020,2.0,0,0,2020,0,1984,599500.0
4.0,1.5,2190,1.0,0,3,2190,0,1952,625000.0
2.0,1.0,780,1.0,0,0,780,0,1958,248500.0
5.0,2.0,1220,1.0,0,0,1090,130,1921,469950.0
3.0,1.5,1840,1.0,0,0,1840,0,1970,525000.0
2.0,2.5,2390,2.0,0,3,1810,580,1949,787500.0
4.0,2.5,3710,1.0,0,0,2130,1580,2005,485000.0
2.0,1.0,750,1.0,0,0,750,0,1919,310000.0
5.0,2.0,2110,1.0,0,0,1110,1000,1966,280000.0
4.0,1.0,1020,1.5,0,0,1020,0,1922,200000.0
3.0,2.5,3080,2.0,0,0,3080,0,2006,490000.0
3.0,1.0,900,1.0,0,0,900,0,1969,146000.0
5.0,3.0,3720,2.0,0,4,2090,1630,1986,500000.0
3.0,1.0,940,1.0,0,0,940,0,1959,242500.0
3.0,1.0,1040,1.0,0,0,1040,0,1959,324950.0
2.0,1.0,1000,1.0,0,0,1000,0,1943,231500.0
3.0,2.5,2080,2.0,0,0,2080,0,1989,300000.0
4.0,2.5,2500,2.0,0,0,2500,0,1997,545000.0
3.0,1.0,1050,1.0,0,0,1050,0,1955,350000.0
3.0,1.75,1620,1.0,0,0,1190,430,1973,467100.0
3.0,1.0,1610,1.5,0,0,1610,0,1959,180000.0
4.0,1.5,2130,2.0,0,0,2130,0,1920,749000.0
3.0,2.5,1460,2.0,0,0,1460,0,1989,245000.0
5.0,1.0,1600,1.0,0,0,1600,0,1962,260000.0
3.0,3.0,1730,3.0,0,0,1730,0,1985,490000.0
4.0,2.5,2280,2.0,0,0,2280,0,2003,565000.0
4.0,2.25,2430,2.0,0,0,2430,0,1983,330000.0
3.0,1.0,1380,1.0,0,0,1380,0,1963,295000.0
3.0,1.5,1790,1.5,0,0,1790,0,1903,725000.0
4.0,2.5,3370,2.0,0,0,3370,0,1999,1135000.0
3.0,2.25,2920,1.0,0,0,1710,1210,1956,680000.0
2.0,1.0,2180,1.0,0,0,1090,1090,1947,490000.0
3.0,1.75,1480,1.5,0,0,1200,280,1926,635000.0
3.0,2.5,2350,1.5,0,0,2350,0,1979,750000.0
4.0,2.25,2440,2.0,0,0,2440,0,1983,330000.0
3.0,2.5,1350,2.0,0,0,1080,270,2007,270000.0
3.0,2.25,1970,2.0,0,0,1970,0,1997,340000.0
3.0,0.75,1110,1.0,0,0,1110,0,1951,413252.0
4.0,2.75,2950,2.0,0,0,2950,0,2007,600000.0
5.0,3.0,2970,2.0,0,0,2970,0,1999,726888.0
2.0,1.0,720,1.0,0,0,720,0,1943,285000.0
2.0,1.0,770,1.0,0,0,770,0,1929,365000.0
4.0,2.0,1650,1.0,0,0,1650,0,1964,295000.0
3.0,2.25,1620,1.0,0,0,1170,450,1969,460000.0
3.0,1.5,1510,1.5,0,0,1510,0,1947,230000.0
3.0,1.0,1070,1.0,0,0,1070,0,1951,337000.0
3.0,1.0,1010,1.0,0,0,1010,0,1957,300000.0
4.0,2.5,3370,1.0,0,0,2240,1130,1962,2300000.0
4.0,2.5,2000,2.0,0,0,2000,0,2003,360000.0
3.0,2.5,2060,2.0,0,0,2060,0,1987,585000.0
3.0,2.25,1740,1.0,0,0,1240,500,1978,182700.0
3.0,2.25,1740,1.0,0,0,1240,500,1978,305000.0
3.0,2.5,1880,2.0,0,0,1880,0,1994,309950.0
3.0,1.0,960,1.0,0,0,960,0,1972,550000.0
3.0,2.5,3280,1.0,0,3,2670,610,1985,825000.0
2.0,1.0,1570,1.5,0,0,1570,0,1914,998500.0
4.0,2.5,2990,2.0,0,0,2990,0,2004,644500.0
3.0,2.0,1250,1.0,0,0,1250,0,1968,320000.0
3.0,2.5,1920,2.0,0,0,1920,0,2005,266950.0
4.0,2.5,2470,2.0,0,0,2470,0,1993,633100.0
2.0,1.0,960,1.0,0,0,960,0,1951,395000.0
3.0,1.0,940,1.0,0,0,940,0,1947,259250.0
3.0,1.0,1260,1.0,0,0,1260,0,1968,300000.0
3.0,1.75,2280,1.0,0,0,2280,0,1977,413000.0
3.0,2.25,1740,1.0,0,0,1240,500,1958,435000.0
4.0,2.75,2630,1.0,0,0,1690,940,1976,500000.0
4.0,1.75,2430,1.0,0,0,1430,1000,1953,402000.0
3.0,2.5,2260,1.5,0,0,2260,0,1995,777700.0
2.0,1.5,1220,1.0,0,2,1220,0,1938,580000.0
3.0,1.75,2580,1.0,0,0,1390,1190,1986,570000.0
2.0,1.0,730,1.0,0,0,730,0,1950,174950.0
2.0,1.0,760,1.0,0,0,760,0,1913,300000.0
3.0,1.5,1740,1.0,0,0,1600,140,1950,435000.0
4.0,2.5,3420,2.0,0,0,3420,0,2000,840000.0
5.0,2.5,2240,1.0,0,0,1140,1100,1966,469000.0
4.0,1.75,1920,2.0,0,0,1920,0,1907,870000.0
4.0,1.75,2020,1.0,0,0,1430,590,1979,532000.0
4.0,1.5,1880,1.0,0,0,1280,600,1955,455000.0
3.0,1.0,1010,1.0,0,0,1010,0,1961,201000.0
5.0,3.25,3990,2.0,0,0,2400,1590,1991,649000.0
2.0,1.75,1390,1.0,0,0,720,670,1941,445500.0
3.0,2.0,1230,1.0,0,0,1230,0,1984,475000.0
4.0,2.5,2940,2.0,0,0,2940,0,1992,590000.0
4.0,1.5,2190,2.0,0,0,2190,0,1935,565000.0
1.0,1.0,640,1.0,0,0,640,0,1920,110000.0
3.0,2.5,1670,1.0,0,0,1130,540,1974,375000.0
3.0,1.5,1240,1.0,0,0,1240,0,1967,255000.0
5.0,1.75,1850,1.5,0,0,1760,90,1937,315000.0
4.0,2.25,2020,1.0,0,0,1350,670,1961,496600.0
3.0,1.0,1020,1.0,0,0,1020,0,1944,380000.0
3.0,1.75,1610,1.0,0,0,1610,0,1974,338950.0
5.0,3.5,2730,1.0,0,0,1530,1200,1989,542500.0
5.0,2.5,2840,1.0,0,0,1620,1220,1913,739000.0
4.0,1.75,1290,2.0,0,0,1290,0,1906,549000.0
3.0,2.25,1670,1.0,0,0,1190,480,1977,252000.0
4.0,4.5,3860,2.0,0,4,2940,920,2004,1698890.0
4.0,1.75,2460,1.5,0,0,1450,1010,1909,735000.0
4.0,2.5,1660,1.0,0,0,1660,0,1978,270000.0
3.0,2.5,3420,1.0,0,0,2890,530,1951,2250000.0
2.0,1.0,1010,1.5,0,0,1010,0,1990,155000.0
4.0,2.5,2240,1.0,0,0,1520,720,1961,469000.0
4.0,2.25,2340,2.0,0,0,2340,0,1965,305000.0
3.0,1.75,1920,1.0,0,0,960,960,1924,675000.0
3.0,2.5,2460,1.5,0,0,1560,900,1929,931000.0
3.0,1.0,1470,1.0,0,0,1470,0,1950,385000.0
3.0,2.5,3400,2.0,0,0,3400,0,2001,815000.0
3.0,2.25,1910,1.0,0,0,1910,0,1979,531000.0
4.0,1.0,1400,1.0,0,0,700,700,1901,386500.0
3.0,1.75,1520,1.0,0,0,1520,0,1983,475580.0
2.0,1.0,930,1.0,0,0,930,0,1939,358000.0
5.0,1.0,2340,2.0,0,0,1810,530,1918,677500.0
3.0,2.5,2920,3.0,0,0,2920,0,2008,868500.0
3.0,1.75,1270,1.0,0,0,1270,0,1967,599380.0
4.0,2.25,2450,1.0,0,0,2450,0,1979,712000.0
5.0,1.75,1380,1.0,0,0,1180,200,1955,350000.0
4.0,2.0,2520,1.0,0,0,1400,1120,1921,875000.0
3.0,2.25,2290,2.0,0,0,2290,0,1988,365000.0
4.0,2.0,1660,1.0,0,0,850,810,1945,452000.0
3.0,2.75,2800,1.0,0,0,1400,1400,1957,915000.0
3.0,2.5,1690,2.0,0,0,1690,0,2005,482500.0
3.0,1.0,1180,1.5,0,0,1180,0,1949,425000.0
2.0,1.75,1390,1.0,0,0,790,600,1916,460000.0
4.0,2.0,2320,1.5,0,0,1620,700,1913,666570.0
3.0,2.25,2270,1.0,0,0,1740,530,1980,390000.0
4.0,1.75,2640,1.0,0,0,1500,1140,1966,650000.0
3.0,2.0,1680,1.0,0,0,1680,0,1993,305000.0
3.0,1.0,990,1.0,0,0,990,0,1949,250000.0
4.0,2.5,2770,2.0,0,0,2770,0,2004,438800.0
2.0,1.0,950,1.0,0,0,950,0,1943,290000.0
4.0,2.0,2160,2.0,0,0,1290,870,1929,324950.0
3.0,2.5,1650,2.0,0,0,1270,380,1991,453000.0
3.0,1.0,1800,1.5,0,0,1160,640,1929,556000.0
3.0,2.0,1660,1.0,0,0,1660,0,1971,315000.0
3.0,2.5,1870,2.0,0,0,1870,0,2003,445830.0
3.0,3.5,3220,2.0,0,4,2760,460,1991,1260000.0
3.0,3.0,1850,1.0,0,0,1090,760,1992,287200.0
4.0,1.5,1580,1.5,0,0,1290,290,1945,525000.0
4.0,4.25,4590,2.0,0,0,3160,1430,2003,1135000.0
3.0,1.75,2700,1.0,0,0,1510,1190,1967,381000.0
3.0,1.75,1020,1.5,0,0,1020,0,1953,360000.0
5.0,3.5,2950,3.0,0,0,2950,0,2004,619000.0
2.0,1.75,1780,1.0,0,0,1780,0,1976,535000.0
2.0,1.0,710,1.0,0,0,710,0,1905,402000.0
4.0,3.5,4300,2.0,0,0,2710,1590,1992,600000.0
3.0,2.5,2080,1.0,0,0,1430,650,1974,549950.0
4.0,2.0,2360,1.0,0,0,1180,1180,1955,300000.0
6.0,2.0,2210,2.0,0,0,2210,0,1969,360000.0
7.0,3.25,4340,2.0,0,0,2550,1790,1986,419000.0
3.0,3.0,1320,3.0,0,0,1320,0,2009,510000.0
3.0,2.5,1980,2.0,0,0,1980,0,1991,319950.0
5.0,5.0,3960,2.0,0,0,3960,0,1998,1180000.0
4.0,2.5,2130,2.0,0,0,2130,0,2003,381000.0
3.0,2.5,1720,2.0,0,0,1720,0,1992,256900.0
5.0,1.0,1790,1.0,0,0,1350,440,1964,346000.0
2.0,2.25,1390,3.0,0,0,1340,50,2009,465000.0
3.0,2.0,1900,1.0,0,0,1500,400,1973,545000.0
2.0,1.75,1640,1.0,0,0,910,730,1925,516000.0
4.0,2.5,2700,1.0,0,0,1440,1260,1968,550000.0
4.0,2.25,2200,2.0,0,0,2200,0,1990,339950.0
3.0,1.0,1310,1.0,0,0,1310,0,1953,417000.0
4.0,2.5,2480,1.0,0,3,1480,1000,1951,906000.0
4.0,2.25,3010,2.0,0,0,3010,0,1973,980000.0
4.0,2.5,2450,2.0,0,0,2450,0,2001,555000.0
2.0,1.75,1250,1.0,0,0,1250,0,1986,468000.0
3.0,1.75,2610,1.0,0,0,1390,1220,1981,378000.0
4.0,2.5,2010,1.5,0,0,2010,0,1962,430000.0
4.0,2.5,3120,2.0,0,0,3120,0,2003,730100.0
4.0,1.5,1370,1.5,0,0,1370,0,1961,219000.0
3.0,2.5,2420,1.0,0,0,2420,0,1990,570000.0
4.0,2.75,1500,1.0,0,0,1060,440,1979,262500.0
5.0,2.5,2630,2.0,0,0,2630,0,2003,525000.0
2.0,1.0,950,1.0,0,0,950,0,1919,520000.0
3.0,3.0,2680,1.0,0,0,2680,0,1970,417400.0
4.0,3.25,3680,2.0,0,0,2840,840,2003,788000.0
3.0,1.0,1270,1.0,0,2,1270,0,1956,320000.0
6.0,1.0,2330,1.5,0,0,2330,0,1920,950000.0
3.0,1.0,960,1.0,0,0,960,0,1955,255000.0
4.0,2.5,1990,2.0,0,0,1990,0,1989,260000.0
3.0,1.0,1450,1.0,0,0,1150,300,1923,394000.0
4.0,2.5,2280,2.0,0,0,2280,0,1996,575000.0
4.0,2.25,1830,2.0,0,2,1750,80,1923,1250000.0
3.0,2.25,1650,1.0,0,0,1260,390,1969,385000.0
5.0,2.75,2720,1.0,0,4,1700,1020,1968,456000.0
4.0,2.5,1710,1.0,0,0,1110,600,1979,637000.0
5.0,1.5,1420,1.0,0,0,1050,370,1964,485000.0
3.0,1.75,1440,1.0,0,0,960,480,1951,315275.0
2.0,1.5,1280,1.0,0,0,1280,0,1967,252500.0
2.0,1.0,1320,1.0,0,0,1320,0,1966,240000.0
4.0,2.5,2560,1.0,0,0,1760,800,1949,790000.0
3.0,1.0,1480,1.0,0,0,1480,0,1952,310000.0
4.0,2.5,2960,2.0,0,4,2960,0,1985,1250000.0
2.0,1.0,1160,1.0,0,0,740,420,1942,425000.0
3.0,2.5,2110,2.0,0,0,2110,0,2001,548000.0
3.0,2.5,1650,1.0,0,0,1130,520,1986,379880.0
3.0,2.5,1950,2.0,0,0,1950,0,1988,530000.0
3.0,2.25,2600,1.5,0,0,2120,480,1977,695000.0
3.0,1.0,1270,1.5,0,2,1270,0,1928,435000.0
3.0,1.75,1300,1.0,0,0,1300,0,1983,540000.0
3.0,2.25,1790,1.0,0,0,1290,500,1967,425000.0
3.0,2.5,1930,2.0,0,0,1930,0,2005,490000.0
4.0,1.0,1200,1.5,0,0,1200,0,1923,220000.0
4.0,2.5,2050,2.0,0,0,2050,0,2001,540000.0
3.0,1.0,1710,1.0,0,0,1410,300,1946,670000.0
3.0,1.75,2130,1.0,0,0,2130,0,1953,667500.0
3.0,3.5,1700,2.0,0,0,1260,440,2010,585000.0
3.0,1.5,1390,1.0,0,0,1390,0,1976,225000.0
3.0,1.0,1230,1.0,0,0,1230,0,1954,375000.0
3.0,2.0,1490,1.0,0,0,1490,0,1967,335000.0
5.0,3.25,2440,2.0,0,0,1990,450,2014,680000.0
3.0,1.0,970,1.0,0,0,970,0,1950,600000.0
4.0,2.0,1700,1.0,0,0,850,850,1954,161000.0
4.0,2.0,1700,1.0,0,0,850,850,1954,220000.0
3.0,1.75,1720,1.5,0,0,1720,0,1932,420000.0
3.0,1.0,1400,1.5,0,0,1400,0,1909,710000.0
4.0,2.5,2570,1.0,0,0,1570,1000,1958,626000.0
3.0,1.5,1200,1.0,0,0,1200,0,1959,279500.0
4.0,3.5,4390,2.0,0,3,3060,1330,1990,1610000.0
2.0,1.0,1080,1.0,0,0,1080,0,1954,325000.0
4.0,2.25,1860,1.0,0,0,1860,0,1966,380000.0
4.0,2.75,2150,1.0,0,0,1220,930,1979,470000.0
4.0,3.0,2250,2.0,0,0,2250,0,1986,363000.0
4.0,2.25,2050,2.0,0,0,2050,0,1977,245000.0
3.0,1.0,1010,1.0,0,0,1010,0,1902,525000.0
5.0,3.5,5850,2.0,0,2,4670,1180,1978,1700000.0
4.0,2.25,1900,1.0,0,0,1400,500,1963,658500.0
2.0,1.0,1020,1.0,0,4,920,100,1941,680000.0
4.0,2.0,3390,2.0,0,0,3390,0,1987,835000.0
4.0,2.5,1990,2.0,0,0,1680,310,2005,595000.0
4.0,2.5,3190,2.0,0,0,3190,0,2005,419000.0
2.0,1.0,1210,1.0,0,0,1210,0,1940,198900.0
4.0,3.25,3740,1.0,0,0,2000,1740,1988,1085000.0
3.0,3.5,2150,2.0,0,0,1610,540,1998,500000.0
4.0,1.75,2440,1.0,0,0,1620,820,1960,575000.0
2.0,1.5,1230,3.0,0,0,1230,0,2000,324950.0
3.0,2.5,2740,2.0,0,0,2740,0,1964,259000.0
2.0,2.0,2260,1.0,0,0,2260,0,1990,551000.0
2.0,1.5,1000,1.0,0,0,1000,0,1942,488000.0
4.0,2.25,2350,2.0,0,0,2350,0,1980,635000.0
3.0,2.5,2300,2.0,0,0,2300,0,1989,395000.0
3.0,1.0,1440,1.5,0,0,1440,0,1928,370000.0
4.0,3.0,2780,1.5,0,0,1710,1070,1919,675000.0
3.0,1.0,1200,1.0,0,0,1200,0,1954,402000.0
3.0,2.75,3040,2.0,0,0,3040,0,1987,825000.0
3.0,2.75,2660,1.0,0,0,1330,1330,1962,579000.0
5.0,2.0,1510,2.0,0,0,1510,0,1983,455000.0
3.0,2.5,1780,2.0,0,0,1780,0,1989,265000.0
5.0,2.75,2920,1.0,0,0,1520,1400,1976,713500.0
3.0,1.0,1550,1.0,0,0,1550,0,1962,240000.0
4.0,3.0,2710,2.5,0,0,2710,0,2006,570000.0
3.0,1.0,1140,1.0,0,0,1140,0,1981,243800.0
2.0,1.0,940,1.0,0,0,940,0,1918,543000.0
3.0,2.25,2160,2.0,0,0,2160,0,1982,1010000.0
4.0,2.25,2470,2.0,0,0,2470,0,1979,625000.0
4.0,2.5,2800,2.0,0,0,2800,0,2006,459950.0
4.0,2.75,2420,1.0,0,0,2420,0,1985,370000.0
4.0,2.0,1460,1.0,0,0,1460,0,1959,150000.0
3.0,1.5,1820,1.5,0,0,1640,180,1946,683500.0
3.0,2.5,1520,2.0,0,0,1040,480,2007,499950.0
2.0,1.0,1320,1.0,0,0,940,380,1919,255000.0
3.0,2.5,1920,2.0,0,0,1920,0,1989,279000.0
5.0,3.0,2640,2.0,0,0,2640,0,2009,910000.0
4.0,2.5,2650,2.0,0,0,2650,0,2006,699000.0
4.0,3.25,3640,1.0,0,0,2570,1070,1924,1651000.0
3.0,1.0,1420,1.0,0,0,1090,330,1981,248000.0
3.0,1.0,1540,1.0,0,0,1090,450,1959,429000.0
4.0,1.0,1550,1.5,1,4,1370,180,1930,685000.0
2.0,1.0,730,1.0,0,0,730,0,1927,316000.0
2.0,1.0,2020,1.0,0,0,1010,1010,1921,410000.0
3.0,1.0,1200,1.0,0,2,1200,0,1955,299000.0
2.0,1.0,1240,1.0,0,1,1060,180,1938,559000.0
3.0,2.25,2680,2.0,0,0,1580,1100,1978,575000.0
3.0,2.5,1640,2.0,0,0,1640,0,1998,602000.0
4.0,2.0,1640,2.0,0,0,1640,0,1907,492000.0
3.0,2.5,1610,2.0,0,0,1610,0,2004,293500.0
3.0,2.75,2290,1.0,0,0,1400,890,1967,481000.0
4.0,2.25,2130,1.0,0,0,1380,750,1977,311100.0
3.0,1.75,2140,1.5,0,0,1620,520,1970,375000.0
3.0,3.0,4020,1.5,0,2,4020,0,1999,1075000.0
5.0,2.5,2030,1.0,0,0,1330,700,1968,500000.0
3.0,1.0,1380,1.0,0,0,1380,0,1918,553000.0
3.0,2.0,1780,1.0,0,2,1400,380,1927,760000.0
4.0,1.5,1440,1.0,0,1,960,480,1960,589500.0
5.0,2.75,2790,1.0,0,0,1680,1110,1959,840000.0
4.0,3.0,4190,2.5,0,2,3490,700,1928,2546000.0
3.0,2.5,3870,2.0,0,3,3870,0,1997,1275000.0
3.0,2.5,1850,1.0,0,0,1250,600,1968,260000.0
3.0,2.25,1550,3.0,0,0,1550,0,2004,430000.0
3.0,2.5,1920,3.0,0,3,1920,0,2000,781000.0
2.0,1.0,790,1.0,0,0,790,0,1947,280000.0
5.0,2.25,3740,1.5,0,0,2240,1500,1958,392000.0
3.0,1.5,1340,1.0,0,0,1340,0,1959,466200.0
3.0,1.75,1620,1.0,0,0,940,680,1926,641000.0
3.0,1.0,1680,1.0,0,0,840,840,1951,350000.0
3.0,2.0,1610,2.0,0,0,1610,0,1996,450000.0
4.0,3.5,4460,1.0,0,0,2550,1910,1962,1800000.0
3.0,1.5,1200,2.0,0,0,1200,0,1966,185000.0
2.0,1.0,1250,1.0,0,0,1250,0,1958,290000.0
3.0,2.5,3630,2.0,0,0,3630,0,1999,964000.0
4.0,3.0,4260,2.0,0,2,4260,0,2000,2000000.0
3.0,2.5,2180,1.0,0,0,1850,330,1979,545000.0
3.0,2.25,1760,1.0,0,0,1330,430,1979,609950.0
4.0,2.0,1820,1.0,0,0,990,830,1941,605000.0
4.0,2.5,2120,1.0,0,0,1450,670,1961,550000.0
4.0,2.75,2730,2.0,0,1,2730,0,2009,905000.0
3.0,2.5,2430,2.0,0,0,2430,0,1986,384200.0
3.0,1.0,1170,1.0,0,0,1170,0,1965,370000.0
3.0,1.0,2090,1.5,0,2,1890,200,1931,717500.0
4.0,3.25,3910,2.0,0,2,2550,1360,1933,1999000.0
2.0,1.0,1140,1.0,0,0,1140,0,1909,365500.0
2.0,1.5,1460,1.5,0,0,1460,0,1912,580000.0
4.0,1.5,2700,1.5,0,0,2700,0,1940,415000.0
2.0,1.0,670,1.0,0,0,670,0,1942,272000.0
3.0,1.75,1880,1.0,0,0,1040,840,1945,600000.0
4.0,3.0,1980,2.5,0,0,1980,0,1941,744000.0
3.0,3.0,2080,1.5,0,0,2080,0,2004,830000.0
3.0,3.25,1380,3.0,0,0,1380,0,2000,322000.0
3.0,2.5,1808,1.0,0,0,1808,0,2005,270000.0
3.0,1.0,1350,1.5,0,0,1350,0,1954,272450.0
3.0,3.0,1760,2.0,0,0,1400,360,2008,605000.0
3.0,1.75,1950,1.0,0,0,1950,0,1962,510000.0
4.0,3.5,3170,2.0,0,0,2340,830,1999,1125000.0
4.0,2.5,3000,2.0,0,0,3000,0,1937,1688000.0
4.0,1.0,1460,1.0,0,0,1460,0,1975,162000.0
3.0,1.75,1350,1.0,0,0,1050,300,1973,337500.0
3.0,2.25,1470,1.0,0,0,1180,290,1973,312000.0
4.0,3.0,3350,2.0,0,0,3350,0,2004,740000.0
4.0,3.0,3350,2.0,0,0,3350,0,2004,700000.0
4.0,1.0,1360,1.0,0,0,1360,0,1948,328000.0
3.0,1.0,1020,1.0,0,0,1020,0,1981,241000.0
3.0,2.25,1840,1.0,0,0,1270,570,1980,265000.0
5.0,1.75,2030,1.0,0,0,2030,0,1958,246000.0
4.0,1.75,1490,1.0,0,0,970,520,1940,271000.0
2.0,1.0,2060,1.0,0,0,1260,800,1962,270000.0
4.0,2.0,2240,1.5,0,0,2240,0,1944,395000.0
3.0,2.0,1460,1.0,0,0,1460,0,1957,340000.0
3.0,1.75,2140,1.0,0,0,1240,900,1948,340000.0
2.0,2.25,1420,2.0,0,0,1420,0,2007,335000.0
2.0,1.0,1060,1.5,0,0,1060,0,1943,435000.0
4.0,1.75,1760,1.0,0,0,880,880,1926,527950.0
2.0,2.25,2320,2.0,1,4,2320,0,1976,600000.0
3.0,1.75,1770,1.0,0,0,1300,470,1963,667000.0
10.0,5.25,4590,1.0,0,2,2500,2090,2008,1148000.0
3.0,2.5,2040,2.0,0,0,2040,0,2000,417000.0
4.0,1.75,1260,1.0,0,0,1260,0,1943,451000.0
2.0,1.0,1650,1.0,0,0,950,700,1943,580000.0
4.0,2.25,2380,2.0,0,0,2380,0,1977,570000.0
5.0,3.25,2750,2.0,0,1,2150,600,1937,750000.0
3.0,2.5,2810,2.0,0,0,2810,0,2001,685000.0
3.0,2.0,1340,1.0,0,0,1340,0,1944,275000.0
3.0,2.5,2420,2.0,0,4,1690,730,1989,739888.0
2.0,2.5,2160,1.0,0,0,2160,0,2002,715000.0
4.0,2.0,2450,1.0,0,0,1450,1000,1913,800000.0
3.0,1.5,1870,1.0,0,0,1120,750,1923,350000.0
3.0,1.0,1000,1.0,0,2,1000,0,1933,220000.0
3.0,2.5,2240,2.0,0,0,2240,0,2002,452500.0
4.0,2.5,2200,2.0,0,0,2200,0,2008,280000.0
1.0,1.0,790,1.0,0,0,790,0,1918,248000.0
2.0,1.0,890,1.0,0,0,740,150,1949,305000.0
3.0,1.0,1270,1.0,0,0,1120,150,1954,435010.0
3.0,1.75,1850,1.5,0,0,1210,640,1931,678100.0
3.0,2.25,1352,3.0,0,0,1352,0,2007,325000.0
3.0,2.0,1540,1.0,0,0,1180,360,1968,529950.0
3.0,1.75,1640,1.0,0,0,1640,0,1951,440000.0
3.0,1.0,1350,1.5,0,0,1350,0,1928,585000.0
3.0,2.5,2010,2.0,0,0,1390,620,2014,462608.0
3.0,1.75,2080,1.0,0,0,1040,1040,1974,350500.0
3.0,1.0,1040,1.0,0,0,1040,0,1956,210000.0
3.0,2.5,1890,2.0,0,0,1890,0,1993,510000.0
3.0,2.25,1810,1.0,0,0,1810,0,1959,280000.0
3.0,1.75,1930,1.0,0,0,1130,800,1963,385000.0
3.0,1.0,1010,1.0,0,0,1010,0,1947,349000.0
3.0,2.25,1740,1.0,0,0,910,830,1981,252000.0
4.0,2.5,2910,2.0,0,1,1940,970,1932,1100000.0
3.0,2.25,1330,2.0,0,0,1330,0,1985,375000.0
4.0,2.25,2210,2.0,0,0,2210,0,1967,336000.0
3.0,3.75,2670,2.5,0,4,2020,650,1977,732000.0
2.0,1.0,1000,1.0,0,0,1000,0,1949,200000.0
4.0,2.5,3150,2.0,0,0,3150,0,2006,681716.0
3.0,1.75,1520,1.0,0,0,1520,0,1971,235000.0
3.0,1.0,1690,1.0,0,0,1210,480,1955,257500.0
3.0,1.0,1070,1.0,0,0,1070,0,1955,315000.0
3.0,1.0,910,1.0,0,0,740,170,1950,299950.0
4.0,2.25,2130,1.0,0,0,1430,700,1969,530000.0
2.0,1.75,2230,1.0,0,0,1530,700,1947,766500.0
4.0,2.5,3560,1.0,0,2,2290,1270,1986,860000.0
3.0,2.5,2590,2.0,0,0,2590,0,1944,690000.0
4.0,1.75,2040,1.0,0,0,1020,1020,1962,551000.0
3.0,2.75,2100,1.0,0,0,2100,0,1955,530000.0
3.0,1.0,1340,1.5,0,0,1340,0,1953,568000.0
3.0,2.5,2770,2.0,0,2,2770,0,1992,749950.0
3.0,2.5,2400,1.0,0,0,2400,0,1983,535000.0
3.0,1.0,1140,1.0,0,0,1140,0,1963,234300.0
2.0,1.0,930,1.0,0,0,930,0,1946,190000.0
4.0,1.75,1820,1.0,0,0,1820,0,1960,525000.0
4.0,1.0,1390,1.5,0,0,1390,0,1926,610000.0
3.0,2.5,1480,3.0,0,0,1480,0,2006,520000.0
2.0,1.0,760,1.0,0,0,760,0,1942,375000.0
3.0,1.75,1580,1.0,0,0,1150,430,1967,600000.0
4.0,2.5,1870,1.0,0,0,1250,620,1974,664000.0
2.0,1.0,1510,1.0,0,0,1010,500,1923,698000.0
3.0,2.0,1250,3.0,0,0,1250,0,2001,418000.0
3.0,1.75,2140,1.0,0,0,1460,680,1974,271675.0
3.0,1.0,1540,1.0,0,0,1540,0,1968,450000.0
3.0,2.25,2950,1.5,0,0,2950,0,2006,759000.0
6.0,3.0,2020,1.0,0,0,1230,790,1994,599950.0
4.0,2.75,2820,1.5,0,0,2170,650,1927,810000.0
3.0,1.75,1660,1.0,0,0,1660,0,1972,331292.0
3.0,1.75,1830,1.0,0,0,930,900,1919,348000.0
2.0,1.0,720,1.0,0,0,720,0,1920,435000.0
3.0,2.5,2160,2.0,0,0,2160,0,1992,530000.0
3.0,1.75,1510,2.0,0,0,1510,0,1989,227000.0
3.0,1.5,1870,1.0,0,0,1870,0,1953,285000.0
4.0,2.25,2860,1.0,0,0,1640,1220,1977,740000.0
3.0,1.0,990,1.5,0,0,990,0,1939,246000.0
3.0,1.0,1910,1.0,0,0,1080,830,1954,260000.0
3.0,2.0,1350,1.0,0,0,1350,0,1977,366000.0
4.0,3.25,2557,2.0,0,2,2557,0,1948,594950.0
3.0,2.75,2610,2.0,0,0,1710,900,1946,608000.0
3.0,2.0,1720,1.0,0,0,1720,0,1905,313100.0
3.0,1.75,1170,1.0,0,0,1170,0,1967,185000.0
2.0,1.0,1140,1.0,0,0,1140,0,1907,455000.0
3.0,2.5,2350,1.0,0,0,1570,780,1966,235000.0
3.0,1.0,1020,1.0,0,0,1020,0,1967,230000.0
4.0,2.25,2730,1.0,0,0,1460,1270,1955,770000.0
4.0,2.25,1830,2.0,0,0,1830,0,1991,240000.0
3.0,2.5,1690,2.0,0,0,1690,0,2002,461000.0
4.0,2.5,2900,1.0,0,3,1450,1450,1963,1580000.0
4.0,4.5,6380,2.0,0,0,6380,0,2006,1822500.0
3.0,2.5,1690,2.0,0,0,1690,0,2004,452000.0
4.0,2.5,2660,2.0,0,2,2660,0,2003,765000.0
4.0,4.0,4550,1.0,0,1,2300,2250,1989,1050000.0
3.0,3.0,1530,1.0,0,0,1150,380,1983,546000.0
3.0,2.5,2070,1.5,0,0,1780,290,1931,781000.0
4.0,1.75,1880,1.0,0,0,1880,0,1965,538000.0
4.0,2.5,2240,1.0,0,0,1470,770,1975,790000.0
4.0,2.75,2540,1.5,0,0,1630,910,1925,696500.0
3.0,2.0,1370,1.0,0,0,1370,0,1988,276000.0
2.0,1.0,770,1.0,0,0,770,0,1953,269000.0
5.0,4.75,7880,2.0,0,2,7880,0,1996,2415000.0
4.0,2.75,2970,1.0,0,2,1610,1360,1973,829000.0
2.0,1.0,740,1.0,0,0,740,0,1942,122000.0
3.0,1.5,1360,1.0,0,0,1360,0,1955,352500.0
4.0,2.0,1280,1.0,0,0,1280,0,1959,249000.0
4.0,2.0,1920,1.0,0,0,1080,840,1962,360000.0
3.0,2.0,2020,1.0,0,0,2020,0,1994,629500.0
4.0,2.25,3310,2.0,0,0,3310,0,1924,1140000.0
2.0,2.25,2950,1.0,0,0,1560,1390,1942,1550000.0
3.0,1.5,1320,1.0,0,0,1320,0,1959,275000.0
4.0,2.5,3160,2.0,0,0,3160,0,2005,697000.0
2.0,1.0,1640,1.0,0,0,840,800,1978,379500.0
3.0,2.75,2440,1.0,0,0,1640,800,1980,720000.0
4.0,2.5,3000,2.0,0,0,3000,0,2006,675000.0
5.0,2.5,2810,2.5,0,0,2810,0,1907,1169000.0
3.0,2.0,2390,2.0,0,1,2390,0,1939,1100000.0
4.0,1.0,2080,1.5,0,0,1260,820,1926,520000.0
3.0,1.75,2650,1.5,0,0,1590,1060,1962,415000.0
3.0,2.5,1060,2.0,0,0,1060,0,2000,415000.0
3.0,2.25,1940,1.0,0,1,1220,720,1963,450000.0
2.0,1.0,1080,1.0,0,0,1080,0,1948,485000.0
3.0,2.25,1700,2.0,0,0,1700,0,1984,294000.0
4.0,3.5,4440,2.0,0,0,4440,0,2003,1037000.0
3.0,1.0,1580,2.0,0,0,1580,0,1905,690000.0
5.0,2.75,3630,2.0,0,0,3630,0,2000,716500.0
2.0,2.25,1290,3.0,0,0,1290,0,2007,481000.0
4.0,2.75,1960,1.0,0,0,1000,960,1968,575000.0
3.0,2.0,2090,1.5,0,0,2090,0,1920,785000.0
3.0,1.75,1960,1.0,0,0,1960,0,1970,480000.0
3.0,2.25,2120,2.0,0,0,2120,0,1981,720000.0
3.0,2.75,2290,2.0,0,3,2290,0,1984,536000.0
4.0,2.5,1880,2.0,0,0,1880,0,2000,324900.0
2.0,1.0,770,1.0,0,0,770,0,1943,265000.0
3.0,2.5,1530,1.5,0,0,1010,520,1928,545000.0
2.0,1.5,1450,1.0,0,0,1450,0,1940,465000.0
3.0,2.25,1690,2.0,0,0,1690,0,1987,292500.0
4.0,1.75,1880,1.5,0,0,1880,0,1924,860000.0
4.0,3.25,4160,2.0,0,0,4160,0,1995,1045000.0
4.0,2.5,2140,2.0,0,0,2140,0,2003,495000.0
2.0,2.0,1320,3.0,0,0,1320,0,1997,342000.0
4.0,2.5,2000,2.0,0,0,2000,0,1997,320000.0
3.0,2.0,1460,2.0,0,0,1460,0,1987,444000.0
4.0,2.5,3070,2.0,0,0,3070,0,2005,804100.0
3.0,2.5,1660,1.0,0,0,1660,0,1970,432000.0
6.0,1.5,1810,1.5,0,0,1050,760,1905,230000.0
4.0,3.5,3510,2.0,0,0,3510,0,2001,935000.0
3.0,3.0,2180,1.5,0,0,1410,770,1930,634950.0
6.0,4.0,3300,1.0,0,0,1960,1340,1963,780000.0
4.0,2.5,2460,2.0,0,0,2460,0,1998,611000.0
4.0,1.75,1880,1.5,0,0,1090,790,1944,475999.0
3.0,2.0,2290,1.0,0,0,1670,620,1979,565000.0
4.0,2.5,2290,2.0,0,0,2290,0,1977,630000.0
4.0,3.5,3860,2.0,0,0,3120,740,1996,840000.0
3.0,2.5,2640,1.5,0,3,2640,0,1996,790000.0
5.0,2.5,2850,1.0,0,0,1930,920,1925,450000.0
4.0,3.25,3020,1.5,0,0,1920,1100,1927,1272000.0
3.0,2.0,1510,1.0,0,0,930,580,1925,520000.0
4.0,2.0,2410,1.0,0,0,1260,1150,1958,446800.0
3.0,1.0,1470,1.0,0,0,1200,270,1948,652000.0
3.0,2.75,2890,2.0,0,3,2830,60,1987,1170000.0
4.0,3.25,3490,2.0,0,0,3490,0,2006,745000.0
3.0,2.25,1270,2.0,0,0,1060,210,2014,594000.0
2.0,1.0,1000,1.0,0,0,800,200,1929,257000.0
4.0,1.75,1430,2.0,0,0,1430,0,1900,485000.0
3.0,1.0,1060,1.0,0,0,1060,0,1943,330000.0
3.0,2.0,1680,1.0,0,0,940,740,1996,381000.0
2.0,2.0,2280,2.0,0,0,2280,0,1990,849900.0
4.0,2.5,2450,1.5,0,0,1490,960,1930,793000.0
3.0,2.25,3650,2.0,0,4,2200,1450,1947,920000.0
2.0,1.0,830,1.0,0,0,830,0,1947,455000.0
4.0,2.5,3490,2.0,0,3,3490,0,2000,975000.0
2.0,1.5,1050,2.0,0,0,960,90,2007,375000.0
2.0,2.5,1170,2.0,0,0,1170,0,2001,400000.0
3.0,1.0,1220,1.0,0,0,1220,0,1965,447000.0
3.0,1.75,1310,1.0,0,0,1310,0,1987,470000.0
4.0,2.5,3130,2.0,0,0,3130,0,2004,665000.0
3.0,1.75,1590,1.5,0,0,1290,300,1933,295500.0
4.0,2.5,1720,2.0,0,0,1720,0,1994,200000.0
3.0,2.25,2520,2.0,0,0,1590,930,2005,620000.0
3.0,2.0,1520,1.0,0,0,1140,380,1983,434900.0
4.0,2.25,3260,2.0,0,0,2360,900,1907,1328000.0
4.0,3.25,3910,2.0,0,0,3910,0,2006,1650000.0
4.0,2.5,3480,2.0,0,0,2360,1120,2000,852500.0
3.0,2.5,3040,2.0,0,0,3040,0,1983,790000.0
4.0,1.75,2030,1.0,0,0,2030,0,1966,565000.0
6.0,3.25,3870,2.0,0,0,2520,1350,1989,1127500.0
3.0,2.5,1870,2.0,0,0,1870,0,2004,289950.0
2.0,2.0,2640,1.0,0,1,1640,1000,1963,850000.0
4.0,1.75,1940,1.0,0,0,1030,910,1922,505000.0
3.0,2.5,1710,2.0,0,0,1710,0,1981,372000.0
4.0,2.0,1690,1.5,0,0,1690,0,1967,207000.0
3.0,1.75,2340,1.0,0,0,2340,0,1967,780000.0
4.0,1.75,1700,1.5,0,0,1340,360,1965,400000.0
3.0,1.5,1850,1.0,0,0,1850,0,1948,440250.0
2.0,2.0,1370,1.0,0,0,950,420,1949,585000.0
4.0,2.5,2900,2.0,0,0,2900,0,1993,850000.0
3.0,3.0,2400,2.0,0,0,2400,0,1991,570000.0
4.0,3.0,3740,2.0,0,0,3060,680,1988,869000.0
4.0,2.75,2170,2.0,0,0,2170,0,2014,551000.0
3.0,1.0,970,1.0,0,0,970,0,1962,172380.0
3.0,2.5,2620,1.0,0,3,1310,1310,1964,355000.0
4.0,2.5,2980,2.0,0,0,2980,0,1993,728935.0
3.0,2.5,2340,2.0,0,2,2340,0,1981,850000.0
5.0,1.75,1880,2.0,0,0,1880,0,1922,515000.0
2.0,1.0,1480,1.0,0,0,1120,360,1925,215000.0
4.0,2.5,2240,1.0,0,0,1370,870,1988,220000.0
4.0,2.5,2940,2.0,0,0,2940,0,2004,845000.0
1.0,1.0,710,1.0,0,0,610,100,1928,390000.0
4.0,1.0,1460,1.5,0,0,1460,0,1940,135000.0
3.0,1.0,1530,1.0,0,0,1290,240,1949,439000.0
4.0,2.5,2630,2.0,0,0,2630,0,1999,585000.0
5.0,1.0,2230,1.5,0,3,1700,530,1923,620000.0
3.0,1.0,960,1.0,0,0,960,0,1906,477000.0
2.0,1.5,1180,2.0,0,0,1180,0,2006,399500.0
2.0,1.0,1760,1.0,1,4,1300,460,1951,500000.0
3.0,2.5,1340,2.0,0,0,1340,0,1984,432500.0
4.0,2.25,2800,1.0,0,0,1650,1150,1965,940000.0
5.0,3.5,4330,1.0,0,4,2090,2240,2008,3168750.0
3.0,2.5,3720,2.0,0,0,3720,0,1982,1080000.0
4.0,2.0,1670,1.0,0,0,1030,640,1977,229999.0
3.0,1.0,1100,1.0,0,0,1100,0,1955,233000.0
3.0,2.5,3240,2.0,0,0,2910,330,2004,600000.0
4.0,1.5,1680,1.0,0,0,1180,500,1965,334000.0
3.0,1.0,1030,1.0,0,0,1030,0,1950,332500.0
3.0,2.5,1630,1.0,0,0,1120,510,1978,249900.0
3.0,2.0,2610,1.0,0,0,1670,940,1918,310000.0
2.0,1.0,1250,1.0,0,0,1250,0,1928,200000.0
4.0,1.75,1480,1.0,0,0,1480,0,1969,310000.0
3.0,1.0,1390,1.0,0,0,1390,0,1954,230000.0
4.0,2.5,1940,2.0,0,0,1940,0,1997,420000.0
4.0,2.5,2960,2.0,0,0,2960,0,2005,785000.0
3.0,2.25,4320,1.0,0,0,2160,2160,1972,1775000.0
5.0,1.5,1500,1.0,0,0,760,740,1920,265000.0
2.0,1.0,840,1.0,0,0,840,0,1951,295000.0
4.0,2.5,3560,2.0,0,0,3560,0,1992,896000.0
4.0,2.75,2390,1.0,0,0,1390,1000,1989,415000.0
3.0,1.75,1200,1.0,0,0,1200,0,1955,250000.0
3.0,2.5,2570,2.0,0,0,2570,0,1984,1475000.0
5.0,2.25,2180,1.0,0,0,1430,750,1966,635000.0
3.0,2.5,3450,2.0,0,0,3450,0,1987,905000.0
3.0,2.5,2020,2.0,0,0,2020,0,2003,528000.0
3.0,2.5,2480,2.0,0,0,2480,0,1992,530000.0
3.0,1.5,1140,2.0,0,0,1140,0,1988,310000.0
3.0,1.0,1530,1.0,0,0,1530,0,1960,252000.0
3.0,2.0,1700,1.0,0,0,1120,580,1961,334500.0
3.0,1.0,2150,1.0,0,0,1610,540,1951,370000.0
3.0,2.0,1190,1.5,0,0,1190,0,1918,311000.0
3.0,2.75,1730,2.0,0,2,1480,250,1975,260000.0
3.0,1.75,1400,1.0,0,0,1400,0,1984,217500.0
3.0,2.5,2200,2.0,0,0,2200,0,2003,290000.0
3.0,1.5,960,1.0,0,0,960,0,1944,500000.0
3.0,2.0,1770,1.0,0,3,1100,670,1984,423500.0
4.0,2.5,2970,2.0,0,0,2970,0,2005,715000.0
3.0,2.5,1590,2.0,0,0,1590,0,1994,299000.0
3.0,2.5,3350,2.0,0,0,2550,800,2005,635000.0
4.0,2.5,3370,2.0,0,0,3370,0,1999,806000.0
3.0,2.5,1960,2.0,0,0,1960,0,2004,289950.0
3.0,1.75,1360,1.0,0,0,1360,0,1981,280000.0
3.0,2.5,2780,2.0,0,0,2780,0,2004,479950.0
4.0,2.5,3000,2.0,0,0,3000,0,2002,394000.0
4.0,2.5,3600,2.0,0,0,3400,200,1979,682000.0
2.0,1.0,990,1.0,0,0,990,0,1918,409950.0
4.0,3.5,2990,2.0,0,4,2000,990,1925,1000000.0
4.0,1.0,1200,1.5,0,2,1200,0,1908,436000.0
3.0,1.0,1530,1.0,0,0,970,560,1952,279000.0
1.0,1.75,1440,1.0,0,0,720,720,1923,390000.0
3.0,1.75,1940,1.0,1,1,1480,460,1955,635000.0
4.0,2.75,2140,2.0,0,0,2140,0,1990,304400.0
5.0,1.75,2330,1.5,0,0,1360,970,1927,780000.0
4.0,3.5,2734,2.0,0,0,2734,0,1974,520000.0
3.0,1.75,1950,1.0,0,0,1250,700,1978,580000.0
3.0,1.75,1440,1.0,0,0,990,450,1981,274000.0
3.0,2.25,1530,1.0,0,0,1150,380,1980,315000.0
4.0,1.75,1910,1.0,0,0,1910,0,1971,390000.0
5.0,2.0,1750,1.0,0,0,1750,0,1956,340000.0
3.0,2.25,1600,2.0,0,0,1600,0,1983,502000.0
3.0,1.75,1750,1.0,0,0,1750,0,1968,260000.0
2.0,1.0,940,1.0,0,0,940,0,1911,399000.0
2.0,1.0,880,1.0,0,0,880,0,1919,312500.0
3.0,1.75,1650,1.0,0,0,1060,590,1951,370000.0
4.0,3.5,3820,2.0,0,0,3280,540,1990,1240000.0
3.0,1.5,1900,1.0,0,0,1900,0,1967,230000.0
4.0,1.75,3720,1.0,0,3,1960,1760,1947,1275000.0
3.0,1.0,1410,1.5,0,0,1210,200,1925,294350.0
3.0,1.0,960,1.0,0,0,960,0,1956,208950.0
2.0,1.75,1930,1.0,0,0,1930,0,2005,515000.0
4.0,2.5,3420,2.0,0,0,3420,0,1994,965000.0
4.0,2.75,3010,2.0,0,2,2240,770,1923,925000.0
4.0,1.0,1780,1.5,0,0,1780,0,1947,654500.0
4.0,2.5,2080,1.0,0,0,2080,0,1969,364000.0
2.0,1.0,1250,1.0,0,0,1050,200,1951,150000.0
5.0,3.0,2257,1.0,0,0,1363,894,2005,349950.0
3.0,1.5,1670,1.5,0,0,1670,0,1912,585000.0
4.0,2.25,2250,2.0,0,0,2250,0,1980,801501.0
3.0,1.75,1650,1.0,0,0,1650,0,1992,610000.0
5.0,2.25,2880,2.0,0,0,2880,0,1990,382000.0
4.0,3.0,3620,2.0,0,2,3620,0,1980,495000.0
3.0,1.75,1950,1.0,0,0,1530,420,1953,447500.0
4.0,2.5,2280,1.0,0,0,1290,990,1966,575000.0
2.0,1.75,1740,1.5,0,2,1040,700,1907,565000.0
3.0,1.0,1220,1.0,0,0,1220,0,1966,348580.0
4.0,1.75,2260,1.0,0,0,1660,600,1978,459000.0
4.0,2.0,1790,2.0,0,2,1790,0,1988,375000.0
4.0,2.5,2440,2.0,0,0,2440,0,1999,310000.0
3.0,1.5,1400,1.0,0,0,1400,0,1964,210000.0
3.0,2.75,1810,2.0,0,0,1810,0,2014,384205.0
2.0,1.0,1400,1.0,0,0,900,500,1922,180000.0
2.0,1.0,1400,1.0,0,0,900,500,1922,310000.0
4.0,2.5,2010,2.0,0,0,2010,0,2000,427500.0
3.0,3.0,2520,1.5,0,0,1560,960,1925,780000.0
3.0,2.25,3060,2.0,0,0,3060,0,1988,1762000.0
4.0,2.5,2150,2.0,0,0,2150,0,2010,339950.0
3.0,2.25,2880,2.0,0,0,2880,0,1989,820000.0
2.0,2.0,1300,1.0,0,0,1300,0,2006,398000.0
3.0,1.75,2770,1.0,0,0,1580,1190,1978,492000.0
4.0,1.5,1780,1.0,0,0,1180,600,1950,240000.0
4.0,3.5,3730,2.0,0,2,2440,1290,1991,599950.0
2.0,1.0,930,1.0,0,0,930,0,1932,105500.0
2.0,1.0,930,1.0,0,0,930,0,1932,445000.0
2.0,1.75,1460,1.0,0,0,960,500,1966,390500.0
3.0,2.0,1310,1.0,0,0,1310,0,1994,255000.0
4.0,2.5,2770,2.0,0,0,2770,0,1989,675750.0
3.0,3.25,3140,2.0,0,3,2240,900,1913,1640000.0
4.0,2.5,1770,2.0,0,0,1770,0,2004,353500.0
3.0,1.0,1220,1.0,0,0,1220,0,1954,765000.0
4.0,2.5,2190,2.0,0,0,2190,0,1999,563500.0
4.0,2.0,1800,1.0,0,0,900,900,1942,439000.0
5.0,2.75,3100,1.0,0,2,1660,1440,1973,975000.0
3.0,2.5,2270,2.0,0,0,2270,0,2007,469900.0
3.0,1.0,1300,2.0,0,0,1300,0,1947,252000.0
3.0,2.0,1769,1.0,0,0,1769,0,1955,495000.0
6.0,2.5,3370,1.0,0,0,1770,1600,1964,570000.0
4.0,2.5,1630,2.0,0,0,1630,0,1999,327000.0
2.0,2.25,2470,1.0,0,0,1480,990,1954,898000.0
4.0,2.5,2600,2.0,0,0,2600,0,2003,300000.0
3.0,2.0,1800,1.0,0,0,1220,580,1978,418500.0
4.0,2.5,2240,2.0,0,0,1840,400,2001,450000.0
3.0,2.0,1960,1.0,0,2,1650,310,1957,403000.0
3.0,1.0,1710,1.5,0,0,1200,510,1926,440000.0
4.0,1.75,2140,1.0,0,0,1080,1060,1965,350000.0
3.0,2.0,1400,1.0,0,0,700,700,1948,240000.0
2.0,1.0,890,1.0,0,0,760,130,1919,460000.0
4.0,1.0,1820,2.0,0,0,1820,0,1923,825000.0
3.0,2.25,1860,1.0,0,0,1860,0,1976,267500.0
3.0,1.0,1220,1.0,0,0,1220,0,1972,201000.0
3.0,2.75,2300,2.0,0,0,2300,0,2008,479500.0
2.0,1.0,1520,2.0,0,0,1520,0,1978,210000.0
2.0,1.0,1440,1.0,0,0,960,480,1915,445000.0
3.0,1.75,1170,1.0,0,0,1170,0,1952,265000.0
3.0,1.75,1170,1.0,0,0,1170,0,1952,399000.0
4.0,2.25,3200,2.0,0,0,3200,0,1972,785000.0
5.0,2.5,4470,2.5,0,0,4470,0,1984,831500.0
4.0,2.5,2570,2.0,0,0,2570,0,2009,360000.0
3.0,2.5,2370,2.0,0,0,2370,0,1990,655000.0
4.0,1.5,1800,1.5,0,0,1800,0,1958,449950.0
5.0,2.5,2300,1.0,0,0,1290,1010,1975,612000.0
3.0,2.5,3240,2.0,0,0,3240,0,2001,575000.0
3.0,2.5,2280,1.0,0,0,960,1320,1995,557000.0
4.0,1.75,1870,1.0,0,1,1030,840,1943,375000.0
3.0,2.25,1820,1.0,0,0,1820,0,1969,369000.0
5.0,2.75,2390,1.0,0,0,1290,1100,1966,330000.0
4.0,1.75,2110,1.0,0,3,1410,700,1941,1031000.0
2.0,1.0,980,1.0,0,0,980,0,1910,550000.0
3.0,1.75,1250,1.0,0,0,1250,0,1947,338000.0
4.0,2.5,3680,2.0,0,2,3680,0,1946,1900000.0
3.0,1.0,2230,1.0,0,0,1230,1000,1966,235000.0
1.0,1.0,1230,1.5,0,0,1230,0,1918,349950.0
5.0,2.5,2093,1.5,0,0,2093,0,1963,300000.0
3.0,1.75,1660,1.0,0,0,1660,0,1967,431000.0
5.0,2.5,1630,1.0,0,0,1100,530,1975,280000.0
4.0,2.5,1677,2.0,0,0,1677,0,2011,295000.0
4.0,2.5,2990,2.0,0,0,2990,0,2003,445000.0
5.0,1.0,2150,1.5,0,0,2150,0,1900,550000.0
4.0,2.5,2890,2.0,0,0,2890,0,2003,515000.0
3.0,2.5,3050,1.0,0,0,3050,0,1987,555000.0
3.0,2.5,1410,2.0,0,0,1410,0,2006,265000.0
4.0,2.5,2280,2.0,0,0,1520,760,1921,597000.0
2.0,1.0,1260,1.0,0,0,1260,0,1939,661000.0
3.0,2.0,1460,2.0,0,0,1460,0,2008,362764.0
4.0,2.5,1600,1.0,0,0,1310,290,1950,427000.0
3.0,1.75,2020,1.0,0,0,2020,0,1965,405000.0
3.0,1.5,1170,1.0,0,0,1170,0,1960,157000.0
3.0,1.5,1170,1.0,0,0,1170,0,1960,246500.0
2.0,1.5,1280,1.0,0,0,850,430,1984,386500.0
4.0,2.5,2680,2.0,0,0,2680,0,1999,300000.0
3.0,1.75,1770,1.0,0,0,1270,500,1978,240000.0
5.0,3.5,4790,2.0,0,1,3110,1680,2005,818500.0
3.0,1.75,1300,1.0,0,0,1300,0,1964,249000.0
4.0,2.25,2610,1.0,0,0,1700,910,1977,580000.0
4.0,2.5,4500,1.0,0,0,4500,0,1988,2340000.0
4.0,2.5,2100,2.0,0,0,2100,0,1997,333000.0
2.0,2.0,1340,1.0,0,0,1340,0,1992,230000.0
3.0,1.0,970,1.0,0,3,970,0,1974,360500.0
3.0,1.75,2200,1.0,0,0,1270,930,1962,265000.0
2.0,1.0,990,1.0,0,0,990,0,1941,490000.0
2.0,1.75,1180,1.0,0,0,880,300,1925,600000.0
3.0,1.0,980,1.0,0,0,980,0,1969,307500.0
4.0,2.25,2370,1.0,0,0,1660,710,1976,670000.0
3.0,1.5,1910,1.5,0,0,1910,0,1922,247200.0
4.0,4.5,5270,2.0,1,4,3400,1870,1979,2600000.0
3.0,1.75,1430,1.0,0,0,1430,0,1961,440000.0
4.0,2.5,2490,2.0,0,0,2490,0,1987,700000.0
4.0,2.0,2000,1.5,0,0,2000,0,1917,756100.0
4.0,2.75,2600,1.0,0,0,1620,980,1978,555000.0
5.0,3.5,2880,2.0,0,2,2270,610,2001,830000.0
3.0,1.0,1010,1.0,0,0,1010,0,1990,180000.0
5.0,3.5,3290,2.0,0,0,2670,620,2004,775000.0
4.0,1.75,1530,1.5,0,0,1530,0,1938,220000.0
4.0,2.75,2020,1.0,0,0,1620,400,1967,650000.0
3.0,1.75,1340,1.0,0,0,1340,0,1961,410000.0
4.0,2.5,2180,2.0,0,0,2180,0,2000,339995.0
5.0,1.75,2870,1.0,0,4,1440,1430,1966,1160000.0
3.0,2.75,2070,2.0,0,0,1330,740,1929,440000.0
2.0,1.75,930,1.0,0,0,930,0,1923,275000.0
3.0,2.5,2270,2.0,0,0,2270,0,1988,766000.0
3.0,2.25,1630,1.0,0,0,1130,500,1973,231500.0
3.0,2.0,2770,2.0,0,0,2770,0,2004,472000.0
4.0,2.5,4010,2.0,0,0,4010,0,1990,1325000.0
4.0,1.75,1970,1.0,0,0,1140,830,1955,265000.0
2.0,1.0,790,1.0,0,0,790,0,1948,325000.0
3.0,1.75,1740,1.0,0,0,1040,700,1954,364500.0
2.0,1.0,1130,1.0,0,0,1130,0,1947,322500.0
3.0,1.75,1180,1.0,0,0,1040,140,1929,338900.0
5.0,2.5,2350,2.0,0,0,2350,0,1993,910000.0
5.0,2.5,2350,2.0,0,0,2350,0,1993,1015000.0
3.0,1.75,1850,1.0,0,2,1100,750,1919,459950.0
4.0,3.0,3220,1.5,0,0,3220,0,2009,584950.0
3.0,1.75,2050,1.0,0,0,1520,530,1987,252000.0
3.0,2.5,1430,1.0,0,0,1190,240,1992,270000.0
4.0,2.5,3210,2.0,0,0,3210,0,2005,750000.0
3.0,1.75,3520,1.0,0,4,1530,1990,1960,775000.0
3.0,2.5,2260,2.0,0,0,2260,0,2004,325000.0
5.0,3.25,3290,2.0,0,0,3290,0,2012,810000.0
2.0,2.25,1640,2.0,0,0,1640,0,1974,409000.0
4.0,1.75,1580,1.0,0,0,1130,450,1947,400000.0
4.0,2.25,1940,2.0,0,0,1940,0,1962,530000.0
3.0,2.25,1580,2.0,0,0,1580,0,1987,580000.0
3.0,1.75,1750,1.0,0,1,1300,450,1987,491300.0
4.0,2.75,1810,1.0,0,0,1200,610,1980,272000.0
3.0,2.5,1970,1.0,0,4,1970,0,1985,599950.0
3.0,2.5,1770,2.0,0,0,1770,0,1992,464000.0
3.0,1.75,1800,1.0,0,0,900,900,1905,471001.0
3.0,1.5,1500,1.0,0,0,1100,400,1980,230000.0
3.0,1.0,940,1.0,0,0,940,0,1959,358000.0
3.0,2.25,2340,1.0,0,0,1210,1130,1929,510000.0
3.0,1.0,840,1.0,0,0,840,0,1960,86500.0
3.0,1.0,840,1.0,0,0,840,0,1960,199950.0
3.0,3.25,2940,3.0,0,3,2440,500,1978,1712500.0
3.0,2.75,3180,2.0,0,0,2190,990,1918,850000.0
4.0,2.5,2020,1.5,0,0,1480,540,1928,542000.0
2.0,1.0,820,1.0,0,0,820,0,1937,102500.0
3.0,1.75,4060,1.0,0,0,2810,1250,1995,718000.0
4.0,2.25,2660,1.0,0,0,2180,480,1977,625000.0
3.0,1.0,1010,1.0,0,0,1010,0,1947,350000.0
2.0,1.0,710,1.0,0,0,710,0,1918,216000.0
3.0,1.0,980,1.5,0,0,980,0,1946,340000.0
3.0,1.0,1100,1.5,0,0,1100,0,1908,505000.0
5.0,2.5,2840,2.0,0,0,2840,0,2003,372000.0
4.0,2.25,2300,2.0,0,0,2300,0,1978,263850.0
4.0,3.25,5370,2.0,0,4,5370,0,1990,1350000.0
4.0,2.5,2280,2.0,0,0,2280,0,1987,325000.0
2.0,1.0,1010,1.0,0,0,890,120,1924,289000.0
3.0,2.25,1420,1.0,0,0,1160,260,1987,364000.0
4.0,2.5,2100,1.0,0,0,1250,850,1980,610000.0
4.0,2.75,3110,1.0,0,0,3110,0,1958,531500.0
3.0,2.25,2160,2.0,0,0,2160,0,1979,402500.0
2.0,1.0,820,1.0,0,0,820,0,1922,375000.0
5.0,2.5,4340,1.0,0,0,2170,2170,1979,537500.0
3.0,1.75,2100,1.0,0,0,1440,660,1962,375000.0
4.0,1.75,1250,1.0,0,0,910,340,1979,293550.0
6.0,3.0,3870,2.0,0,0,2700,1170,1976,585000.0
2.0,2.5,1360,2.0,0,0,1360,0,2003,225000.0
4.0,1.0,1400,1.5,0,0,1400,0,1957,185000.0
3.0,1.5,1450,1.0,0,0,1010,440,1968,402000.0
5.0,1.75,1880,1.0,0,0,960,920,1963,585000.0
2.0,2.5,1380,3.0,0,0,1380,0,2006,549000.0
3.0,2.25,2910,1.5,0,0,2510,400,1923,1810000.0
3.0,1.75,1380,1.0,0,0,1380,0,1967,345000.0
3.0,2.25,3100,1.0,0,0,1790,1310,1963,302500.0
4.0,1.75,1400,1.0,0,0,1400,0,1964,218500.0
2.0,2.0,1650,1.5,0,0,1650,0,1916,705000.0
3.0,1.0,840,1.0,0,0,840,0,1969,191000.0
3.0,2.5,2550,2.0,0,0,2550,0,2001,695000.0
2.0,2.75,2820,2.0,0,0,1630,1190,1947,350000.0
3.0,1.75,1710,1.0,0,0,1130,580,1979,480000.0
3.0,1.0,820,1.0,0,0,820,0,1977,220000.0
4.0,2.25,2620,2.0,0,0,2620,0,1977,535000.0
2.0,1.75,2430,1.0,0,4,2430,0,1951,1000000.0
3.0,1.75,1560,1.0,0,0,1560,0,1940,592000.0
4.0,2.5,3060,2.0,0,0,3060,0,2004,775000.0
3.0,2.5,1680,2.0,0,0,1680,0,2003,320000.0
3.0,3.25,3320,2.0,0,0,3320,0,1989,760000.0
3.0,2.5,2390,2.0,0,0,2390,0,1990,640000.0
3.0,1.0,1360,1.0,0,0,1360,0,1953,253200.0
2.0,1.0,1800,1.0,0,0,1800,0,1954,228000.0
3.0,1.0,1160,1.0,0,0,1160,0,1968,325000.0
4.0,3.25,4160,2.0,0,0,2760,1400,1973,530000.0
4.0,2.25,1660,2.0,0,0,1660,0,2011,300000.0
3.0,2.0,1410,1.5,0,0,1410,0,1930,418000.0
4.0,1.75,2230,1.0,0,4,1180,1050,1955,415000.0
3.0,2.5,1700,2.0,0,0,1700,0,2003,384000.0
3.0,2.5,2070,2.0,0,0,2070,0,1997,325000.0
3.0,1.75,2300,1.0,0,2,2300,0,1955,600000.0
4.0,2.25,3040,1.0,0,0,1940,1100,1978,760000.0
2.0,1.5,1220,1.5,0,0,1220,0,1976,168000.0
3.0,1.0,960,1.0,0,0,960,0,1943,405000.0
3.0,1.0,1480,1.0,0,0,1480,0,1956,479000.0
3.0,2.0,1560,1.0,0,0,1150,410,1915,549000.0
3.0,1.5,1100,1.0,0,0,1100,0,1967,215000.0
2.0,1.5,900,1.0,0,2,900,0,1940,550000.0
4.0,1.75,2400,1.5,0,0,1500,900,1927,389000.0
3.0,2.5,2320,2.0,0,0,2320,0,1990,447500.0
5.0,3.0,2570,1.0,0,0,1580,990,2009,540000.0
4.0,2.75,1300,1.0,0,0,1300,0,1983,273500.0
5.0,2.75,2930,2.0,0,0,2930,0,2002,257000.0
2.0,1.0,720,1.0,0,0,720,0,1943,199000.0
4.0,2.5,2350,2.0,0,0,2350,0,1992,339100.0
4.0,2.5,2940,2.0,0,0,2940,0,1991,435000.0
3.0,2.5,2020,1.0,0,0,1010,1010,1910,400000.0
2.0,1.0,1430,1.0,0,0,1010,420,1991,356000.0
3.0,1.0,950,1.0,0,0,950,0,1950,395000.0
2.0,1.0,1250,1.0,0,0,850,400,1911,575000.0
3.0,1.75,1300,1.5,0,0,1300,0,1925,515000.0
4.0,3.25,2520,1.5,0,0,1550,970,1931,618250.0
3.0,1.5,1330,2.0,0,0,1330,0,1968,245000.0
3.0,2.75,2480,1.5,0,0,1890,590,1929,690000.0
5.0,2.25,3020,1.0,0,0,1510,1510,1959,465000.0
3.0,1.75,1770,1.0,0,0,1240,530,1978,280000.0
3.0,1.75,1930,1.0,0,0,1230,700,1960,285000.0
3.0,2.25,1650,2.0,0,0,1650,0,1994,320000.0
4.0,3.0,2580,2.0,0,0,2130,450,1992,355000.0
3.0,2.0,2570,1.5,0,0,2570,0,1965,670000.0
1.0,1.0,2880,1.0,0,0,1440,1440,1925,550000.0
4.0,2.75,2660,1.5,0,0,1860,800,1909,765000.0
3.0,1.0,1560,1.5,0,0,1260,300,1927,430000.0
3.0,2.5,3080,2.0,0,2,3080,0,2000,950000.0
4.0,1.75,2540,1.0,0,0,1270,1270,1947,525000.0
6.0,2.5,3080,1.0,0,0,1580,1500,1985,300000.0
3.0,2.75,2190,2.0,0,0,2190,0,2000,345000.0
3.0,3.75,2930,2.0,0,0,2930,0,1972,838000.0
5.0,2.75,2880,1.0,0,3,1660,1220,1959,1795000.0
3.0,1.75,2160,2.0,0,0,2160,0,1978,390000.0
3.0,2.0,2110,2.0,0,0,2110,0,1979,1150000.0
4.0,2.25,1830,2.0,0,0,1830,0,2003,295000.0
4.0,4.0,3180,2.0,0,0,2530,650,1920,775000.0
3.0,2.5,1880,2.0,0,0,1880,0,1993,380000.0
3.0,1.0,1140,1.0,0,0,1140,0,1959,550000.0
5.0,1.75,1798,1.0,0,0,1798,0,1967,199900.0
3.0,1.75,1670,1.5,0,0,1670,0,1908,329900.0
3.0,2.25,2580,1.0,0,0,2580,0,1964,898000.0
4.0,2.25,3720,1.0,0,2,1860,1860,1970,875000.0
4.0,2.5,2790,2.0,0,0,2790,0,2005,375000.0
3.0,2.5,2190,2.0,0,0,2190,0,2004,365000.0
4.0,2.75,2280,1.5,0,0,1540,740,1930,530000.0
3.0,1.0,1100,1.0,0,0,1100,0,1969,225500.0
4.0,2.25,2180,1.0,0,0,1680,500,1969,318000.0
4.0,2.5,2770,2.0,0,0,2770,0,1986,910000.0
3.0,1.0,1980,1.0,0,0,1280,700,1943,207000.0
5.0,3.5,4180,2.0,0,0,4180,0,2004,1886700.0
6.0,3.0,3030,1.0,0,0,1670,1360,1980,624500.0
3.0,2.5,1690,2.5,0,0,1690,0,2007,640000.0
3.0,2.0,1990,2.0,0,0,1990,0,1986,500000.0
5.0,1.75,2250,1.0,0,0,1500,750,1966,390000.0
3.0,2.25,2080,1.5,0,0,1550,530,2003,284000.0
3.0,2.0,2460,1.0,0,0,2460,0,1988,620000.0
3.0,2.5,2588,2.0,0,0,2588,0,2008,306000.0
4.0,1.75,2570,1.0,0,0,1910,660,1978,495000.0
3.0,2.5,2370,2.0,0,0,2370,0,2001,499950.0
3.0,1.0,1070,1.0,0,0,1070,0,1969,330000.0
3.0,2.0,1940,1.5,0,0,1150,790,1944,665000.0
3.0,2.5,2650,2.0,0,0,1830,820,1920,850000.0
4.0,2.5,2290,2.0,0,0,2290,0,1988,599950.0
4.0,2.5,2050,2.0,0,0,2050,0,1992,360000.0
3.0,2.5,2680,2.0,0,0,2680,0,2001,699000.0
3.0,1.75,1520,1.0,0,0,760,760,1945,475000.0
3.0,2.0,2690,2.0,0,0,2690,0,1992,575000.0
2.0,1.5,1180,2.0,0,0,990,190,2005,345000.0
4.0,2.5,3030,2.0,0,0,3030,0,1989,367950.0
3.0,2.25,1400,2.0,0,0,1400,0,1984,374500.0
4.0,2.5,3000,2.0,0,0,3000,0,1992,607500.0
3.0,1.0,1200,1.0,0,0,1200,0,1971,374000.0
3.0,1.0,1000,1.0,0,0,1000,0,1947,390000.0
4.0,3.25,2740,2.5,0,0,2740,0,2004,705000.0
3.0,2.5,1990,2.0,0,0,1990,0,2004,467000.0
3.0,3.0,2110,1.0,0,0,2110,0,1981,243500.0
3.0,2.75,1830,2.0,0,0,1690,140,2011,593000.0
3.0,1.0,940,1.0,0,0,940,0,1961,223000.0
4.0,2.5,2980,2.0,0,2,2980,0,2003,574000.0
3.0,2.0,2260,1.0,0,0,1130,1130,1986,400000.0
4.0,2.75,3470,1.0,0,0,1750,1720,1962,772000.0
3.0,1.75,1510,1.0,0,0,1510,0,1964,593777.0
4.0,3.5,2710,2.0,0,0,2040,670,1997,539500.0
3.0,2.5,2080,2.0,0,0,2080,0,2006,550000.0
2.0,2.0,1860,1.0,0,0,1260,600,1952,265000.0
3.0,1.75,2120,1.0,0,0,1280,840,1979,428000.0
3.0,2.0,1110,1.0,0,0,1110,0,1951,505000.0
5.0,5.5,5190,2.0,0,2,5190,0,2001,925000.0
3.0,1.75,1520,1.0,0,0,1520,0,1968,230000.0
4.0,2.5,2650,2.0,0,0,2650,0,1990,695000.0
4.0,2.75,3350,2.0,0,2,3350,0,2004,700000.0
3.0,1.75,1770,1.5,0,0,1770,0,1914,712500.0
3.0,2.5,2200,2.0,0,0,2200,0,2005,480000.0
3.0,2.5,2000,1.0,0,0,1300,700,1968,470000.0
3.0,1.75,1730,1.0,0,0,1150,580,1980,335000.0
3.0,1.5,1300,1.0,0,0,900,400,1970,270000.0
5.0,3.25,2950,1.0,0,0,2530,420,1981,810000.0
3.0,3.0,1720,3.0,0,0,1460,260,2006,589000.0
2.0,1.0,880,1.0,0,0,880,0,1951,415000.0
4.0,2.25,1790,1.0,0,0,1220,570,1979,197000.0
3.0,1.5,1380,1.0,0,0,790,590,1971,235500.0
3.0,2.25,1530,2.0,0,0,1240,290,2008,460000.0
5.0,1.75,2330,1.0,0,0,1380,950,1955,572500.0
5.0,2.0,1540,1.0,0,0,1540,0,1960,302000.0
3.0,2.5,3210,2.0,0,0,2530,680,1990,870000.0
3.0,1.0,1130,1.0,0,0,960,170,1939,485000.0
3.0,2.0,1460,1.0,0,0,1460,0,1968,240000.0
3.0,1.75,1410,1.0,0,0,1410,0,1967,383000.0
4.0,2.75,1750,1.5,0,0,1750,0,1903,750000.0
2.0,1.75,1370,1.0,0,0,1370,0,1944,409950.0
3.0,1.5,1780,1.0,0,0,1780,0,1953,246000.0
4.0,1.75,1890,2.0,0,0,1490,400,1937,860000.0
3.0,2.25,1630,2.0,0,0,1630,0,1985,339950.0
5.0,1.75,2320,1.0,0,0,1160,1160,1956,315000.0
3.0,2.5,2580,2.0,0,0,2580,0,2006,698000.0
2.0,2.5,1470,2.0,0,0,1470,0,1985,419000.0
3.0,1.0,2298,1.0,0,0,2298,0,1969,372000.0
3.0,2.5,1960,2.0,0,0,1960,0,2003,425000.0
3.0,2.25,2950,1.5,0,0,1950,1000,1963,386500.0
2.0,1.0,670,1.0,0,0,670,0,1942,348000.0
5.0,3.5,3020,2.0,0,0,2230,790,1978,754000.0
4.0,3.0,2390,2.0,0,0,2390,0,1944,269950.0
3.0,2.5,3090,2.0,0,0,3090,0,1991,891500.0
4.0,1.75,1780,1.0,0,0,890,890,1903,349950.0
2.0,1.0,1420,1.0,0,0,1180,240,1956,360000.0
4.0,2.25,2420,2.0,0,0,2420,0,1925,975000.0
4.0,2.0,1480,1.5,0,0,1480,0,1928,449250.0
4.0,2.25,2190,2.0,0,0,2190,0,2006,350000.0
4.0,1.75,1820,1.5,0,3,1690,130,1911,790000.0
3.0,1.75,1810,1.0,0,4,930,880,1983,990000.0
3.0,2.25,2550,2.0,0,0,2550,0,1983,834000.0
3.0,1.0,1360,1.0,0,0,1060,300,1963,466950.0
3.0,1.75,2259,1.5,0,3,1491,768,1908,262500.0
4.0,2.5,3880,2.0,0,0,3880,0,1987,762300.0
6.0,2.75,2730,1.0,0,0,1780,950,1962,733000.0
4.0,2.5,2800,1.0,0,2,1560,1240,1957,439000.0
5.0,3.25,4290,2.5,0,0,3590,700,1927,1160000.0
3.0,2.5,1770,2.0,0,0,1770,0,1999,420000.0
3.0,2.25,1920,2.0,0,0,1920,0,1981,549000.0
4.0,2.5,2320,1.5,0,0,1510,810,1905,518000.0
4.0,2.5,2961,2.0,0,0,2961,0,1998,695000.0
3.0,2.5,1680,2.0,0,0,1680,0,1988,485000.0
3.0,1.75,1590,1.5,0,0,1590,0,1926,280000.0
2.0,1.0,1420,1.5,0,0,1420,0,1943,306500.0
2.0,1.0,1370,1.0,0,0,1370,0,1950,720000.0
3.0,2.5,2620,2.0,0,3,2620,0,2010,277500.0
3.0,2.0,1810,2.0,1,4,1810,0,1913,649000.0
4.0,3.5,4730,1.0,1,4,2940,1790,1954,3395000.0
2.0,1.0,700,1.0,0,0,700,0,1949,267800.0
4.0,2.75,2390,2.0,0,0,2390,0,1993,625000.0
4.0,2.5,2070,1.5,0,0,1590,480,1924,600000.0
4.0,2.0,1780,1.5,0,0,1780,0,1948,395000.0
4.0,2.5,1900,1.5,0,0,1900,0,1940,212000.0
2.0,1.0,1040,1.0,0,0,940,100,1928,425000.0
4.0,1.75,2370,1.5,0,2,1770,600,1919,870000.0
3.0,2.5,1970,2.0,0,0,1970,0,2004,420000.0
4.0,2.25,2120,2.0,0,0,2120,0,1981,800000.0
3.0,2.5,1960,2.0,0,0,1960,0,1989,575000.0
3.0,3.25,2660,2.0,0,0,2170,490,2003,915000.0
3.0,2.25,1180,2.0,0,0,1180,0,1987,400000.0
3.0,2.5,2390,1.0,0,2,1440,950,1955,750000.0
3.0,1.0,1250,1.0,0,0,1250,0,1961,235000.0
5.0,3.0,2600,1.0,0,0,1300,1300,1967,599950.0
2.0,1.0,940,1.0,0,0,940,0,1929,481203.0
5.0,3.0,3880,2.0,0,0,3880,0,1972,1815000.0
3.0,2.5,1530,2.0,0,0,1530,0,1986,379000.0
3.0,1.75,2430,2.0,0,0,1760,670,1945,626000.0
2.0,1.0,1030,1.0,0,0,920,110,1939,535000.0
4.0,2.5,2740,2.0,0,0,2740,0,1984,1225000.0
2.0,1.5,1180,2.0,0,0,1120,60,2001,410000.0
4.0,2.5,3090,1.0,0,3,1680,1410,1967,940000.0
3.0,1.0,1060,1.0,0,0,1060,0,1967,326250.0
2.0,1.0,790,1.0,0,0,790,0,1944,200000.0
4.0,2.5,3070,1.0,0,0,2100,970,1958,880000.0
2.0,2.0,2100,2.0,0,0,2100,0,2005,370000.0
2.0,2.5,1100,2.0,0,0,1100,0,2006,190000.0
2.0,1.0,1070,1.0,0,0,1070,0,1983,160000.0
4.0,3.0,2190,1.0,0,0,1520,670,1989,625000.0
4.0,3.5,3450,2.0,0,0,2750,700,2004,590000.0
3.0,2.5,2070,2.0,0,0,2070,0,1999,575000.0
2.0,1.0,1190,1.0,0,0,1190,0,1912,470000.0
2.0,1.0,600,1.0,0,0,600,0,1900,130000.0
3.0,1.0,940,1.0,0,0,940,0,1958,229000.0
3.0,1.0,1280,1.5,0,0,1280,0,1942,279900.0
3.0,1.0,1370,1.0,0,0,1370,0,1960,307000.0
3.0,1.75,2450,1.0,0,0,1980,470,1989,399950.0
4.0,2.25,1970,1.0,0,0,1370,600,1962,405000.0
4.0,2.75,2910,1.0,0,0,2130,780,1966,539950.0
2.0,1.0,760,1.0,0,0,760,0,1949,129000.0
3.0,1.75,1270,1.0,0,0,1270,0,1967,340000.0
3.0,1.75,1570,1.0,0,0,1310,260,1977,214950.0
4.0,2.75,2310,1.0,0,2,1330,980,1952,450000.0
3.0,1.75,1900,1.0,0,0,950,950,1925,515000.0
4.0,2.25,3780,2.0,0,0,2510,1270,1907,1400000.0
3.0,1.0,1060,1.0,0,0,1060,0,1956,230000.0
3.0,1.75,1880,1.0,0,0,1880,0,1984,681000.0
3.0,1.0,1160,1.0,0,0,1160,0,1923,255000.0
2.0,1.0,860,1.0,0,0,860,0,1925,580000.0
2.0,2.0,1590,1.0,0,0,910,680,1984,295000.0
2.0,1.0,1170,1.0,0,0,1170,0,1913,286000.0
3.0,1.5,1190,1.0,0,0,830,360,1947,425000.0
2.0,1.0,1300,1.0,0,0,1300,0,1961,170000.0
3.0,2.0,1660,1.0,0,0,1660,0,1949,380000.0
3.0,2.0,1160,1.0,0,0,1160,0,1947,506000.0
3.0,2.5,1950,2.0,0,0,1950,0,1992,315000.0
4.0,2.5,2470,2.0,0,0,2470,0,1999,449950.0
3.0,1.0,1430,1.0,0,0,1430,0,1964,255000.0
3.0,2.5,1970,2.0,0,0,1090,880,1988,289000.0
3.0,1.75,1400,1.0,0,0,1400,0,1962,389000.0
3.0,1.5,1510,1.0,0,2,1510,0,1964,327000.0
7.0,3.0,5350,2.5,0,0,5020,330,1910,2885000.0
3.0,1.0,920,1.0,0,0,920,0,1948,210000.0
4.0,3.75,7620,2.0,0,3,5980,1640,2005,1680000.0
4.0,2.5,2490,2.0,0,0,2490,0,2001,360000.0
4.0,2.5,3030,2.0,0,0,3030,0,1990,875000.0
4.0,2.25,1650,1.0,0,0,1650,0,1967,550000.0
3.0,1.5,1210,1.0,0,0,1210,0,1962,257500.0
4.0,2.75,2990,1.5,0,0,2090,900,1923,1075000.0
2.0,1.0,1060,1.0,0,0,1060,0,1969,202950.0
4.0,1.75,2680,1.0,0,0,1340,1340,1959,622000.0
4.0,1.75,1790,1.0,0,0,1410,380,1976,455000.0
3.0,2.5,2690,2.0,0,3,2690,0,1997,805000.0
2.0,1.0,770,1.0,0,0,770,0,1950,257000.0
5.0,2.5,2700,1.0,0,0,1750,950,1967,744500.0
4.0,2.5,2620,2.0,0,0,2620,0,1996,885000.0
2.0,2.25,930,2.0,0,0,630,300,2007,355000.0
3.0,1.0,1340,1.0,0,0,1340,0,1978,240000.0
3.0,1.5,1470,2.0,0,0,1470,0,1916,169000.0
3.0,2.5,2330,2.0,0,0,2330,0,1992,639900.0
3.0,1.75,1730,1.0,0,0,1730,0,1972,292000.0
4.0,2.5,2780,2.0,0,3,2780,0,2004,563500.0
2.0,2.0,1200,1.0,0,0,1200,0,2006,389000.0
4.0,3.25,4430,2.0,0,0,4430,0,1952,2750000.0
3.0,2.0,1820,2.0,0,0,1820,0,1994,661000.0
2.0,2.0,1300,1.0,0,0,1300,0,2005,344000.0
1.0,1.0,680,1.0,0,0,480,200,1916,510000.0
2.0,1.0,780,1.0,0,0,780,0,1942,289000.0
3.0,2.25,2430,1.5,0,0,1900,530,1979,365000.0
3.0,1.5,1750,1.0,0,0,1750,0,1966,410000.0
3.0,1.0,1610,1.5,0,0,1010,600,1901,535610.0
4.0,1.75,2120,2.0,0,0,2120,0,1971,397950.0
3.0,1.75,1430,1.0,0,0,930,500,1978,284000.0
4.0,1.5,1360,1.5,0,0,1360,0,1962,201000.0
4.0,2.25,2530,1.5,0,0,1690,840,1925,734000.0
5.0,3.0,3270,2.0,0,0,3270,0,2002,357500.0
5.0,2.5,2620,1.0,0,0,1520,1100,1975,550120.0
3.0,1.5,1810,1.0,0,0,1810,0,1988,300000.0
3.0,2.5,2120,2.0,0,0,2120,0,1992,374950.0
4.0,1.75,2190,2.0,0,0,2190,0,1980,602500.0
3.0,1.0,980,1.0,0,0,980,0,1954,221000.0
5.0,3.0,2230,2.0,0,0,1730,500,1913,920000.0
4.0,2.0,1540,1.0,0,0,1540,0,1955,235000.0
3.0,1.0,980,1.0,0,0,980,0,1967,375000.0
4.0,2.5,2120,2.0,0,0,2120,0,2005,599000.0
3.0,2.25,2090,2.0,0,0,2090,0,1983,562100.0
3.0,2.5,1620,2.0,0,0,1100,520,2009,640000.0
3.0,2.0,1650,1.0,0,0,1250,400,1957,294000.0
4.0,2.5,3230,2.0,0,0,3230,0,2005,714000.0
4.0,3.25,2790,1.0,0,3,1130,1660,1963,970000.0
4.0,2.25,1600,2.0,0,0,1600,0,1991,280000.0
4.0,2.5,1790,2.0,0,0,1790,0,1993,260000.0
3.0,1.5,2060,1.5,0,0,2060,0,1938,294000.0
4.0,1.0,1370,1.5,0,2,1370,0,1900,255500.0
5.0,4.75,6200,2.0,1,4,4440,1760,1989,3300000.0
3.0,2.0,1510,1.0,0,0,1510,0,1954,450000.0
3.0,1.0,1280,1.0,0,0,1280,0,1968,368000.0
4.0,2.25,2180,1.0,0,0,1370,810,1963,830000.0
2.0,1.75,1440,1.0,0,0,1130,310,1935,282500.0
3.0,2.25,1580,1.0,0,0,1580,0,1978,335000.0
2.0,2.0,1580,1.0,0,0,790,790,1910,558000.0
4.0,1.5,1730,1.5,0,0,1730,0,1961,270000.0
2.0,1.0,700,1.0,0,0,700,0,1920,152000.0
4.0,1.75,2030,1.5,0,0,2030,0,1975,493000.0
4.0,2.5,2500,2.0,0,0,2500,0,1992,740000.0
3.0,2.5,2605,2.0,0,2,2090,515,1979,789800.0
2.0,1.0,910,1.0,0,0,910,0,1910,275000.0
6.0,2.5,3560,2.5,0,0,3560,0,1914,1500000.0
3.0,1.75,1140,1.0,0,0,620,520,1925,424000.0
2.0,1.0,1000,1.0,0,4,1000,0,1914,715000.0
4.0,2.5,3010,2.0,0,0,3010,0,2000,600000.0
2.0,1.75,2110,1.0,0,4,1760,350,1960,802000.0
3.0,1.0,910,1.0,0,0,910,0,1943,165000.0
4.0,3.25,2050,2.0,0,0,1370,680,1987,750000.0
2.0,1.0,1090,1.0,0,0,780,310,1981,405000.0
3.0,2.5,2100,2.0,0,0,2100,0,1997,521900.0
3.0,1.0,1000,1.0,0,0,1000,0,1969,275000.0
5.0,3.25,4410,2.0,0,0,2330,2080,2001,600000.0
3.0,1.75,1800,1.0,0,0,1800,0,1967,442500.0
2.0,1.0,920,1.0,0,0,920,0,1944,229950.0
3.0,2.0,1410,1.0,0,0,1410,0,1983,274950.0
3.0,1.75,1860,1.5,0,0,1860,0,1929,407185.0
4.0,2.5,2100,1.0,0,0,1240,860,1976,468000.0
2.0,1.0,1030,1.0,0,0,1030,0,1942,450000.0
2.0,1.0,940,1.0,0,0,940,0,1955,219950.0
2.0,2.5,1340,2.0,0,0,1340,0,1989,275000.0
2.0,1.0,850,1.0,0,0,850,0,1924,229950.0
3.0,1.75,2130,1.0,0,0,1430,700,1922,675000.0
4.0,2.5,2430,2.0,0,0,2430,0,1993,412950.0
5.0,2.25,2290,2.0,0,0,2290,0,1979,670000.0
3.0,1.75,1230,1.0,0,0,1230,0,1963,420000.0
3.0,1.5,1150,1.0,0,0,1150,0,1976,358000.0
3.0,2.5,2120,2.0,0,0,2120,0,2005,680000.0
2.0,1.0,980,1.0,0,0,980,0,1923,380000.0
3.0,2.5,2130,2.0,0,0,2130,0,1986,515000.0
2.0,1.0,1050,1.0,0,0,1050,0,1969,325000.0
3.0,2.5,1820,1.0,0,0,1820,0,1953,875000.0
3.0,2.5,2210,2.0,0,0,1710,500,1914,426000.0
5.0,2.5,2490,1.0,0,0,1610,880,1959,868500.0
4.0,2.75,4140,2.0,0,0,4140,0,2002,657500.0
2.0,1.0,1210,1.0,0,0,860,350,1926,366000.0
2.0,1.0,1010,1.0,0,0,1010,0,1911,385000.0
4.0,2.0,2050,1.0,0,0,1300,750,1967,300000.0
3.0,1.75,2060,2.0,0,0,1500,560,1918,810000.0
4.0,1.75,1560,1.0,0,0,860,700,1943,460000.0
3.0,2.5,1780,2.0,0,0,1780,0,1995,459000.0
3.0,1.75,1460,1.0,0,0,1460,0,1967,260000.0
4.0,2.5,3030,2.0,0,0,3030,0,1987,557865.0
4.0,1.0,980,1.5,0,0,980,0,1914,295000.0
4.0,2.25,1450,1.0,0,0,1450,0,1950,375000.0
3.0,2.25,3230,2.0,0,0,3230,0,1973,2110000.0
2.0,2.0,1520,3.0,0,0,1520,0,1999,307300.0
4.0,1.0,1410,1.5,0,0,1410,0,1963,225000.0
3.0,1.75,1390,2.0,0,0,1390,0,1979,290000.0
4.0,2.0,2230,1.5,0,0,1510,720,1922,690000.0
4.0,2.25,2110,2.0,0,0,2110,0,1972,825000.0
3.0,1.75,2270,1.0,0,0,1370,900,1956,645000.0
4.0,2.25,2530,1.0,0,0,1320,1210,1977,590000.0
5.0,2.0,1900,1.0,0,0,1180,720,1930,667000.0
4.0,2.5,2390,2.0,0,0,2390,0,1998,664000.0
4.0,2.5,3160,1.0,0,3,1580,1580,1959,452100.0
2.0,1.0,900,2.0,0,0,900,0,1998,290000.0
3.0,3.0,3610,2.0,0,2,3610,0,1954,950000.0
3.0,2.0,2070,1.5,0,0,1670,400,1906,662500.0
4.0,2.5,1850,2.0,0,0,1850,0,1981,475000.0
3.0,1.5,1440,1.0,0,0,1140,300,1956,450000.0
3.0,2.25,2590,2.0,0,3,2590,0,1984,538250.0
2.0,1.0,1140,1.5,0,0,1140,0,1949,329950.0
4.0,3.5,2760,2.0,0,2,2760,0,1955,1103990.0
5.0,1.5,1310,1.5,0,0,1110,200,1929,307000.0
3.0,1.75,1870,1.0,0,0,1270,600,1959,433000.0
3.0,2.25,1900,1.0,0,0,1280,620,1968,212000.0
5.0,2.75,2860,2.5,0,0,2380,480,1902,750000.0
3.0,2.0,1640,1.0,0,0,1640,0,2003,279000.0
3.0,1.0,1140,1.5,0,0,1140,0,1908,476000.0
5.0,1.75,2590,1.0,0,0,1390,1200,1963,368000.0
4.0,3.0,2160,1.0,0,0,1320,840,1978,228950.0
5.0,3.5,3260,2.0,0,0,3260,0,1969,568450.0
4.0,1.75,1660,1.5,0,0,1660,0,1926,619000.0
3.0,2.25,1640,2.0,0,0,1640,0,1996,275000.0
4.0,2.5,2620,2.0,0,0,2620,0,2003,321500.0
3.0,1.75,950,1.0,0,0,790,160,1939,230000.0
3.0,1.0,900,1.0,0,0,900,0,1959,179500.0
3.0,2.25,1650,1.0,0,0,1220,430,1975,460000.0
3.0,2.5,1800,2.0,0,0,1800,0,2006,286000.0
3.0,1.0,1480,1.5,0,0,1480,0,1925,427500.0
3.0,1.0,1040,1.0,0,0,1040,0,1942,400000.0
3.0,3.5,2300,1.0,0,0,2300,0,2004,675000.0
3.0,1.0,2480,1.0,0,0,1240,1240,1969,350000.0
4.0,1.75,1970,1.0,0,0,1540,430,1977,385000.0
2.0,1.75,1530,1.0,0,1,830,700,1916,525000.0
2.0,1.0,970,1.0,0,0,970,0,1939,315000.0
4.0,2.5,2920,2.0,0,0,2920,0,2002,820000.0
3.0,1.0,970,1.0,0,0,970,0,1959,205000.0
2.0,1.0,680,1.0,0,0,680,0,1922,500000.0
4.0,2.5,2640,2.0,0,0,2640,0,1989,599000.0
3.0,4.0,4200,2.0,0,2,3600,600,1933,2225000.0
1.0,2.5,1980,1.0,0,0,1180,800,1979,299000.0
3.0,2.75,2980,1.5,1,2,2180,800,1917,947500.0
3.0,3.25,1630,3.0,0,0,1630,0,2007,385000.0
2.0,1.75,1780,1.0,0,0,890,890,1925,639950.0
2.0,1.0,1210,1.0,0,0,780,430,2000,824000.0
3.0,1.0,1010,1.0,0,0,1010,0,1969,199950.0
3.0,2.5,2570,1.0,0,0,1480,1090,1940,1005000.0
4.0,2.25,2770,2.0,0,1,2440,330,2013,950000.0
3.0,2.5,2290,2.0,0,0,2290,0,1984,822000.0
4.0,1.5,1780,1.0,0,0,1080,700,1969,473600.0
5.0,2.0,2150,1.5,0,0,2150,0,1938,490000.0
3.0,1.75,1920,1.0,0,0,1000,920,1984,245000.0
4.0,1.0,1220,1.0,0,0,1220,0,1960,199000.0
3.0,3.0,2960,2.0,0,2,2440,520,1937,1340000.0
3.0,1.75,1500,1.0,0,0,1500,0,1984,418000.0
7.0,3.5,2830,1.0,0,0,1830,1000,1957,450000.0
3.0,2.5,1580,2.0,0,0,1580,0,1992,280000.0
3.0,2.25,1230,1.0,0,0,910,320,1992,273000.0
4.0,2.5,2910,2.0,0,0,2910,0,2008,549000.0
5.0,2.25,2370,2.0,0,0,2370,0,1981,913888.0
4.0,2.25,1930,1.5,0,0,1540,390,1916,689888.0
4.0,2.0,1780,1.0,0,0,870,910,1993,305000.0
4.0,2.5,2760,2.0,0,0,2760,0,1999,602500.0
2.0,1.75,1620,1.0,0,0,900,720,1929,355000.0
3.0,2.5,2160,2.0,0,0,2160,0,1986,756000.0
4.0,2.25,2190,1.0,0,0,1040,1150,1977,289950.0
3.0,2.5,3240,2.0,0,0,3240,0,1994,800000.0
2.0,1.0,720,1.0,0,0,720,0,1905,403000.0
3.0,2.25,1410,2.0,0,0,1370,40,1967,350000.0
5.0,3.5,2980,2.0,0,0,2370,610,2015,1285000.0
5.0,2.25,1950,1.0,0,2,1150,800,1960,525126.0
3.0,1.0,1100,1.0,0,0,1100,0,1949,241450.0
3.0,1.5,1400,1.0,0,0,1400,0,1954,320000.0
4.0,2.0,1710,1.0,0,0,1030,680,1975,234000.0
5.0,2.5,2000,1.0,0,0,1150,850,1987,441000.0
5.0,2.5,2000,1.0,0,0,1150,850,1987,474500.0
3.0,1.0,1440,1.5,0,0,1440,0,1906,705000.0
4.0,2.5,1520,2.0,0,0,1520,0,1994,517500.0
4.0,0.75,1440,1.0,0,0,1440,0,1948,142500.0
2.0,1.5,1010,2.0,0,0,1010,0,1981,310000.0
4.0,2.5,2440,2.0,0,0,2440,0,1987,749500.0
5.0,3.0,2480,1.0,0,0,1560,920,1999,360000.0
3.0,1.0,1090,1.0,0,0,1090,0,1967,267500.0
3.0,1.0,1480,1.0,0,0,1380,100,1942,290000.0
5.0,2.5,2800,1.0,0,0,1400,1400,1970,850000.0
4.0,1.75,1820,1.5,0,0,1820,0,1921,815000.0
5.0,4.0,5840,2.0,0,1,4410,1430,1988,2200000.0
4.0,3.25,2980,2.0,0,0,2150,830,1999,1625000.0
3.0,1.5,1220,1.0,0,0,1220,0,1973,175000.0
3.0,1.75,1830,1.0,0,0,1300,530,1977,429950.0
4.0,2.5,2900,2.0,0,0,2900,0,2002,675000.0
3.0,2.25,1940,1.0,0,0,1520,420,1987,580000.0
4.0,2.0,1750,1.0,0,0,1750,0,1944,240000.0
3.0,2.5,1850,1.0,0,0,1210,640,1982,374000.0
4.0,2.5,3220,2.0,0,2,2180,1040,1937,862500.0
2.0,1.0,1080,1.0,0,0,1080,0,1908,140000.0
5.0,3.75,3990,2.0,0,0,3090,900,1937,740000.0
3.0,1.75,920,1.0,0,0,820,100,1904,589000.0
3.0,1.75,1290,1.0,0,0,1290,0,1979,275000.0
4.0,2.5,2090,2.0,0,0,2090,0,2006,489900.0
3.0,2.5,1900,2.0,0,0,1900,0,1996,545000.0
4.0,1.0,1360,1.5,0,0,1360,0,1941,235000.0
3.0,1.0,1000,1.5,0,0,1000,0,1915,230000.0
4.0,2.25,2170,2.0,0,0,1920,250,1980,655000.0
2.0,1.0,820,1.0,0,0,820,0,1923,185000.0
3.0,1.0,1090,1.0,0,0,1090,0,1962,196000.0
3.0,2.25,1830,1.0,0,0,1290,540,1986,572000.0
4.0,2.5,3010,2.0,0,0,3010,0,2001,615000.0
4.0,3.75,4150,1.0,0,0,3130,1020,1963,1950000.0
6.0,2.25,2930,2.0,0,0,2130,800,1913,1225000.0
3.0,2.5,1520,2.0,0,0,1520,0,1989,375000.0
3.0,1.75,1250,1.0,0,0,1250,0,1971,295000.0
4.0,2.5,2760,2.0,0,0,2230,530,1942,760000.0
3.0,1.75,1330,1.0,0,0,1330,0,1978,347000.0
3.0,2.0,1700,1.5,0,0,1500,200,1924,712000.0
4.0,2.0,2050,1.5,0,0,1210,840,1941,495000.0
4.0,2.0,3140,1.0,0,0,2040,1100,1959,925000.0
3.0,1.0,2030,1.5,0,0,1840,190,1908,775000.0
4.0,2.5,2100,1.5,0,0,1400,700,1916,429000.0
3.0,1.0,1010,1.0,0,0,1010,0,1959,229000.0
4.0,1.5,1980,1.0,0,0,1980,0,1962,400000.0
4.0,2.25,2100,2.0,0,0,2100,0,1978,625000.0
2.0,1.0,840,1.0,0,0,840,0,1951,130000.0
3.0,1.75,1690,1.0,0,0,1190,500,1976,349000.0
3.0,2.0,2140,1.0,0,0,2140,0,1983,365000.0
3.0,2.5,1810,2.0,0,0,1350,460,1997,487500.0
3.0,2.5,2600,2.0,0,0,2600,0,1989,475000.0
3.0,1.75,1650,1.0,0,0,1470,180,1959,685000.0
3.0,1.75,2460,1.0,0,0,1230,1230,1938,960000.0
5.0,2.25,4320,2.0,0,0,2880,1440,1973,1100000.0
3.0,2.25,2600,2.0,0,0,2600,0,1978,428000.0
3.0,2.5,1930,2.0,0,0,1930,0,1988,435000.0
3.0,2.0,2190,1.0,0,2,1260,930,1952,769950.0
3.0,1.0,1420,1.0,0,0,1200,220,1954,385000.0
3.0,2.5,2090,2.0,0,0,1670,420,2005,352000.0
3.0,2.5,2290,2.0,0,0,2290,0,1983,622500.0
3.0,3.0,2470,2.0,0,0,2290,180,1976,660000.0
3.0,1.0,840,1.0,0,0,840,0,1959,105000.0
2.0,1.0,2100,1.0,0,0,1400,700,1908,420000.0
3.0,1.5,1360,1.0,0,0,1360,0,1955,499950.0
6.0,3.0,3420,1.0,0,0,2270,1150,1948,975000.0
3.0,2.75,1930,1.5,0,0,1490,440,1929,665000.0
4.0,2.5,2180,1.0,0,0,1180,1000,1968,540000.0
4.0,2.0,1670,1.0,0,0,1670,0,1955,400000.0
4.0,2.75,2720,1.0,0,0,1650,1070,2008,469950.0
4.0,2.5,3170,2.0,0,0,3170,0,1979,777000.0
2.0,1.75,1610,1.0,0,0,1010,600,1941,346500.0
3.0,2.5,2370,2.0,0,0,2370,0,2003,685000.0
3.0,2.5,2590,1.0,0,0,2590,0,1976,396500.0
3.0,2.5,2850,2.0,0,0,1990,860,1980,783500.0
4.0,2.0,1660,1.5,0,0,1660,0,1922,575000.0
4.0,4.25,5550,2.0,0,0,5550,0,2005,1500000.0
3.0,1.5,2200,1.0,0,0,1130,1070,1942,515000.0
3.0,2.5,2020,1.0,0,0,1250,770,1963,300000.0
3.0,1.5,1760,1.0,0,0,1760,0,1966,272000.0
4.0,2.25,1810,2.0,0,0,1810,0,2003,355000.0
3.0,2.0,1310,1.0,0,0,1310,0,1951,223000.0
4.0,2.5,3000,2.0,0,0,3000,0,2003,397000.0
2.0,2.0,1080,1.0,0,0,1080,0,1923,460000.0
3.0,2.75,2170,1.5,0,0,1550,620,1930,848000.0
2.0,1.0,740,1.0,0,0,740,0,1924,392800.0
3.0,3.25,5290,2.0,0,0,4540,750,1988,1690000.0
3.0,3.25,5290,2.0,0,0,4540,750,1988,1800000.0
3.0,2.25,2370,2.0,0,0,2370,0,1985,577000.0
3.0,1.0,1890,1.5,0,0,1390,500,1901,570000.0
3.0,1.75,1160,1.0,0,0,1160,0,1998,250000.0
4.0,1.75,1550,1.5,0,0,1550,0,1958,645000.0
3.0,2.5,3090,2.0,0,0,3090,0,1990,567500.0
4.0,2.5,2610,2.0,0,0,2610,0,2004,337000.0
3.0,1.75,1230,1.0,0,0,1230,0,1966,280000.0
3.0,1.5,1280,2.0,0,0,1280,0,1985,167000.0
2.0,1.0,1880,1.0,0,0,940,940,1919,280000.0
2.0,1.5,1220,1.0,0,0,1220,0,1948,317500.0
2.0,2.75,1350,2.0,0,0,1120,230,2006,405500.0
4.0,2.5,2370,2.0,0,0,2370,0,1995,495000.0
4.0,3.0,3040,2.0,0,0,3040,0,1987,691000.0
5.0,1.75,2080,1.0,0,0,2080,0,1963,480000.0
2.0,1.75,1560,1.0,0,0,880,680,1942,549010.0
5.0,3.5,2980,2.0,0,2,2980,0,2005,750000.0
2.0,1.0,870,1.0,0,0,870,0,1948,365000.0
3.0,1.75,1660,1.0,0,0,1100,560,1988,412500.0
3.0,2.25,1870,1.0,0,0,1440,430,1978,425000.0
3.0,1.0,1410,1.0,0,0,960,450,1953,920000.0
4.0,2.25,2180,1.0,0,0,1630,550,1975,340000.0
4.0,2.5,2620,1.0,0,0,1520,1100,1955,405000.0
3.0,2.5,2450,1.0,0,0,1870,580,1990,537100.0
4.0,2.5,3250,2.0,0,0,3250,0,2007,353500.0
3.0,1.0,1150,1.0,0,0,1150,0,1952,522000.0
4.0,2.75,2780,2.0,0,0,2780,0,2001,710000.0
3.0,1.75,1360,1.0,0,0,1360,0,1985,329950.0
5.0,2.5,2810,1.0,0,3,1540,1270,1979,830000.0
4.0,2.5,1780,1.0,0,0,1780,0,1962,800500.0
3.0,1.0,1100,1.0,0,0,1100,0,1969,168500.0
3.0,2.5,2230,2.0,0,0,2230,0,2000,490000.0
3.0,2.5,1710,2.0,0,0,1140,570,2003,579000.0
4.0,2.5,2620,2.0,0,0,2620,0,1987,600000.0
4.0,1.75,1990,1.5,0,0,1190,800,1944,445000.0
4.0,1.75,1450,1.0,0,0,1450,0,1960,362500.0
4.0,2.0,1630,1.0,0,0,1050,580,1975,234000.0
1.0,1.0,730,1.0,0,0,730,0,2008,321500.0
3.0,1.75,1980,1.5,0,0,1140,840,1926,660000.0
4.0,1.0,1730,1.5,0,0,1730,0,1954,319000.0
3.0,1.75,1350,1.0,0,0,1100,250,1953,314000.0
3.0,2.0,1410,1.0,0,0,740,670,1908,517950.0
5.0,2.5,2360,1.0,0,0,1180,1180,1961,525000.0
3.0,1.0,1190,1.0,0,0,1190,0,1961,319500.0
4.0,3.25,3760,1.5,0,0,2400,1360,1950,1580000.0
1.0,1.0,1220,1.0,0,4,1220,0,1946,325000.0
4.0,2.5,2920,2.0,0,0,2920,0,1995,795000.0
2.0,1.75,1590,1.5,0,3,1320,270,1927,850000.0
5.0,3.25,3510,2.0,0,0,3510,0,2013,1010000.0
3.0,2.5,1320,3.0,0,0,1320,0,2006,475000.0
3.0,1.0,1610,1.0,0,0,1090,520,1975,375000.0
3.0,1.0,1410,1.0,0,0,1410,0,1951,405000.0
4.0,2.5,2170,1.0,0,0,1570,600,1962,420000.0
4.0,1.75,1890,1.5,0,0,1390,500,1906,775000.0
4.0,2.75,3260,2.0,0,0,3260,0,2007,800000.0
3.0,1.75,2080,2.0,0,0,1540,540,1984,436800.0
3.0,1.75,2040,1.5,0,0,1740,300,1930,620000.0
3.0,1.0,1250,1.0,0,0,1250,0,1970,230000.0
1.0,1.0,850,1.0,0,0,850,0,1906,165000.0
1.0,1.0,850,1.0,0,0,850,0,1906,490000.0
3.0,1.75,1600,1.0,0,0,1600,0,1963,480000.0
3.0,2.5,2400,2.0,0,0,2400,0,1993,570000.0
3.0,2.25,1870,2.0,0,0,1750,120,1992,615000.0
3.0,1.0,1720,1.0,0,0,860,860,1969,280000.0
3.0,1.0,1030,1.0,0,0,1030,0,1969,326000.0
2.0,2.25,1190,2.0,0,0,1100,90,2004,550700.0
2.0,1.0,910,1.5,0,0,910,0,1900,600000.0
3.0,1.0,1290,1.0,0,0,1150,140,1968,450000.0
2.0,2.25,1530,2.0,0,0,1280,250,2010,546000.0
3.0,2.5,2330,2.0,0,0,2330,0,1983,585000.0
3.0,1.75,2090,1.0,0,2,1200,890,1952,489000.0
3.0,2.0,1570,2.0,0,2,1050,520,1971,765000.0
3.0,1.75,1560,1.0,0,3,1560,0,1973,519000.0
2.0,1.0,1500,1.5,0,0,880,620,1928,262000.0
4.0,2.75,2160,1.0,0,0,1430,730,1987,550000.0
2.0,1.0,780,1.0,0,0,780,0,1943,285000.0
4.0,1.75,2340,1.0,0,0,1360,980,1956,476000.0
3.0,2.0,3570,1.0,0,1,2070,1500,1946,2200000.0
1.0,1.0,720,1.0,0,0,720,0,1907,335000.0
4.0,2.0,2990,1.0,0,0,2990,0,1974,510000.0
3.0,2.25,1860,1.0,0,0,1860,0,1961,291000.0
4.0,1.75,1950,1.5,0,0,1950,0,1931,335000.0
3.0,1.5,1860,1.0,0,0,1490,370,1955,415000.0
3.0,2.0,1550,1.0,0,0,830,720,1942,430000.0
3.0,1.75,1610,1.0,0,0,1210,400,1979,270000.0
3.0,2.0,1810,1.0,0,0,980,830,1906,760000.0
2.0,2.0,1730,2.0,0,0,1730,0,1905,450000.0
3.0,2.5,1230,1.0,0,0,1230,0,1978,425000.0
4.0,2.5,2130,1.5,0,0,1730,400,1916,725000.0
3.0,2.75,2190,1.0,0,0,1610,580,1973,700000.0
5.0,4.5,4130,2.0,0,0,4130,0,2004,998000.0
3.0,2.25,1680,2.0,0,0,1680,0,1989,396000.0
3.0,2.5,1480,1.0,0,0,1480,0,1968,547000.0
4.0,1.5,1790,1.0,0,0,1210,580,1963,302000.0
5.0,3.5,2810,2.0,0,0,1900,910,1910,999000.0
4.0,2.5,2360,1.0,0,3,1980,380,1977,633000.0
3.0,1.75,1460,1.0,0,0,1460,0,1982,265800.0
3.0,2.25,2160,1.0,0,0,1460,700,1960,530000.0
6.0,2.0,2610,1.0,0,0,1320,1290,1965,605000.0
4.0,2.5,2170,2.0,0,0,2170,0,2006,489000.0
2.0,1.0,2160,1.0,0,0,1360,800,1968,305000.0
4.0,2.75,2020,1.0,0,0,1010,1010,1958,513000.0
4.0,2.5,2980,2.0,0,0,2980,0,2006,765000.0
2.0,1.5,1300,1.0,0,0,990,310,1903,550000.0
4.0,2.5,3090,2.0,0,0,2420,670,1985,974350.0
4.0,2.25,2280,2.0,0,0,2280,0,1984,653675.0
3.0,1.75,1260,1.0,0,0,1260,0,1985,245000.0
2.0,1.75,1530,1.0,0,0,1020,510,1952,700180.0
3.0,2.5,1830,1.0,0,0,1390,440,1996,510000.0
3.0,2.5,1610,1.0,0,0,1190,420,1969,390000.0
3.0,2.5,2170,2.0,0,0,2170,0,2000,606500.0
4.0,4.25,5020,2.0,0,0,5020,0,1998,1500000.0
3.0,2.25,1620,2.0,0,0,1620,0,1988,290000.0
3.0,1.75,1080,1.0,0,0,1080,0,1981,115000.0
3.0,2.5,1940,1.0,0,0,1940,0,1987,500000.0
,,844,1.0,0,0,844,0,1913,139950.0
3.0,2.5,2360,2.0,0,3,2360,0,1996,580050.0
3.0,2.5,2010,2.0,0,0,1390,620,2014,550000.0
3.0,1.0,800,1.5,0,0,800,0,1903,465000.0
3.0,1.0,970,1.5,0,0,970,0,1949,354950.0
4.0,3.25,3720,2.0,0,2,3720,0,2007,980000.0
3.0,2.25,2010,2.0,0,0,2010,0,1985,500000.0
4.0,1.0,1430,1.5,0,0,1430,0,1924,667750.0
3.0,1.75,2250,1.0,0,1,2250,0,1956,735000.0
3.0,1.75,2130,1.0,0,3,1330,800,1955,361000.0
3.0,2.0,1620,1.0,0,0,1290,330,1989,276750.0
4.0,3.25,3140,2.0,0,0,2310,830,2009,760000.0
2.0,1.0,870,1.0,0,2,870,0,1946,475000.0
4.0,2.5,1820,1.0,0,0,1120,700,1987,234000.0
3.0,2.0,1510,1.0,0,0,1510,0,1974,234950.0
2.0,1.75,1320,1.0,0,0,1320,0,1968,269950.0
3.0,2.5,1800,2.0,0,0,1800,0,1989,495000.0
2.0,1.0,1120,1.0,0,0,1120,0,1942,438000.0
3.0,1.75,2160,1.0,0,0,2160,0,1981,260000.0
4.0,2.5,3220,2.0,0,0,3220,0,2004,697000.0
2.0,1.0,960,1.0,0,0,960,0,1951,212625.0
5.0,2.5,2640,1.5,0,0,1840,800,1925,593000.0
4.0,3.0,2430,2.0,0,0,2430,0,2003,410000.0
2.0,1.0,1470,1.0,0,0,1020,450,1941,445434.0
3.0,2.5,2040,1.0,0,0,1340,700,1968,200126.0
3.0,2.5,1670,2.0,0,0,1670,0,1992,290700.0
4.0,1.0,1010,1.0,0,0,1010,0,1955,248000.0
1.0,1.0,540,1.0,0,0,540,0,1961,345000.0
3.0,1.0,1240,1.0,0,0,800,440,1951,525000.0
3.0,1.75,1510,1.0,0,0,1510,0,1968,400000.0
3.0,1.0,1820,1.0,0,0,1120,700,1918,532000.0
2.0,1.0,1000,1.0,0,0,760,240,1915,159995.0
5.0,1.5,2040,1.0,0,0,1030,1010,1963,287000.0
4.0,2.5,3690,1.0,0,3,2190,1500,1951,1115000.0
3.0,2.5,2310,2.0,0,0,2310,0,1988,765000.0
3.0,1.5,1090,1.0,0,0,1090,0,1969,185000.0
3.0,1.0,1150,1.0,0,0,1150,0,1906,430000.0
4.0,2.5,2100,2.0,0,0,2100,0,2009,346000.0
4.0,2.75,2150,1.0,0,0,1240,910,1982,607000.0
3.0,1.5,2500,1.5,0,0,1730,770,1941,417000.0
5.0,2.0,3530,1.5,0,0,3530,0,1925,930000.0
2.0,1.75,1290,1.0,0,2,870,420,1951,573300.0
4.0,1.75,2010,1.0,0,0,1410,600,1955,260000.0
1.0,0.75,420,1.0,0,0,420,0,1922,280000.0
4.0,2.5,2180,2.0,0,0,2180,0,1920,825000.0
4.0,1.0,1150,1.5,0,0,1150,0,1947,307000.0
4.0,1.75,2000,1.0,0,0,1130,870,1949,595000.0
5.0,1.75,2780,1.0,0,0,1390,1390,1966,528000.0
2.0,1.75,1550,1.0,1,4,1550,0,1965,600000.0
2.0,1.0,2180,1.0,0,0,1480,700,1959,275000.0
2.0,1.5,1570,1.5,0,2,1320,250,1906,782000.0
3.0,2.5,2260,1.0,0,0,1660,600,1986,610000.0
3.0,1.0,1600,1.5,0,0,1600,0,1909,488000.0
3.0,1.0,1630,1.0,0,0,930,700,1954,320000.0
3.0,1.0,890,1.0,0,0,890,0,1910,153500.0
3.0,1.0,1350,1.0,0,0,1350,0,1979,414500.0
5.0,1.75,2850,1.0,0,0,2850,0,1951,750000.0
3.0,1.0,1350,1.0,0,3,1350,0,1925,349990.0
3.0,2.25,3280,1.0,0,0,3280,0,2001,645000.0
2.0,1.0,1090,1.0,0,0,1090,0,1922,425000.0
4.0,2.5,2990,2.0,0,0,2990,0,2003,785000.0
3.0,1.75,1340,1.0,0,0,1340,0,1963,290000.0
3.0,1.75,1340,1.0,0,0,1340,0,1963,415000.0
2.0,1.0,720,1.0,0,0,720,0,1949,248500.0
3.0,2.5,2330,1.0,0,0,1480,850,1980,325000.0
2.0,1.0,1280,1.5,0,0,1280,0,1941,272925.0
2.0,2.25,1570,2.0,0,0,1280,290,2015,500000.0
4.0,1.75,1510,1.5,0,0,1510,0,1920,250000.0
4.0,2.5,2470,2.0,0,0,2470,0,2002,470000.0
2.0,1.0,1190,1.0,0,0,990,200,1917,440000.0
4.0,2.5,1981,2.0,0,0,1981,0,2013,299999.0
3.0,1.75,1590,1.0,0,0,1590,0,1959,255000.0
3.0,1.75,1150,1.0,0,0,1150,0,1957,415950.0
5.0,2.75,2160,1.5,0,0,1220,940,1955,402000.0
3.0,1.5,1770,1.0,0,4,1770,0,1953,729000.0
2.0,2.5,2470,2.0,0,0,1780,690,2001,635000.0
3.0,2.5,1710,2.0,0,0,1710,0,1982,479000.0
2.0,2.25,1860,2.0,0,0,1860,0,1986,462370.0
3.0,1.0,1150,1.5,0,0,1150,0,1946,171500.0
5.0,3.0,3850,2.0,0,0,2910,940,1963,925000.0
5.0,3.0,3410,1.0,0,0,1870,1540,1968,675000.0
4.0,1.5,1890,1.0,0,0,1890,0,1974,320000.0
5.0,3.5,3200,2.0,0,0,3200,0,1989,499950.0
5.0,1.0,2170,1.5,0,0,1670,500,1930,435000.0
4.0,2.5,2390,2.0,0,0,2390,0,1999,359800.0
3.0,2.0,1410,1.0,0,0,1410,0,1985,239900.0
2.0,1.0,740,1.0,0,2,740,0,1915,295000.0
3.0,2.5,2150,1.5,0,0,2150,0,1980,380000.0
4.0,2.5,2180,2.0,0,0,1410,770,1945,435000.0
2.0,1.0,820,1.0,0,0,820,0,1953,508000.0
6.0,4.5,5480,2.0,0,3,4430,1050,1999,2400000.0
4.0,2.5,1960,1.0,0,0,1220,740,1978,234500.0
2.0,1.0,1270,1.0,0,0,960,310,1920,355000.0
3.0,2.0,1710,1.0,0,0,1030,680,1977,230000.0
3.0,1.75,1930,1.0,0,1,1150,780,1951,345000.0
3.0,1.75,1200,1.0,0,0,1200,0,1906,430000.0
3.0,1.5,1680,1.0,0,0,1680,0,1962,500000.0
4.0,1.0,1300,1.0,0,0,1300,0,1954,378000.0
3.0,2.5,1540,2.0,0,0,1540,0,1999,345000.0
2.0,1.75,870,1.0,0,0,870,0,1941,410000.0
2.0,2.25,1890,2.0,0,0,1610,280,1905,750000.0
4.0,1.75,2050,1.0,0,0,1330,720,1968,485000.0
3.0,1.0,880,1.0,0,0,880,0,1970,105000.0
3.0,2.75,2780,2.0,0,2,1960,820,1904,1025000.0
3.0,1.0,1160,1.0,0,0,1160,0,1965,360000.0
5.0,2.75,2300,1.0,0,0,1400,900,1969,294000.0
4.0,2.5,3140,2.0,0,0,3140,0,1977,400000.0
3.0,1.75,2300,1.0,0,0,1150,1150,1970,325000.0
3.0,2.5,2900,1.0,0,0,1490,1410,1987,770000.0
3.0,2.25,1920,2.0,0,0,1920,0,1989,443000.0
3.0,1.0,1150,1.0,0,0,1150,0,1970,325000.0
4.0,2.5,3120,2.0,0,0,3120,0,1992,760000.0
4.0,2.0,2560,1.0,0,0,1890,670,1947,640000.0
3.0,2.0,1410,1.5,0,0,1410,0,1900,415000.0
3.0,1.0,970,1.0,0,0,970,0,1959,156000.0
3.0,3.25,3620,2.0,0,0,2730,890,1988,996000.0
2.0,1.0,880,1.0,0,0,880,0,1941,415000.0
3.0,1.75,1900,1.5,0,0,1110,790,1927,615000.0
4.0,2.5,2540,2.0,0,0,2540,0,2009,717000.0
4.0,1.75,1690,1.0,0,0,1090,600,1968,548000.0
3.0,1.5,1120,1.0,0,0,1120,0,1937,425000.0
4.0,2.75,2130,1.0,0,0,1330,800,1991,325250.0
3.0,2.5,3420,2.0,0,0,3420,0,1990,1225000.0
3.0,1.75,1900,1.0,0,0,1900,0,1959,557500.0
4.0,2.5,3730,2.0,0,0,3730,0,1990,1260500.0
3.0,3.0,1790,2.0,0,0,1480,310,2006,249950.0
4.0,2.75,2250,1.0,0,0,1320,930,1984,260000.0
3.0,2.5,2880,1.0,0,4,1520,1360,1950,1989000.0
4.0,1.75,1780,1.0,0,0,890,890,1943,442900.0
3.0,2.25,1580,1.0,0,0,1200,380,1981,475000.0
5.0,2.75,3260,2.0,0,0,3260,0,2004,365000.0
4.0,2.5,3180,2.0,0,2,3180,0,2002,780000.0
3.0,1.75,2460,1.0,0,0,1230,1230,1925,930000.0
5.0,6.25,8670,2.0,0,4,6120,2550,1965,2888000.0
3.0,1.0,1020,1.0,0,0,850,170,1941,350000.0
3.0,1.75,1630,1.0,0,0,1630,0,1983,357500.0
4.0,2.5,3290,2.0,0,0,3290,0,1992,520000.0
4.0,2.5,1940,2.0,0,0,1940,0,2003,330000.0
3.0,2.0,1350,1.0,0,0,1110,240,1995,310000.0
3.0,1.0,1110,1.0,0,0,1110,0,1949,279000.0
4.0,1.5,2993,2.0,0,0,2233,760,1921,540000.0
4.0,2.5,2280,2.0,0,0,2280,0,1994,322000.0
5.0,3.25,3800,1.0,0,0,2490,1310,1965,380000.0
2.0,1.0,850,1.0,0,0,850,0,1941,320000.0
3.0,1.75,1560,1.0,0,0,1560,0,1970,400000.0
3.0,1.0,1000,1.0,0,0,900,100,1928,412000.0
3.0,1.0,1400,1.5,0,0,1400,0,1900,887200.0
4.0,1.75,1540,1.0,0,0,770,770,1943,395000.0
4.0,3.0,3570,1.5,0,3,2630,940,1935,895000.0
2.0,1.0,800,1.0,0,0,800,0,1918,195000.0
3.0,1.0,1160,1.5,0,0,1160,0,1910,390000.0
3.0,1.0,1010,1.0,0,0,1010,0,1958,165000.0
3.0,1.0,1010,1.0,0,0,1010,0,1958,255000.0
4.0,2.25,2390,2.0,0,0,2390,0,1981,589000.0
3.0,2.5,1610,2.0,0,0,1610,0,1996,505000.0
3.0,3.0,2400,1.0,0,0,1440,960,1955,335750.0
3.0,1.75,1800,1.0,0,0,900,900,1947,719000.0
4.0,3.25,2110,2.0,0,0,2110,0,2001,796000.0
2.0,1.0,960,1.0,0,0,960,0,1918,95000.0
3.0,3.0,2600,1.5,0,3,1890,710,1989,525000.0
3.0,1.5,1340,1.0,0,0,1340,0,1956,417000.0
3.0,1.0,1410,1.0,0,0,980,430,1925,410000.0
4.0,2.25,2390,1.0,0,0,2390,0,1962,984000.0
2.0,1.5,1180,3.0,0,0,1180,0,2009,325000.0
3.0,1.0,1040,1.0,0,0,1040,0,1968,314950.0
3.0,2.25,1840,1.0,0,0,1200,640,1987,350000.0
4.0,2.25,2630,2.0,0,0,1810,820,1909,1045000.0
4.0,2.5,2640,2.0,0,0,2640,0,1995,657000.0
2.0,2.5,1720,2.0,0,0,1720,0,1999,234950.0
4.0,1.75,2320,1.0,0,0,1220,1100,1955,410000.0
3.0,1.75,1840,2.0,0,0,1270,570,1948,625000.0
5.0,2.5,2890,2.0,0,0,2890,0,1990,706000.0
3.0,1.75,2200,2.0,0,2,2200,0,1908,485000.0
4.0,2.75,1660,1.5,0,0,1280,380,1928,685000.0
3.0,2.5,2170,1.0,0,0,1690,480,1980,242050.0
3.0,3.25,3310,2.0,0,0,3310,0,2006,770000.0
2.0,1.5,1450,1.0,0,0,950,500,1947,557000.0
3.0,1.75,1440,1.0,0,0,1440,0,1966,246000.0
4.0,2.0,1760,1.0,0,0,1760,0,1962,194000.0
3.0,2.5,3170,2.0,0,0,3170,0,2005,720000.0
2.0,1.0,1250,1.0,0,0,1040,210,1925,449000.0
4.0,2.5,3280,2.0,0,0,3280,0,1994,925000.0
4.0,3.0,2460,1.0,0,0,1700,760,1947,570000.0
3.0,2.0,1470,1.0,0,0,1470,0,1962,395000.0
4.0,2.0,1780,1.5,0,0,1780,0,1918,1000000.0
4.0,1.0,1580,1.5,0,2,1580,0,1928,406000.0
3.0,1.5,1630,1.5,0,0,1630,0,1932,574800.0
4.0,2.0,2240,1.0,0,0,1120,1120,1968,309000.0
3.0,2.5,2430,2.0,0,0,2430,0,1987,770000.0
3.0,1.5,1940,1.0,0,0,1440,500,1941,525000.0
3.0,2.5,1970,2.0,0,0,1970,0,2004,419000.0
4.0,2.5,2050,1.0,0,0,1230,820,1973,479000.0
3.0,1.0,1340,1.5,0,0,1340,0,1935,160000.0
4.0,1.75,1880,1.0,0,0,1880,0,1967,333000.0
2.0,1.0,860,1.0,0,0,860,0,1921,310000.0
3.0,2.5,2140,2.0,0,0,1770,370,2007,666000.0
3.0,3.0,3620,2.0,1,4,2370,1250,1977,2230000.0
4.0,2.75,2370,2.0,0,0,2370,0,1989,310000.0
3.0,2.5,1860,2.0,0,0,1860,0,1992,350000.0
4.0,3.0,2110,1.5,0,2,1640,470,1930,610000.0
3.0,2.25,1990,2.0,0,0,1990,0,1991,564800.0
3.0,2.25,1820,1.0,0,0,1320,500,1961,438000.0
3.0,2.0,3120,1.0,0,0,1820,1300,1978,855000.0
3.0,2.5,1190,2.0,0,0,1190,0,2002,229000.0
3.0,2.0,1170,1.0,0,0,1170,0,1902,260000.0
3.0,2.5,2630,2.0,0,0,2630,0,1989,609000.0
4.0,1.0,1450,1.0,0,0,990,460,1964,277000.0
4.0,2.0,2100,1.0,0,0,1200,900,1959,283000.0
2.0,1.75,1680,1.0,0,0,840,840,1914,334000.0
4.0,1.75,2000,1.0,0,0,1100,900,1963,267000.0
3.0,1.0,1030,1.0,0,0,830,200,1924,385000.0
5.0,1.75,2020,1.0,0,0,1120,900,1956,640000.0
4.0,2.0,2220,1.0,0,0,2220,0,1963,532500.0
4.0,2.5,1750,1.0,0,0,1240,510,1983,335000.0
3.0,2.5,1710,2.0,0,0,1710,0,1990,415000.0
6.0,3.25,3560,1.5,0,0,2760,800,1963,1098000.0
2.0,2.5,2720,1.0,0,3,2160,560,1953,1442500.0
3.0,1.0,1010,1.0,0,0,1010,0,1955,180000.0
4.0,2.5,1830,2.0,0,0,1830,0,2004,335000.0
4.0,3.0,4480,2.0,0,0,4480,0,1987,835000.0
4.0,1.5,2080,1.5,0,0,2080,0,1925,592500.0
3.0,1.5,1470,1.0,0,0,1470,0,1954,418900.0
3.0,1.0,1600,1.0,0,0,1600,0,1958,340000.0
3.0,2.0,1340,1.5,0,0,1340,0,1923,545000.0
5.0,3.5,3680,2.0,0,0,3680,0,2003,1378000.0
3.0,2.5,1770,2.0,0,0,1770,0,2004,183750.0
4.0,2.0,980,1.0,0,0,980,0,1978,295000.0
4.0,3.0,2530,1.0,0,0,1470,1060,1976,625000.0
4.0,3.0,2390,2.0,0,0,2390,0,1974,290000.0
4.0,2.5,3600,2.0,0,0,3600,0,2004,760000.0
4.0,2.5,3270,1.0,0,0,1690,1580,1979,560000.0
5.0,2.5,2300,2.0,0,0,2300,0,1994,475000.0
3.0,1.0,1710,1.5,0,0,1710,0,1909,620000.0
4.0,2.0,1170,1.0,0,0,1170,0,1955,330000.0
3.0,2.25,1990,1.0,0,0,1390,600,1960,620000.0
4.0,1.75,1710,1.5,0,0,1710,0,1969,320000.0
3.0,2.5,1740,2.0,0,0,1120,620,1996,525000.0
4.0,3.75,3320,2.0,0,0,3320,0,2005,802500.0
4.0,1.0,1960,2.0,0,0,1960,0,1907,569500.0
6.0,3.5,2820,1.0,0,0,1620,1200,1958,850000.0
3.0,1.0,1590,1.5,0,0,1590,0,1922,630000.0
4.0,2.25,2490,1.0,0,1,1400,1090,1979,454800.0
3.0,1.0,870,1.0,0,0,870,0,1969,177000.0
3.0,1.75,1860,1.0,0,0,1860,0,1971,275000.0
3.0,2.0,2930,2.0,0,0,2240,690,1990,460000.0
3.0,1.0,1580,2.0,0,0,1580,0,1908,729000.0
4.0,3.25,4110,2.0,0,2,4110,0,1995,935000.0
3.0,2.0,1410,1.0,0,0,1410,0,1940,481450.0
3.0,2.0,2090,1.5,0,0,1490,600,1930,860000.0
3.0,1.75,1400,1.0,0,0,1400,0,1958,274000.0
3.0,3.5,1690,2.0,0,0,1360,330,2008,499000.0
5.0,2.25,3210,1.5,0,0,3210,0,1979,696500.0
3.0,1.0,1190,1.5,0,0,1190,0,1935,390000.0
3.0,1.0,960,1.0,0,0,960,0,1922,265000.0
4.0,2.25,2380,2.0,0,0,1530,850,1979,470000.0
2.0,1.0,1020,1.0,0,0,1020,0,1935,168500.0
3.0,1.75,1290,1.0,0,0,1290,0,1983,220000.0
3.0,2.0,1830,1.0,0,0,1100,730,1948,295000.0
5.0,4.0,4770,2.0,0,0,4770,0,1990,1475000.0
2.0,2.5,2910,2.0,1,4,1940,970,1985,1295000.0
3.0,1.0,950,1.0,0,0,950,0,1959,285000.0
3.0,1.0,1160,1.0,0,0,1160,0,1968,294950.0
4.0,4.0,4930,2.0,0,3,4930,0,2004,1465000.0
3.0,1.75,1780,1.0,0,0,980,800,1944,565500.0
3.0,2.0,1410,1.0,0,0,1410,0,1980,230000.0
4.0,3.5,2700,1.5,0,0,2700,0,1948,569950.0
2.0,1.5,1790,1.0,0,0,920,870,1915,721000.0
3.0,2.5,4040,2.0,0,0,2900,1140,2006,565000.0
3.0,1.75,1990,1.0,0,0,1030,960,1978,438000.0
3.0,1.75,2150,1.0,0,0,1650,500,1978,369900.0
4.0,2.5,1850,2.0,0,0,1850,0,1997,405000.0
3.0,2.5,1680,1.0,0,0,1240,440,1994,282000.0
2.0,1.0,1430,1.0,0,0,1110,320,1944,380950.0
3.0,1.0,960,1.0,0,0,960,0,1958,349810.0
4.0,2.5,2700,2.0,0,0,2700,0,2004,690000.0
2.0,1.5,1290,1.0,0,0,1050,240,1947,653000.0
3.0,2.5,1860,2.0,0,0,1860,0,1986,526500.0
4.0,3.5,4320,2.0,0,0,3280,1040,2005,1040000.0
3.0,1.0,2130,1.5,0,0,2130,0,1917,335000.0
2.0,1.75,2870,2.0,0,2,1770,1100,1994,570000.0
5.0,3.5,3740,2.0,0,0,3740,0,2013,1080000.0
3.0,2.5,2130,2.0,0,0,2130,0,1985,475000.0
4.0,2.0,1210,1.0,0,0,1210,0,1941,315000.0
6.0,2.0,2800,1.0,0,0,1400,1400,1954,405000.0
5.0,2.25,3040,2.0,0,0,3040,0,1984,562000.0
3.0,2.5,1570,2.0,0,0,1570,0,1993,295000.0
3.0,2.25,2090,1.0,0,0,2090,0,1961,383000.0
3.0,2.25,1690,1.0,0,0,1250,440,1985,242000.0
3.0,1.5,1470,1.0,0,0,1470,0,1967,352500.0
4.0,1.0,1460,1.0,0,0,730,730,1941,239950.0
4.0,2.5,3030,2.0,0,0,2530,500,1947,998000.0
3.0,1.75,1190,1.0,0,0,1190,0,1922,515000.0
5.0,1.0,1840,1.5,0,0,1840,0,1920,590000.0
4.0,3.75,3560,2.0,0,0,3560,0,1972,1160000.0
3.0,1.75,1580,1.0,0,0,1580,0,1954,289000.0
3.0,1.5,1230,1.0,0,0,1230,0,1953,424000.0
4.0,2.0,1440,1.0,0,0,1440,0,1943,199000.0
4.0,3.5,4420,2.0,0,0,3350,1070,2004,730000.0
3.0,1.0,910,1.0,0,0,910,0,1971,244000.0
2.0,1.0,670,1.0,0,0,670,0,1942,240000.0
4.0,2.75,2650,2.0,0,0,2650,0,1959,797000.0
4.0,2.25,2220,2.0,0,0,2220,0,1999,350000.0
3.0,1.75,1640,1.0,0,0,1190,450,1972,415000.0
2.0,1.0,770,1.0,0,0,770,0,1947,378510.0
4.0,3.5,3960,2.0,0,0,2850,1110,2006,1195000.0
2.0,1.5,1140,1.0,0,0,1140,0,1925,379900.0
3.0,2.5,2480,2.0,0,0,2480,0,2004,620000.0
3.0,1.5,1580,1.0,0,0,900,680,1946,524500.0
4.0,2.75,1990,1.0,0,0,1270,720,1999,270000.0
4.0,2.25,1830,1.0,0,0,1200,630,1989,236000.0
2.0,2.0,840,1.5,0,0,840,0,1942,308500.0
5.0,2.25,3320,1.0,0,0,1660,1660,1963,989900.0
4.0,2.25,2050,2.0,0,0,2050,0,1977,299000.0
2.0,1.75,1560,2.0,0,0,1560,0,1967,295000.0
2.0,1.0,800,1.0,0,0,800,0,1927,110000.0
2.0,1.0,1190,1.0,0,0,1190,0,1948,295950.0
3.0,1.75,1300,1.0,0,0,650,650,1918,270000.0
4.0,2.5,3400,2.0,0,0,3400,0,2001,712000.0
2.0,1.5,1170,3.0,0,0,1170,0,2000,475000.0
4.0,2.5,2510,2.0,0,0,2510,0,2001,410000.0
4.0,2.25,2510,1.0,0,0,1810,700,1977,588000.0
3.0,2.5,2390,2.0,0,0,1970,420,2006,420000.0
4.0,2.25,2200,2.0,0,0,2200,0,2005,355000.0
2.0,1.0,2550,1.0,0,1,1610,940,1958,446000.0
4.0,2.25,2560,1.0,0,0,1760,800,1976,765000.0
3.0,3.75,3250,2.0,0,2,2370,880,1951,967500.0
2.0,2.0,1340,1.0,0,0,1340,0,2004,381000.0
3.0,2.25,2840,2.0,0,0,2840,0,1983,490000.0
4.0,2.25,2480,1.0,0,0,1900,580,1975,716000.0
5.0,3.5,3060,2.0,0,0,3060,0,1989,605000.0
4.0,2.5,2910,2.0,0,0,2910,0,2004,312200.0
4.0,1.0,1900,1.0,0,0,1290,610,1948,327000.0
4.0,1.75,1300,1.0,0,0,1300,0,1969,229950.0
3.0,1.5,1480,1.0,0,0,1000,480,1980,160000.0
3.0,1.0,1250,1.0,0,0,1250,0,1972,255000.0
4.0,2.5,2000,1.5,0,0,1220,780,1944,530000.0
3.0,1.5,1330,1.0,0,0,900,430,1971,239000.0
3.0,2.25,1840,1.0,0,0,1270,570,1983,285000.0
4.0,2.0,1560,1.5,0,0,1140,420,1945,537000.0
3.0,2.5,3150,2.0,0,0,3150,0,2006,530000.0
3.0,2.25,1560,2.0,0,0,1560,0,1990,213675.0
5.0,2.5,2910,1.0,0,0,1690,1220,1964,530000.0
3.0,2.5,2940,2.0,0,0,2940,0,1994,780000.0
3.0,1.0,950,1.0,0,0,950,0,1947,390000.0
2.0,1.0,1200,1.0,0,0,1070,130,1940,450000.0
2.0,1.0,1000,1.0,0,0,1000,0,1953,420000.0
3.0,2.0,1490,1.0,0,0,1490,0,1959,550000.0
2.0,1.0,600,1.0,0,0,600,0,1943,110000.0
2.0,1.75,2320,1.5,0,2,1720,600,1925,700000.0
4.0,2.5,3190,2.0,0,0,3190,0,2002,807500.0
2.0,1.0,990,1.0,0,0,990,0,1977,179000.0
4.0,2.75,5470,2.0,1,4,3730,1740,1992,1612500.0
4.0,2.75,2890,2.0,0,0,2890,0,1981,655000.0
3.0,2.0,1790,1.0,0,0,1240,550,1964,472500.0
4.0,2.5,2350,2.0,0,0,2350,0,1998,299000.0
4.0,2.5,3430,2.0,0,0,3430,0,2000,740000.0
3.0,1.75,2600,1.0,0,0,1700,900,1967,860000.0
4.0,3.0,2130,1.0,0,0,1440,690,1948,620000.0
3.0,1.75,1660,1.0,0,0,960,700,1982,410000.0
5.0,3.5,2473,2.0,0,1,2473,0,1963,343000.0
2.0,2.75,1430,2.0,0,0,995,435,2006,465000.0
3.0,2.25,1570,2.0,0,0,1570,0,2002,273950.0
2.0,1.0,1240,1.0,0,1,1240,0,1915,825000.0
3.0,2.5,1720,2.0,0,0,1720,0,2014,255000.0
3.0,2.0,1140,1.0,0,0,1140,0,1998,250000.0
4.0,3.25,2690,2.0,0,3,1720,970,1978,635000.0
3.0,1.75,1520,1.0,0,0,1520,0,1966,240000.0
4.0,2.25,2040,2.0,0,0,2040,0,2012,670000.0
3.0,2.5,2830,1.0,0,3,1730,1100,1954,713414.0
3.0,1.5,1340,1.0,0,0,1340,0,1966,245000.0
4.0,2.5,2520,1.0,0,0,1680,840,1968,600000.0
3.0,2.5,1660,2.0,0,0,1660,0,2002,270000.0
2.0,1.0,880,1.0,0,0,880,0,1943,190000.0
3.0,2.0,980,1.0,0,0,980,0,1940,435000.0
4.0,1.0,1360,1.5,0,0,1360,0,1900,560000.0
3.0,3.75,3710,2.0,0,0,2910,800,1978,998000.0
3.0,1.0,940,1.0,0,0,940,0,1952,725000.0
2.0,1.0,970,1.0,0,0,970,0,1968,210000.0
3.0,2.25,1500,3.0,0,0,1500,0,2007,513000.0
5.0,2.5,2780,1.0,0,0,1390,1390,1967,290000.0
3.0,2.5,3110,1.0,0,1,1640,1470,1954,1260000.0
3.0,2.25,1860,2.0,0,0,1860,0,1995,330000.0
3.0,1.0,1010,1.0,0,0,1010,0,1958,189000.0
3.0,2.25,2850,2.0,0,2,1900,950,1947,907500.0
3.0,2.25,2280,1.0,0,0,2280,0,1978,410000.0
4.0,3.0,3080,2.0,0,3,3080,0,1961,1050000.0
4.0,2.5,2280,1.5,0,0,1510,770,1942,622100.0
3.0,1.5,2030,1.0,0,0,1310,720,1969,250000.0
4.0,3.0,2570,2.0,0,0,1750,820,1909,1180000.0
3.0,2.75,3640,1.0,0,0,2060,1580,1979,925000.0
3.0,2.0,1760,1.0,0,0,960,800,1931,554000.0
3.0,2.5,2760,2.0,0,0,2760,0,2002,545000.0
3.0,2.5,2650,2.0,0,0,2650,0,2005,660000.0
5.0,4.5,5160,2.0,0,0,5160,0,1996,1900000.0
4.0,2.0,1480,1.0,0,0,1480,0,1974,260000.0
3.0,1.0,860,1.0,0,0,860,0,1944,219900.0
4.0,2.5,2610,2.0,0,0,2610,0,2004,373500.0
2.0,1.0,1470,1.0,0,0,1470,0,1949,380000.0
4.0,2.5,4570,2.0,0,2,4570,0,1990,1060000.0
3.0,3.0,3410,2.0,1,4,2220,1190,1973,2600000.0
3.0,2.25,1760,2.0,0,0,1760,0,1983,450000.0
3.0,1.75,2040,1.0,0,0,2040,0,1987,379950.0
3.0,3.5,3470,3.0,0,0,3470,0,2008,834800.0
2.0,1.0,680,1.0,0,0,680,0,1917,365000.0
2.0,2.0,1494,2.0,1,4,1494,0,1943,465000.0
3.0,1.5,1250,1.0,0,0,1250,0,1955,452000.0
3.0,3.0,3570,2.0,0,2,2710,860,1985,840000.0
4.0,2.0,2000,1.5,0,0,1480,520,1930,465000.0
3.0,2.5,2030,2.0,0,0,2030,0,2003,295000.0
3.0,1.0,1390,1.0,0,0,1390,0,1949,396000.0
2.0,1.0,1030,1.5,0,0,1030,0,1942,397000.0
3.0,1.0,1280,1.5,0,0,1280,0,1954,240000.0
3.0,2.5,2370,2.0,0,0,2370,0,1987,300523.0
3.0,2.0,1380,2.0,0,0,1380,0,1946,215500.0
5.0,3.0,2320,1.0,0,0,1370,950,1986,552500.0
5.0,1.5,2050,1.0,0,0,1520,530,1968,375000.0
3.0,1.0,1210,1.0,0,0,1210,0,1918,160000.0
4.0,2.5,3270,2.0,0,0,3270,0,1989,1070000.0
3.0,2.5,2450,2.0,0,0,1800,650,1922,952000.0
5.0,1.75,1890,1.5,0,0,1090,800,1906,523460.0
4.0,2.5,2007,2.0,0,0,2007,0,2009,305950.0
3.0,2.5,1430,2.0,0,0,1430,0,1991,220000.0
2.0,1.75,2056,1.0,0,0,1048,1008,1980,289000.0
5.0,2.5,2210,1.0,0,2,1430,780,1964,648000.0
5.0,1.75,2330,1.5,0,0,2080,250,1937,825000.0
4.0,2.0,2070,2.0,0,0,2070,0,1982,400000.0
2.0,2.5,1480,3.0,0,0,1480,0,2009,420000.0
2.0,1.75,1160,2.0,0,1,1160,0,1949,389000.0
4.0,2.5,2520,2.0,0,0,2520,0,1906,865000.0
2.0,1.0,1770,1.0,0,3,1220,550,1957,345000.0
3.0,2.5,3110,2.0,0,0,2430,680,1995,700000.0
3.0,2.5,1680,2.0,0,0,1680,0,1982,550000.0
3.0,1.0,1320,1.5,0,0,1320,0,1912,201500.0
3.0,1.0,1320,1.5,0,0,1320,0,1912,459000.0
3.0,2.5,1810,1.0,0,0,1310,500,1984,327000.0
1.0,1.0,1140,1.5,0,0,1140,0,1920,540000.0
5.0,2.5,4600,1.0,0,3,2300,2300,1956,805000.0
3.0,2.0,1840,1.0,0,0,1840,0,1908,521000.0
3.0,1.5,2000,1.0,0,0,1520,480,1965,375000.0
3.0,1.75,1480,1.0,0,0,1080,400,1978,235000.0
4.0,2.5,2040,2.0,0,0,2040,0,1994,240000.0
4.0,2.25,2060,1.0,0,0,2060,0,1968,575000.0
6.0,3.5,3720,2.0,0,0,3720,0,2003,1520000.0
4.0,2.5,3002,2.0,0,0,3002,0,2004,394500.0
3.0,1.0,1060,1.0,0,0,1060,0,1970,174950.0
4.0,2.0,1830,1.0,0,0,1060,770,1966,383000.0
3.0,2.0,1550,1.0,0,0,1550,0,1958,249950.0
3.0,2.5,1690,2.0,0,0,1690,0,1979,431000.0
3.0,1.75,2580,1.0,0,0,1290,1290,1951,459900.0
5.0,2.5,2510,1.0,0,0,1490,1020,1977,475000.0
3.0,2.25,1290,2.0,0,0,1290,0,1987,605000.0
4.0,2.0,1450,1.0,0,0,1450,0,1967,234950.0
4.0,2.5,2690,2.0,0,0,2690,0,1993,419000.0
4.0,3.25,3340,1.5,0,0,2240,1100,1963,910000.0
4.0,2.5,2600,2.0,0,0,2600,0,1991,392000.0
3.0,2.5,3140,2.0,0,0,2500,640,2001,915000.0
3.0,3.25,3800,2.0,0,3,3800,0,1983,630000.0
4.0,1.75,2320,1.0,0,3,1160,1160,1956,416100.0
4.0,2.5,2360,1.0,0,0,1440,920,1965,285000.0
4.0,1.5,1100,1.0,0,0,1100,0,1960,353000.0
3.0,2.0,1390,1.0,0,0,1390,0,1990,297950.0
2.0,2.0,2180,2.0,0,0,2180,0,1934,750000.0
3.0,3.0,1730,3.5,0,0,1730,0,2006,525000.0
5.0,1.75,2760,1.0,0,0,1510,1250,1968,495000.0
3.0,1.75,2430,1.0,0,1,1620,810,1949,710000.0
3.0,2.0,2010,1.0,0,0,2010,0,1953,310000.0
5.0,1.75,1730,1.0,0,0,1050,680,1978,205000.0
3.0,3.0,2450,1.5,0,3,2450,0,2004,530000.0
4.0,2.5,3300,2.0,0,0,3300,0,1998,725000.0
2.0,1.0,720,1.0,0,0,720,0,1947,195000.0
3.0,2.0,1240,1.0,0,0,1000,240,1984,401000.0
5.0,2.5,3050,1.0,0,4,1650,1400,1962,1030000.0
3.0,1.5,1590,1.5,0,0,1590,0,1971,251000.0
3.0,2.0,2040,1.0,0,0,1020,1020,1949,667500.0
4.0,2.5,1840,2.0,0,0,1840,0,2004,300000.0
4.0,2.25,1960,2.0,0,0,1960,0,1973,610000.0
4.0,5.0,4110,2.0,0,0,4110,0,1978,1042030.0
3.0,2.25,1830,1.0,0,0,1400,430,1976,430000.0
2.0,1.0,1330,1.0,0,0,1330,0,1950,455000.0
5.0,2.0,2190,1.0,0,0,1110,1080,1965,600000.0
3.0,3.25,1720,2.5,0,2,1410,310,2004,638000.0
3.0,1.75,1710,1.0,0,0,1360,350,1918,561000.0
3.0,2.5,2180,1.0,0,0,1240,940,1977,625000.0
3.0,1.75,1700,1.0,0,0,1180,520,1977,263950.0
3.0,2.5,2960,2.0,0,2,2960,0,1978,740000.0
3.0,1.0,1330,1.0,0,0,1330,0,1948,234999.0
4.0,2.5,1940,2.0,0,0,1940,0,2004,380000.0
3.0,2.25,1500,1.0,0,0,1170,330,1989,329500.0
4.0,2.5,2230,1.0,0,0,1230,1000,1978,464950.0
3.0,2.25,1700,1.0,0,0,1340,360,1985,500000.0
4.0,1.5,1840,1.5,0,0,1840,0,1950,415000.0
3.0,2.25,2100,2.0,0,0,2100,0,1983,437500.0
7.0,2.5,2580,1.0,0,0,1880,700,1901,599000.0
4.0,2.5,2350,2.0,0,0,2350,0,1997,367000.0
2.0,1.0,760,1.0,0,0,760,0,1922,530000.0
5.0,3.5,3280,2.0,0,0,2440,840,2003,989000.0
3.0,2.0,1320,1.0,0,0,1020,300,1940,462600.0
3.0,2.5,1690,1.0,0,0,1690,0,1973,875000.0
3.0,2.25,2060,1.0,0,2,1600,460,1976,335000.0
4.0,2.0,1450,1.0,0,0,1450,0,1951,393000.0
4.0,3.0,2760,2.0,0,1,1840,920,1938,1340000.0
3.0,2.5,2830,2.0,0,0,2830,0,2001,590000.0
4.0,2.75,1890,2.0,0,0,1200,690,2015,671000.0
3.0,3.25,2610,1.5,0,0,1660,950,1909,925000.0
3.0,2.25,1900,1.0,0,0,1250,650,1967,245000.0
3.0,1.0,930,1.0,0,0,930,0,1952,392500.0
4.0,2.0,2730,1.0,0,0,1410,1320,1998,505000.0
4.0,2.5,2650,2.0,0,0,2650,0,2013,702000.0
2.0,1.0,1010,1.0,0,0,1010,0,1947,337000.0
4.0,2.5,3550,2.0,0,0,3550,0,1996,920000.0
3.0,1.75,2130,1.0,0,0,1720,410,1959,495500.0
2.0,1.75,1840,1.0,0,0,1570,270,1938,245000.0
2.0,1.0,1320,1.5,0,0,1320,0,1909,395000.0
3.0,1.0,990,1.0,0,0,990,0,1970,335000.0
2.0,1.75,1020,1.0,0,0,1020,0,1983,187000.0
4.0,2.0,1570,1.0,0,0,1570,0,1960,450000.0
4.0,2.25,1930,1.0,0,0,1360,570,1988,280000.0
5.0,4.0,3760,1.0,0,3,1910,1850,1969,1375000.0
2.0,1.0,1000,1.0,0,0,1000,0,1960,265000.0
3.0,1.75,1930,1.0,0,0,1930,0,1958,795000.0
3.0,1.5,2240,2.0,0,0,1370,870,1929,510000.0
4.0,2.5,2190,1.0,0,0,1430,760,1972,699900.0
4.0,2.75,2400,1.0,0,2,1760,640,1958,839000.0
4.0,1.75,1970,1.0,0,0,1220,750,1968,396000.0
3.0,2.25,2860,2.0,0,0,2860,0,1983,365000.0
3.0,2.25,1900,1.0,0,0,1220,680,1970,440000.0
4.0,2.5,2090,2.0,0,0,2090,0,1997,405000.0
3.0,1.5,850,1.0,0,0,850,0,1986,295000.0
4.0,2.5,1840,2.0,0,0,1400,440,2004,275000.0
2.0,1.0,820,1.0,0,0,820,0,1930,295000.0
5.0,3.5,4370,2.0,0,0,3270,1100,1990,1500000.0
3.0,3.5,3190,2.0,0,0,2560,630,1994,795000.0
5.0,3.5,3480,2.0,0,0,2490,990,1983,650000.0
3.0,1.0,1690,1.0,0,0,1690,0,1959,260000.0
2.0,2.5,1650,2.0,0,2,1650,0,2008,382000.0
4.0,2.5,2590,2.0,0,0,2590,0,1985,790100.0
4.0,2.5,2160,2.0,0,0,2160,0,1993,220000.0
4.0,3.5,3500,2.0,0,0,2500,1000,1994,799000.0
4.0,2.25,3920,2.0,0,0,3120,800,1928,1480000.0
4.0,2.75,2190,2.0,0,0,2190,0,1993,367300.0
4.0,2.0,1890,1.5,0,0,1490,400,1907,805000.0
2.0,1.0,1860,1.0,0,0,1010,850,1920,730000.0
3.0,2.0,1720,1.0,0,0,1160,560,1969,402000.0
4.0,2.75,2600,1.0,0,0,1560,1040,1976,750000.0
3.0,1.5,1570,1.0,0,0,1570,0,1972,458000.0
3.0,2.5,3530,2.0,0,0,3530,0,1997,898000.0
4.0,2.5,1960,2.0,0,0,1960,0,1998,308000.0
3.0,2.5,2230,2.0,0,0,2230,0,2004,385000.0
4.0,3.0,2720,1.5,0,0,1790,930,1928,1020000.0
5.0,3.0,2840,2.0,0,0,2440,400,1905,1425000.0
3.0,1.75,1260,1.0,0,0,1260,0,1984,240000.0
3.0,1.5,1860,1.0,0,0,1860,0,1967,217000.0
4.0,1.75,2010,1.0,0,2,1610,400,1937,972000.0
2.0,1.0,820,1.0,0,0,820,0,1944,361280.0
3.0,1.75,1220,1.0,0,0,620,600,1905,385000.0
3.0,2.5,2220,2.0,0,0,2220,0,1987,475000.0
4.0,2.5,2860,1.5,0,2,1720,1140,1924,724950.0
5.0,4.5,4230,2.0,0,0,4230,0,1999,935000.0
3.0,1.0,840,1.0,0,0,840,0,1961,169950.0
3.0,2.5,2290,2.0,0,0,2290,0,2001,585000.0
3.0,2.5,2290,2.0,0,0,2290,0,2001,585000.0
5.0,3.5,3480,2.0,0,2,2890,590,2004,480000.0
4.0,2.5,4260,1.5,0,0,4100,160,1935,635000.0
3.0,2.5,2230,2.0,0,0,2230,0,2004,368750.0
6.0,2.0,3080,2.0,0,0,3080,0,1900,432500.0
3.0,2.5,2250,2.0,0,0,2250,0,2004,589000.0
4.0,3.25,3160,2.0,0,0,2280,880,2004,840000.0
3.0,2.5,1770,2.0,0,0,1770,0,2005,316500.0
4.0,2.5,2880,2.0,0,0,2880,0,2006,536000.0
4.0,2.75,2690,1.0,0,0,1750,940,1978,563750.0
4.0,1.0,1730,1.5,0,0,1730,0,1970,152500.0
4.0,1.0,1730,1.5,0,0,1730,0,1970,267950.0
5.0,4.0,4780,2.0,0,0,4780,0,1994,1640000.0
4.0,2.5,2540,2.0,0,0,2540,0,1977,269950.0
4.0,3.0,2630,2.0,0,0,2630,0,2006,731688.0
3.0,1.5,1890,1.0,0,0,1190,700,1959,240000.0
2.0,1.0,1220,1.0,0,0,1220,0,1961,555950.0
2.0,1.0,710,1.0,0,0,710,0,1942,289000.0
3.0,2.5,2970,1.0,0,0,1770,1200,1995,525000.0
3.0,2.5,2970,1.0,0,0,1770,1200,1995,745000.0
2.0,1.0,1000,1.0,0,2,1000,0,1939,397000.0
3.0,1.0,1980,1.0,0,0,1030,950,1965,233000.0
4.0,2.25,1920,2.0,0,0,1920,0,1979,625000.0
3.0,2.0,2740,2.0,0,4,2740,0,1988,535000.0
3.0,2.25,1740,1.0,0,0,1380,360,1973,270000.0
3.0,1.75,1300,1.0,0,0,1300,0,1967,360000.0
4.0,1.5,2740,2.0,0,0,1930,810,1905,1105000.0
4.0,1.75,4060,2.0,0,3,2890,1170,1953,970000.0
5.0,2.5,3490,1.0,0,4,1840,1650,1958,915000.0
4.0,1.75,1430,1.0,0,0,1130,300,1960,412000.0
4.0,1.75,1860,1.0,0,0,1110,750,1963,265000.0
4.0,2.25,2120,1.0,0,0,1490,630,1976,426000.0
4.0,2.25,1860,1.0,0,0,1140,720,1978,266000.0
3.0,2.0,2330,1.5,0,0,1430,900,1900,325000.0
3.0,1.75,1670,1.0,0,2,990,680,1954,615000.0
3.0,1.75,2130,1.0,0,0,1580,550,1979,310000.0
4.0,1.75,1900,1.0,0,0,1900,0,1973,340000.0
2.0,1.0,1170,1.5,0,0,1170,0,1905,562500.0
2.0,1.0,980,2.0,0,0,980,0,2010,447000.0
7.0,4.25,4670,2.0,0,2,4670,0,1992,2450000.0
4.0,1.5,2500,1.0,0,0,1500,1000,1961,250000.0
4.0,2.5,2020,2.0,0,0,2020,0,1990,633000.0
3.0,2.0,1290,3.0,0,0,1290,0,2004,310000.0
2.0,1.75,1620,1.5,0,0,1620,0,1995,439000.0
3.0,3.25,1710,2.0,0,0,1360,350,2003,470000.0
3.0,2.5,1720,1.0,0,0,1720,0,1968,270000.0
3.0,1.75,1820,2.0,0,0,1820,0,1994,299500.0
3.0,1.0,1130,1.0,0,0,1130,0,1954,227000.0
4.0,2.75,3040,2.0,1,4,3040,0,1966,735000.0
3.0,3.0,2410,2.0,0,2,2410,0,1942,537000.0
4.0,2.5,2440,1.0,0,0,1660,780,1970,699000.0
2.0,1.0,800,1.0,0,0,600,200,1929,330000.0
3.0,1.0,1030,1.0,0,0,1030,0,1954,229000.0
3.0,1.0,1480,1.0,0,0,940,540,1947,200000.0
3.0,1.75,1710,1.0,0,0,1710,0,1966,522500.0
3.0,2.75,3450,1.5,0,3,2590,860,1925,1295000.0
3.0,3.25,2610,2.0,1,4,2610,0,2006,2000000.0
2.0,0.75,780,1.0,0,0,780,0,1945,200000.0
3.0,1.75,1260,1.0,0,0,1260,0,1971,352000.0
4.0,3.0,2590,2.0,0,2,2240,350,1964,855000.0
3.0,2.5,1580,2.0,0,0,1580,0,1993,267000.0
2.0,1.75,1660,1.0,0,0,1160,500,1942,484000.0
4.0,2.75,2950,1.0,0,0,2120,830,1974,402000.0
4.0,2.25,2240,2.0,0,0,1770,470,1900,905000.0
4.0,1.75,1940,1.0,0,0,1720,220,1966,274000.0
3.0,1.75,1850,1.0,0,0,1850,0,1962,475000.0
4.0,4.5,5770,1.0,0,3,3160,2610,1949,1535000.0
4.0,2.0,2280,1.0,0,0,1140,1140,1900,628000.0
6.0,1.75,2740,1.0,0,3,1370,1370,1953,675000.0
4.0,3.25,3760,2.0,0,0,2740,1020,2007,429900.0
3.0,1.5,1580,1.0,0,0,1140,440,1954,260000.0
3.0,1.75,1600,1.0,0,0,1030,570,1941,690000.0
4.0,2.25,2100,1.0,0,0,2100,0,1961,1081000.0
4.0,2.5,2610,2.0,0,0,2610,0,1988,360000.0
3.0,1.75,1840,1.0,0,0,920,920,1910,499000.0
3.0,1.0,1320,1.0,0,0,1320,0,1952,159000.0
3.0,1.75,1540,1.0,0,0,940,600,1947,430000.0
5.0,2.75,2520,1.0,0,0,1660,860,1959,1050000.0
5.0,2.5,3780,1.0,0,1,1890,1890,1978,725000.0
3.0,1.0,1200,1.0,0,0,1200,0,1959,150000.0
4.0,2.25,2720,2.0,0,0,2720,0,1976,840000.0
4.0,2.5,3100,2.0,0,0,3100,0,2011,499000.0
3.0,1.75,1630,1.0,0,0,1100,530,1968,285000.0
4.0,2.5,1910,1.0,0,0,1210,700,1987,340000.0
4.0,2.0,1580,1.0,0,0,1580,0,1955,405100.0
3.0,2.5,1690,2.0,0,0,1690,0,2003,464000.0
4.0,2.25,1960,1.0,0,0,1290,670,1959,723000.0
8.0,3.25,4300,2.0,0,0,2800,1500,1979,430000.0
3.0,1.75,1840,1.0,0,0,940,900,1907,645000.0
4.0,2.75,3480,2.0,0,2,2630,850,1979,1580000.0
5.0,3.0,2710,2.0,0,0,1890,820,1919,925000.0
4.0,1.75,2100,1.0,0,0,1340,760,1975,759000.0
4.0,2.0,1760,1.0,0,0,1760,0,1954,690000.0
4.0,2.5,2155,2.0,0,0,2155,0,1996,358800.0
5.0,1.5,1720,1.5,0,0,1520,200,1925,683000.0
3.0,1.0,1430,1.5,0,0,1430,0,1924,650000.0
5.0,2.75,2790,1.5,0,0,2140,650,1949,288000.0
3.0,1.5,1180,1.0,0,0,1180,0,1968,209950.0
3.0,3.5,2450,2.0,0,4,1960,490,1933,939000.0
3.0,1.0,1330,1.0,0,0,930,400,1954,320000.0
3.0,2.25,1940,2.0,0,0,1940,0,1989,283748.0
3.0,2.25,1600,1.0,0,0,1280,320,1987,370000.0
4.0,2.75,3210,1.0,0,0,1610,1600,1989,399950.0
5.0,2.5,2880,1.0,0,0,1680,1200,1976,360000.0
2.0,1.5,1160,1.0,0,0,1160,0,1950,365000.0
3.0,2.0,1360,2.0,0,0,1360,0,1989,396900.0
3.0,2.5,2014,2.0,0,0,2014,0,2005,321000.0
3.0,2.0,1440,1.0,0,0,1440,0,1985,245000.0
2.0,1.0,1570,1.5,0,1,1570,0,1931,502000.0
4.0,2.75,2330,1.0,0,0,1800,530,1990,257000.0
4.0,1.75,1880,1.0,0,0,1010,870,1976,423000.0
4.0,2.25,1850,1.0,0,0,1850,0,1957,485000.0
4.0,2.5,2230,2.0,0,0,2230,0,2002,500000.0
2.0,1.0,990,1.5,0,2,990,0,1917,442000.0
3.0,1.75,1720,1.5,0,0,1720,0,1925,475000.0
4.0,2.25,3230,2.0,0,0,3230,0,1986,625000.0
3.0,1.0,1180,1.0,0,0,820,360,1944,194000.0
3.0,2.25,1450,2.0,0,0,1450,0,1989,410000.0
4.0,2.5,2370,2.0,0,0,2370,0,2003,1034500.0
4.0,2.5,2570,2.0,0,0,2570,0,2006,490000.0
4.0,1.75,1870,1.0,0,0,1480,390,1972,348500.0
3.0,1.0,1220,1.5,0,0,1220,0,1901,380000.0
3.0,2.0,1770,3.0,0,0,1770,0,1999,660000.0
3.0,1.0,1500,1.0,0,0,1500,0,1943,525000.0
3.0,2.0,1110,1.0,0,0,1110,0,1990,235000.0
4.0,3.75,4980,2.0,0,3,4980,0,2006,1210000.0
4.0,1.75,2360,1.0,0,0,1180,1180,1916,397950.0
3.0,1.75,1600,1.0,0,0,1600,0,1999,268000.0
3.0,1.0,1450,1.0,0,1,950,500,1948,525000.0
3.0,2.5,2680,2.0,0,0,2680,0,2001,549950.0
3.0,1.75,1150,1.5,0,0,1150,0,1970,370000.0
4.0,2.25,1870,2.0,0,0,1870,0,1996,299000.0
6.0,2.75,3400,2.0,0,2,2860,540,1977,715000.0
4.0,1.5,1810,1.0,0,0,1810,0,1966,430000.0
3.0,1.75,1860,1.0,0,0,1260,600,1975,345000.0
3.0,3.25,3790,2.0,0,4,3790,0,1985,1600000.0
3.0,2.5,2130,1.0,0,0,1210,920,1994,534640.0
3.0,2.5,2860,2.0,0,2,1980,880,1915,1225000.0
4.0,2.5,2370,2.0,0,0,2370,0,1997,351000.0
4.0,2.25,2290,2.0,0,0,2290,0,1972,745000.0
2.0,1.0,1120,1.0,0,1,750,370,1929,320000.0
3.0,2.0,1810,1.0,0,0,1810,0,1957,555700.0
4.0,2.5,3220,2.0,0,0,3220,0,1991,690000.0
3.0,1.75,1660,1.0,0,0,1660,0,1952,449000.0
2.0,1.0,850,1.0,0,0,850,0,1950,308500.0
4.0,2.5,2665,2.0,0,0,2665,0,2006,340000.0
4.0,2.75,2580,1.5,0,0,1710,870,1917,937750.0
4.0,2.5,3200,2.0,0,0,3200,0,1998,725126.0
3.0,1.0,840,1.0,0,0,840,0,1943,135000.0
4.0,2.5,2970,1.0,0,0,2020,950,1969,635000.0
2.0,1.0,790,1.0,0,0,790,0,1950,245500.0
6.0,1.5,2140,1.5,0,0,2140,0,1903,230000.0
3.0,2.5,2580,1.0,0,2,2580,0,1951,1770000.0
5.0,2.5,2180,1.0,0,0,1200,980,1955,425000.0
2.0,1.0,1060,1.5,0,0,1060,0,1965,220000.0
3.0,2.0,1860,1.5,0,0,1860,0,1939,370000.0
3.0,2.0,1840,1.0,0,0,960,880,1972,390000.0
3.0,1.75,1340,1.0,0,0,1340,0,1968,239000.0
4.0,2.25,2320,2.0,0,0,2320,0,1973,345000.0
3.0,2.5,2110,1.0,0,0,2110,0,1985,289000.0
5.0,1.5,1840,1.5,0,0,1840,0,1962,285000.0
3.0,2.0,1080,1.0,0,0,1080,0,1955,147400.0
2.0,1.0,1290,1.0,0,0,1290,0,1924,600000.0
3.0,2.25,2210,1.0,0,0,1540,670,1967,245000.0
3.0,2.25,2210,1.0,0,0,1540,670,1967,520000.0
3.0,2.25,1410,1.0,0,2,1170,240,1987,352500.0
5.0,3.5,3740,2.0,0,0,2760,980,1998,448000.0
4.0,2.75,2440,1.0,0,0,1200,1240,1963,270000.0
3.0,2.5,2040,1.0,0,0,1840,200,1951,872500.0
4.0,3.25,3840,1.5,0,3,2590,1250,1939,2152500.0
3.0,1.5,1660,1.0,0,0,980,680,1962,225000.0
4.0,2.0,1640,1.5,0,0,1640,0,1911,735000.0
3.0,1.0,1310,1.0,0,0,1310,0,1972,375000.0
3.0,1.75,1720,1.0,0,0,1720,0,1978,169000.0
3.0,1.75,1720,1.0,0,0,1720,0,1978,279950.0
4.0,2.75,4020,2.0,0,4,2830,1190,1989,1950000.0
3.0,2.25,1960,2.0,0,0,1750,210,2003,310000.0
4.0,2.5,3240,2.0,0,0,3240,0,1978,975000.0
10.0,2.0,3610,2.0,0,0,3010,600,1958,650000.0
2.0,1.5,1800,1.0,0,2,1000,800,1942,930000.0
4.0,1.5,1960,1.0,0,0,980,980,1912,412000.0
3.0,1.0,1250,1.0,0,0,1250,0,1965,225000.0
3.0,2.5,2120,2.0,0,0,2120,0,2003,507000.0
4.0,4.0,3860,2.0,0,2,3860,0,1927,1755000.0
3.0,2.5,1340,2.0,0,0,1340,0,1995,230000.0
1.0,2.0,1780,2.0,0,0,1780,0,2001,316000.0
5.0,3.25,3920,2.0,0,0,3030,890,2014,616200.0
3.0,1.75,1690,1.0,0,0,1690,0,1984,509900.0
4.0,2.5,2570,2.0,0,0,2570,0,1987,370000.0
3.0,1.75,1870,1.0,0,0,1870,0,1977,619100.0
3.0,2.25,2860,1.0,0,1,2290,570,1956,805000.0
2.0,1.5,1670,1.0,0,0,1090,580,1950,612125.0
2.0,1.5,1070,3.0,0,0,1070,0,2003,350000.0
2.0,1.0,940,1.0,0,0,940,0,1960,225000.0
3.0,2.5,2588,2.0,0,0,2588,0,2008,335000.0
5.0,3.25,3500,2.0,0,0,3500,0,2001,972800.0
3.0,1.75,1690,1.0,0,0,1690,0,1973,500000.0
4.0,3.75,3790,2.0,0,0,2530,1260,1931,2200000.0
3.0,1.5,1090,1.0,0,0,1090,0,1966,415000.0
3.0,3.0,2240,2.0,0,0,1710,530,1950,399000.0
2.0,1.0,1150,1.0,0,0,1150,0,1947,376000.0
3.0,2.0,1870,1.0,0,0,1120,750,1913,340000.0
5.0,2.75,2990,2.0,0,0,2990,0,1997,490000.0
4.0,2.5,2580,2.0,0,0,2580,0,2004,374000.0
4.0,1.0,2220,1.5,0,0,1470,750,1927,852000.0
3.0,2.25,1620,2.0,0,0,1620,0,1987,473000.0
3.0,1.75,2590,1.0,0,0,1970,620,1968,540000.0
2.0,2.0,1390,1.0,0,0,970,420,1959,431000.0
4.0,3.0,2270,1.0,0,0,1410,860,1979,435000.0
4.0,3.0,2920,1.0,0,3,1460,1460,1964,1051000.0
3.0,2.75,1250,2.0,0,0,1040,210,2010,450000.0
3.0,1.0,1100,1.0,0,0,960,140,1935,157500.0
3.0,1.75,1500,1.0,0,0,1500,0,1976,244000.0
3.0,2.5,2800,2.0,0,0,2800,0,2001,550000.0
4.0,2.5,3420,2.0,0,0,3420,0,2000,975000.0
4.0,2.75,2100,1.0,0,0,2100,0,1990,426500.0
3.0,1.0,1790,1.5,0,0,1090,700,1904,350000.0
3.0,1.0,1790,1.5,0,0,1090,700,1904,615000.0
3.0,2.25,2220,2.0,0,0,2220,0,1985,542000.0
4.0,1.75,2000,1.0,0,3,1000,1000,1956,710000.0
3.0,2.5,1770,1.0,0,0,1770,0,1988,289950.0
4.0,2.75,4280,2.0,0,0,3900,380,1947,1900000.0
2.0,1.0,1260,1.5,0,0,1120,140,1925,528000.0
2.0,1.0,840,1.0,0,0,840,0,1949,471000.0
4.0,2.75,1830,2.0,0,0,1830,0,2001,250000.0
3.0,1.5,970,1.0,0,0,970,0,1966,155000.0
4.0,1.5,1740,1.5,0,0,1400,340,1946,515000.0
3.0,2.25,1654,2.0,0,0,1654,0,1995,336600.0
3.0,2.25,2390,2.0,0,0,1580,810,1925,915000.0
2.0,1.75,1080,2.0,0,0,1080,0,1984,350000.0
4.0,1.75,2610,1.0,0,0,2610,0,1966,1300000.0
3.0,1.0,1070,1.0,0,0,1070,0,1967,175000.0
2.0,2.0,1430,1.0,0,0,1430,0,1949,545000.0
4.0,3.0,2400,2.0,0,2,1600,800,1965,475000.0
2.0,1.0,670,1.0,0,0,670,0,2003,390000.0
4.0,2.5,2860,2.0,0,0,2860,0,1995,645000.0
3.0,1.5,2270,1.0,0,0,1420,850,1954,410000.0
4.0,2.5,2180,2.0,0,2,2180,0,1997,480000.0
3.0,1.75,1860,2.0,0,2,1860,0,1959,725000.0
6.0,4.5,6040,2.0,0,0,4100,1940,1996,1150000.0
2.0,1.0,1010,1.0,0,0,1010,0,1947,300000.0
4.0,2.5,2570,1.0,0,2,1710,860,1961,752000.0
4.0,2.5,1950,2.0,0,0,1950,0,2004,585000.0
3.0,1.75,1970,1.0,0,0,1300,670,1973,678700.0
4.0,2.25,2110,2.0,0,0,2110,0,1975,603000.0
3.0,1.75,1650,1.5,0,4,1150,500,1928,715000.0
4.0,3.0,3520,2.0,0,2,3520,0,1981,1395000.0
3.0,2.5,2840,2.0,0,3,2840,0,1997,1085000.0
2.0,1.75,1490,1.0,0,0,750,740,1918,467500.0
3.0,2.25,1650,1.0,0,0,1230,420,1985,359000.0
4.0,2.0,1960,1.0,0,0,960,1000,1922,745000.0
3.0,2.25,2450,1.0,0,0,2450,0,1978,450000.0
3.0,2.0,1720,1.5,0,0,1060,660,1910,935000.0
3.0,2.5,1980,2.0,0,0,1890,90,2009,615000.0
3.0,2.5,4110,2.0,0,0,4110,0,1976,1031000.0
4.0,2.5,1990,2.0,0,0,1990,0,1999,283500.0
2.0,1.0,860,1.0,0,0,860,0,1947,340000.0
4.0,2.5,2320,2.0,0,0,2320,0,1994,370000.0
3.0,2.5,4190,2.0,0,0,4190,0,1999,1150000.0
4.0,1.0,1940,1.0,0,0,1080,860,1962,265000.0
4.0,2.25,2520,2.0,0,0,1690,830,1908,480000.0
3.0,2.0,1880,1.0,0,0,1030,850,1927,667500.0
3.0,2.5,2910,2.0,0,0,2910,0,1989,1398000.0
7.0,4.75,5310,2.0,0,0,3650,1660,2013,2300000.0
3.0,2.25,2670,1.0,0,0,1640,1030,1966,465000.0
1.0,1.0,470,1.0,0,2,470,0,1924,192500.0
3.0,1.0,1060,1.0,0,0,760,300,1943,345000.0
3.0,1.5,1120,1.0,0,0,1120,0,1956,439800.0
4.0,1.75,2250,1.0,0,0,1330,920,1958,468000.0
4.0,2.5,2070,1.0,0,0,1250,820,1976,775000.0
4.0,2.25,2370,2.0,0,0,2370,0,1979,684680.0
4.0,3.5,3570,2.0,0,0,3570,0,1990,910000.0
4.0,3.25,4830,2.0,1,4,4830,0,1990,3640900.0
3.0,1.75,1160,1.0,0,0,1160,0,1976,375000.0
3.0,2.5,1610,2.0,0,0,1610,0,1994,250000.0
5.0,3.0,4150,2.5,0,4,3510,640,1909,3065000.0
4.0,2.25,1840,1.0,0,0,1390,450,1973,442500.0
3.0,3.5,4080,1.5,0,3,4080,0,2000,900000.0
3.0,2.0,1820,2.0,0,2,1820,0,1937,699000.0
4.0,2.0,2680,1.0,0,0,2680,0,1965,360000.0
4.0,4.75,4790,2.0,0,0,4790,0,1999,1675000.0
5.0,2.0,2420,1.5,0,0,2420,0,1966,675000.0
2.0,1.0,1130,1.0,0,0,1130,0,1921,345000.0
4.0,1.0,1320,1.5,0,0,1320,0,1928,229000.0
3.0,1.0,1290,1.5,0,0,1290,0,1908,300000.0
3.0,3.25,1600,3.0,0,0,1600,0,1998,392500.0
3.0,1.0,1120,1.0,0,0,820,300,1912,552000.0
2.0,1.75,2060,1.0,0,0,1420,640,1940,457000.0
4.0,2.5,2830,2.0,0,0,2830,0,1993,518000.0
3.0,2.0,1210,1.0,0,0,1210,0,1985,237000.0
3.0,2.25,1560,1.0,0,0,1260,300,1988,399950.0
3.0,2.25,2260,2.0,0,0,2260,0,1990,605000.0
4.0,2.5,1850,2.0,0,0,1850,0,1993,295000.0
4.0,2.5,1930,1.0,0,0,1380,550,1978,513000.0
4.0,2.5,3230,2.0,0,0,3230,0,2004,772500.0
4.0,2.5,3230,2.0,0,0,3230,0,2004,765000.0
4.0,2.75,2450,1.5,0,0,1550,900,1920,696950.0
3.0,1.0,1200,1.5,0,0,1200,0,1928,329000.0
3.0,2.5,2360,2.0,0,0,2360,0,1995,339999.0
3.0,1.0,1060,1.0,0,0,1060,0,1959,364500.0
5.0,1.75,2220,1.5,0,0,1420,800,1923,607500.0
3.0,1.0,880,1.0,0,0,880,0,1961,550000.0
4.0,2.0,2510,1.0,0,0,1630,880,1960,479900.0
4.0,4.0,2530,3.0,0,2,2100,430,2013,1120280.0
2.0,1.0,700,1.0,0,0,700,0,1953,192000.0
3.0,2.0,1500,1.0,0,0,1060,440,1977,250000.0
3.0,2.0,1130,2.0,0,0,1130,0,1996,340000.0
3.0,2.0,1420,1.0,0,0,830,590,1942,340000.0
3.0,2.25,2210,1.0,0,0,1510,700,1976,635250.0
2.0,1.0,1170,1.0,0,0,880,290,1949,324800.0
2.0,1.0,780,1.0,0,0,780,0,1942,78000.0
4.0,1.75,1770,1.0,0,0,1770,0,1988,400000.0
3.0,1.0,1070,1.0,0,2,1070,0,1919,640500.0
3.0,2.0,1930,1.0,0,0,1260,670,1964,570000.0
3.0,1.5,1940,1.5,0,2,1940,0,1900,1330000.0
3.0,2.75,1440,1.0,0,0,1040,400,1980,330490.0
3.0,2.5,1740,2.0,0,0,1740,0,1999,325000.0
3.0,2.5,1740,2.0,0,0,1740,0,1999,335000.0
5.0,2.75,2210,1.0,0,0,1460,750,1963,314000.0
4.0,2.0,2190,1.5,0,0,1990,200,1925,625000.0
3.0,2.5,2590,2.0,0,0,2590,0,1988,809000.0
3.0,2.5,2790,2.0,0,0,2790,0,1990,535000.0
5.0,1.75,2180,1.0,0,0,1140,1040,1963,275000.0
4.0,2.75,2580,1.0,0,0,1620,960,1967,358000.0
3.0,2.25,2820,1.0,0,0,1720,1100,1947,297975.0
2.0,1.75,1300,1.0,0,0,1300,0,1945,492000.0
2.0,1.0,720,1.0,0,0,720,0,1943,210000.0
3.0,2.5,2260,1.5,0,0,1380,880,1928,622500.0
3.0,2.5,1550,3.0,0,0,1390,160,2004,550000.0
3.0,1.75,1390,1.0,0,0,1390,0,1965,190000.0
4.0,2.5,2380,2.0,0,0,2380,0,2000,340000.0
3.0,2.5,2640,2.0,0,0,2640,0,2003,678000.0
5.0,2.0,2260,1.0,0,0,1250,1010,1962,275000.0
3.0,2.75,1720,1.0,0,0,1270,450,1947,493000.0
3.0,1.0,1070,1.0,0,0,1070,0,1960,147000.0
3.0,2.25,2000,2.0,0,0,2000,0,1985,334000.0
4.0,2.5,2800,1.0,0,0,1420,1380,1970,605000.0
3.0,1.75,1450,1.0,0,0,1450,0,1976,365000.0
3.0,1.0,1620,1.0,0,0,1620,0,1958,345000.0
3.0,2.5,2710,1.0,0,4,2080,630,1956,999000.0
2.0,1.75,1520,1.0,0,0,840,680,1910,470000.0
5.0,2.75,2730,1.0,0,0,2080,650,1968,599000.0
3.0,2.25,1740,1.0,0,0,1740,0,1977,255000.0
4.0,1.75,1800,1.0,0,0,1800,0,1975,295000.0
4.0,3.5,4150,2.0,0,0,4150,0,2006,550000.0
5.0,3.5,3270,2.0,0,0,2180,1090,2011,1305000.0
2.0,1.0,1070,1.0,0,0,1070,0,1922,225000.0
4.0,0.75,1960,1.0,1,4,1320,640,1923,520000.0
3.0,3.25,1600,2.0,0,0,1360,240,2000,345000.0
4.0,1.75,1650,1.0,0,0,1150,500,1950,475000.0
5.0,1.5,2170,1.0,0,0,1230,940,1959,497500.0
3.0,3.0,3730,1.5,0,0,2230,1500,1990,649500.0
4.0,2.75,3280,2.0,0,0,3280,0,2003,734500.0
3.0,1.0,870,1.0,0,0,870,0,1953,276000.0
2.0,1.0,900,1.0,0,0,900,0,1928,235000.0
2.0,1.0,1400,1.0,0,0,1400,0,1974,325000.0
4.0,2.75,1680,1.0,0,0,1080,600,1979,425000.0
4.0,2.0,2390,2.0,0,0,1720,670,1949,307000.0
3.0,2.5,2300,1.5,0,0,2000,300,1921,635000.0
3.0,1.75,1340,1.0,0,0,1340,0,1973,223000.0
3.0,2.75,2600,2.0,0,0,2600,0,1994,425000.0
3.0,2.25,1640,1.0,0,0,1220,420,1989,190000.0
4.0,1.75,1960,1.0,0,0,1960,0,1967,275000.0
3.0,2.5,1480,2.0,0,0,1480,0,2005,450000.0
4.0,3.25,5010,2.0,0,0,5010,0,1988,1468000.0
4.0,2.0,1540,1.5,0,0,1540,0,1913,550000.0
4.0,2.75,4030,2.0,0,2,3310,720,1943,835000.0
6.0,3.0,3020,2.0,0,0,3020,0,1952,900000.0
2.0,2.0,1590,1.0,0,0,910,680,1983,290000.0
4.0,2.5,2910,2.0,0,0,2910,0,2014,1035000.0
4.0,2.5,3020,1.0,0,0,1730,1290,1976,780000.0
3.0,2.0,2290,2.0,0,0,2290,0,1979,572500.0
3.0,1.75,2180,1.0,0,0,1090,1090,1938,389000.0
4.0,1.75,2740,1.0,0,0,1440,1300,1972,350000.0
4.0,2.5,2740,2.0,0,0,2740,0,1993,476000.0
2.0,3.0,2330,2.0,0,0,1870,460,1927,1046250.0
3.0,2.25,2300,1.0,0,0,1550,750,1978,287000.0
4.0,4.0,1550,1.5,0,0,1550,0,1907,707500.0
4.0,2.5,1750,1.0,0,0,1610,140,1947,464500.0
3.0,1.5,2180,1.0,0,3,1090,1090,1941,720000.0
3.0,2.5,1610,2.0,0,0,1610,0,1994,319000.0
3.0,1.0,1570,1.0,0,0,1570,0,1953,330000.0
3.0,1.75,1140,1.0,0,0,1140,0,1969,120750.0
3.0,1.75,1140,1.0,0,0,1140,0,1969,195000.0
4.0,1.5,2480,1.0,0,0,1380,1100,1946,650000.0
3.0,1.75,1690,1.0,0,0,1690,0,1958,530000.0
4.0,3.0,2910,1.0,0,0,1800,1110,1970,825000.0
4.0,2.0,1600,1.0,0,0,1600,0,1972,436000.0
2.0,1.0,1010,1.0,1,4,1010,0,1926,658000.0
3.0,2.0,1850,1.0,0,0,950,900,1940,547500.0
3.0,1.75,2150,2.0,0,0,1400,750,1906,762000.0
3.0,1.75,2650,1.0,0,0,1460,1190,1952,340000.0
4.0,1.75,2510,1.0,0,2,1830,680,1953,880000.0
4.0,2.5,3240,2.0,0,0,2060,1180,2008,1220000.0
4.0,2.5,3440,2.0,1,4,2170,1270,2012,1950000.0
3.0,2.0,1150,1.0,0,0,1150,0,1952,382500.0
3.0,1.75,1890,1.0,0,0,1210,680,1976,344500.0
4.0,2.75,1430,1.0,0,0,1030,400,1982,375000.0
1.0,0.75,370,1.0,0,0,370,0,1923,276000.0
5.0,3.25,3130,2.0,0,0,2180,950,1975,500000.0
4.0,2.5,2105,2.0,0,0,2105,0,2003,330000.0
3.0,1.0,890,1.0,0,0,890,0,1950,328000.0
3.0,1.5,1340,1.0,0,0,1340,0,1972,450000.0
4.0,2.25,2290,1.0,1,4,1490,800,1948,840500.0
3.0,2.5,2770,2.0,0,3,2770,0,1957,679000.0
3.0,1.5,1890,1.0,0,0,1090,800,1957,270000.0
5.0,2.25,3160,2.0,0,0,3160,0,1977,757500.0
2.0,2.5,1830,2.0,0,0,1830,0,2005,524950.0
4.0,2.75,2950,1.0,0,0,2950,0,1960,424900.0
3.0,1.0,1430,1.0,0,0,1430,0,1954,551100.0
3.0,2.0,1420,1.0,0,0,1420,0,1968,421000.0
4.0,1.75,2460,2.0,0,0,2460,0,1952,635000.0
3.0,1.0,1340,1.5,0,0,1340,0,1920,255000.0
4.0,1.0,1530,1.0,0,0,1030,500,1955,419950.0
6.0,3.0,2650,1.0,0,0,2650,0,1977,325000.0
4.0,2.25,1677,2.0,0,0,1677,0,2012,281000.0
3.0,1.75,2050,1.0,0,0,1460,590,1962,655275.0
3.0,2.0,2520,1.0,0,0,1270,1250,1931,861000.0
3.0,3.5,2620,2.0,0,4,2060,560,1977,850000.0
3.0,2.5,1650,1.0,0,0,1290,360,1990,246000.0
2.0,1.0,700,1.0,0,0,700,0,1926,380000.0
4.0,2.5,3430,2.0,0,0,3430,0,1998,813000.0
4.0,2.5,3140,2.0,0,0,3140,0,1988,990000.0
3.0,2.5,2350,2.0,0,0,1740,610,2003,650000.0
4.0,3.0,1990,2.0,0,0,1990,0,1990,273000.0
4.0,2.5,2050,2.0,0,0,2050,0,1989,398000.0
2.0,1.0,930,1.0,0,0,930,0,1938,200000.0
3.0,1.0,1230,1.0,0,0,1230,0,1955,839000.0
3.0,2.5,1870,1.0,0,0,1250,620,1984,502000.0
3.0,2.25,2110,1.0,0,0,1360,750,1973,305000.0
5.0,3.25,3160,2.0,0,0,3160,0,1980,574950.0
3.0,1.0,1120,1.0,0,0,1120,0,1942,311000.0
3.0,2.25,2750,1.0,1,4,1620,1130,1959,1650000.0
3.0,1.0,1230,1.0,0,0,1230,0,1962,387000.0
3.0,1.5,1190,1.5,0,3,1190,0,1948,375000.0
2.0,1.0,740,1.0,0,0,740,0,1920,175000.0
4.0,2.5,1770,2.0,0,0,1770,0,2003,248000.0
4.0,2.25,1720,1.0,0,0,1350,370,1955,336750.0
4.0,2.5,2770,2.0,0,0,2770,0,1989,685000.0
4.0,2.75,2330,2.0,0,0,2330,0,2004,645000.0
3.0,2.5,1660,2.0,0,0,1660,0,2003,279000.0
2.0,2.5,1730,3.5,0,0,1730,0,2008,479000.0
3.0,2.25,1880,1.0,0,0,1280,600,1962,466000.0
4.0,2.75,2190,2.0,0,0,2190,0,1995,361500.0
3.0,1.75,1720,1.0,0,0,1720,0,1995,404000.0
4.0,3.25,2360,2.0,0,0,2360,0,1990,319000.0
3.0,1.5,1490,1.0,0,0,1490,0,1969,320000.0
4.0,3.75,3490,2.0,0,0,2610,880,2014,1311000.0
3.0,2.75,2370,1.0,0,4,1670,700,1971,1000000.0
4.0,2.5,2290,2.0,0,0,2290,0,1977,660000.0
4.0,3.0,1790,1.5,0,0,1790,0,1901,546000.0
4.0,1.75,1820,1.0,0,0,1190,630,1926,300000.0
2.0,1.5,1760,1.0,0,0,1760,0,1964,500000.0
4.0,2.5,2430,2.0,0,0,2430,0,2003,381500.0
3.0,2.25,2630,2.0,0,0,2630,0,1966,990000.0
4.0,2.5,2390,2.0,0,0,2390,0,2006,278226.0
2.0,1.75,1500,1.0,0,0,1220,280,1947,340000.0
4.0,2.5,2510,1.0,0,0,1520,990,1977,305000.0
4.0,2.5,2420,1.0,0,4,1700,720,1958,760000.0
4.0,1.5,2170,2.0,0,0,2170,0,1952,195000.0
4.0,1.75,1960,1.0,0,0,1260,700,1960,564000.0
4.0,2.25,2280,1.0,0,0,1660,620,1977,539500.0
4.0,1.5,1580,1.0,0,0,790,790,1945,299980.0
4.0,2.5,1850,2.0,0,0,1850,0,1993,290000.0
2.0,1.0,770,1.0,0,0,770,0,1947,257000.0
4.0,3.0,2120,1.5,0,0,1420,700,1985,518500.0
4.0,2.75,3060,1.0,0,0,1810,1250,1982,657000.0
3.0,2.25,2680,2.0,0,0,2680,0,1984,590000.0
4.0,1.75,2220,1.0,0,0,1110,1110,1959,526000.0
2.0,1.0,1150,1.0,0,0,1150,0,1920,254500.0
2.0,1.0,980,1.0,0,0,980,0,1909,575000.0
3.0,1.5,1690,1.0,0,0,1690,0,1967,464550.0
3.0,1.75,1320,1.0,0,0,1320,0,1969,409950.0
2.0,1.0,910,1.0,0,0,910,0,1956,100000.0
2.0,1.5,820,2.0,0,0,820,0,2009,365000.0
3.0,1.0,1300,1.0,0,0,1300,0,1960,208000.0
4.0,2.5,1950,2.0,0,0,1550,400,1998,497950.0
5.0,3.5,3672,2.0,0,0,3006,666,2006,405000.0
3.0,2.5,2740,2.0,0,0,2740,0,1994,568000.0
2.0,1.0,890,1.0,0,0,890,0,1941,334000.0
3.0,2.0,1090,1.0,0,0,1090,0,1961,235000.0
2.0,1.0,1170,1.0,0,0,1170,0,1963,295000.0
4.0,3.0,2600,1.0,0,0,2600,0,1994,610000.0
4.0,1.75,2000,1.0,0,2,1300,700,1959,453500.0
4.0,3.75,3520,1.5,0,0,2200,1320,1913,1220000.0
2.0,1.0,1410,1.0,0,0,1410,0,1968,175000.0
2.0,1.0,1410,1.0,0,0,1410,0,1968,335000.0
3.0,1.5,1950,1.0,0,0,1010,940,1956,275000.0
2.0,1.0,980,1.0,0,0,860,120,1918,400000.0
3.0,2.75,3390,1.0,0,3,1740,1650,1979,915000.0
4.0,2.5,2270,1.0,0,0,1500,770,1972,619850.0
3.0,1.0,1510,1.0,0,0,1010,500,1963,225900.0
2.0,1.5,960,1.0,0,0,960,0,1910,525000.0
4.0,2.25,1900,1.0,0,0,1900,0,1967,215000.0
3.0,2.5,2580,2.0,0,0,2580,0,1986,802000.0
4.0,2.5,2340,2.0,0,0,2340,0,1997,330000.0
3.0,2.25,1580,1.0,0,0,1580,0,1958,549800.0
4.0,1.0,1230,1.5,0,0,1230,0,1954,195500.0
3.0,2.5,1590,2.0,0,0,1590,0,1992,338000.0
4.0,3.25,7000,1.0,1,4,3500,3500,1991,3200000.0
4.0,2.25,1770,1.0,0,0,1770,0,1972,480000.0
4.0,2.5,1850,1.0,0,0,1200,650,1962,383000.0
3.0,1.75,1430,1.0,0,0,1430,0,1975,257000.0
4.0,2.75,2190,2.0,0,0,2190,0,1996,335000.0
4.0,2.5,2310,2.0,0,2,2310,0,2012,422000.0
3.0,1.75,2000,1.0,0,0,1400,600,1963,560000.0
4.0,2.75,3620,2.0,0,0,3620,0,2006,680000.0
2.0,1.0,1210,1.0,0,0,1210,0,1952,320000.0
3.0,2.5,2330,1.0,0,2,2330,0,1996,665000.0
3.0,2.5,2840,2.0,0,0,2840,0,2002,751000.0
6.0,2.75,2410,1.0,0,0,1310,1100,1957,320000.0
4.0,1.75,1820,2.5,0,0,1820,0,1918,290000.0
4.0,2.0,1470,1.0,0,0,1470,0,1967,250000.0
3.0,1.75,1100,1.0,0,0,1100,0,1964,423000.0
4.0,2.5,2050,1.0,0,0,1050,1000,1976,601002.0
2.0,1.5,1240,2.0,0,0,1240,0,2002,352900.0
3.0,2.5,2210,2.0,0,3,2210,0,1995,509950.0
2.0,1.75,1340,3.0,0,0,1340,0,2009,360000.0
4.0,2.75,2580,2.0,0,1,1780,800,1964,1075000.0
3.0,2.5,2390,2.0,0,0,2390,0,2002,349950.0
4.0,2.5,2250,2.0,0,0,2250,0,1987,395000.0
3.0,1.5,2000,1.0,0,0,1540,460,1967,273500.0
4.0,1.75,1870,1.0,0,0,1670,200,1949,700000.0
3.0,2.5,2370,2.0,0,0,2370,0,1985,699000.0
4.0,2.25,2640,1.0,0,0,1620,1020,1980,537000.0
3.0,1.5,1240,1.0,0,0,1240,0,1977,405000.0
2.0,1.0,800,2.0,0,0,800,0,1999,269500.0
4.0,2.5,2050,1.0,0,0,1300,750,1965,260000.0
3.0,2.25,1650,2.0,0,0,1650,0,1988,266750.0
5.0,3.75,4320,2.0,1,4,4320,0,1938,1800000.0
2.0,2.25,2130,1.0,0,0,1830,300,1950,779000.0
3.0,2.5,2840,1.0,0,3,1870,970,1994,500000.0
4.0,1.75,3080,1.5,0,0,3080,0,1950,365000.0
2.0,1.0,1560,1.5,0,1,1560,0,1942,724000.0
4.0,2.75,3220,2.0,0,0,3220,0,1994,890000.0
4.0,2.5,1450,1.5,0,0,1250,200,1902,431000.0
2.0,1.0,960,1.0,0,0,960,0,1947,242000.0
4.0,2.5,2670,2.0,0,0,2670,0,1999,415000.0
7.0,3.75,2310,2.0,0,0,2310,0,1984,727160.0
4.0,3.25,3520,1.0,0,2,2010,1510,1978,1110000.0
2.0,1.75,1090,1.0,0,0,1090,0,1970,265000.0
3.0,1.75,2000,1.0,0,0,1080,920,1903,519000.0
4.0,1.5,1840,2.0,0,0,1840,0,1965,262000.0
4.0,2.5,3160,2.0,0,0,3160,0,1965,1190000.0
3.0,1.75,1520,1.0,0,0,1170,350,1992,295000.0
3.0,1.75,2110,1.0,0,0,1480,630,1978,615000.0
4.0,2.75,3410,1.0,0,4,1710,1700,1958,1100000.0
4.0,2.5,2630,2.0,0,0,2630,0,1992,575000.0
3.0,1.75,1350,3.0,0,0,1350,0,1999,388000.0
4.0,2.5,2860,1.0,0,0,1530,1330,1989,750500.0
3.0,1.75,2310,1.0,0,0,1760,550,1977,527500.0
3.0,2.0,2590,2.0,0,0,1980,610,1988,503000.0
4.0,3.5,3500,2.0,0,0,2560,940,2000,1047000.0
2.0,1.0,800,1.0,0,0,800,0,1953,325000.0
3.0,1.75,1580,1.5,0,0,1580,0,1947,402000.0
3.0,1.5,1560,1.0,0,0,1060,500,1927,370000.0
3.0,1.0,1750,1.0,0,0,1150,600,1956,329950.0
2.0,1.0,600,1.0,0,0,600,0,1943,135000.0
4.0,3.0,1630,1.0,0,0,1110,520,1990,482500.0
4.0,1.5,1260,1.5,0,0,1260,0,1955,259000.0
3.0,2.25,2140,1.0,0,0,1470,670,1978,210000.0
4.0,2.75,2790,2.0,0,0,2790,0,2000,459000.0
3.0,1.75,2530,1.0,0,0,1800,730,1977,375000.0
3.0,2.25,1330,1.0,0,0,900,430,1974,295000.0
3.0,2.0,2700,1.0,0,0,1350,1350,1962,910000.0
4.0,1.0,1740,1.5,0,0,1740,0,1932,470000.0
4.0,2.0,2070,1.5,0,0,2070,0,1940,565000.0
4.0,2.25,2670,1.0,0,0,2170,500,1955,339950.0
5.0,3.0,2200,1.0,0,0,1160,1040,1971,547000.0
2.0,1.0,810,1.0,0,0,810,0,1942,125000.0
4.0,4.75,3970,2.0,0,2,3390,580,1928,2300000.0
3.0,2.5,2370,1.0,0,3,1620,750,1979,348000.0
3.0,1.0,1460,1.0,0,0,1460,0,1961,175000.0
3.0,2.5,1770,2.0,0,0,1770,0,1990,439950.0
3.0,1.0,1120,1.0,0,0,1120,0,1934,230000.0
3.0,2.5,1520,2.0,0,0,1520,0,2005,207000.0
5.0,2.5,3020,1.0,0,0,1510,1510,1978,320000.0
5.0,3.25,5600,2.0,0,0,3440,2160,1988,1089000.0
4.0,1.5,1320,1.0,0,0,1320,0,1954,510000.0
4.0,1.0,1870,1.5,0,0,1670,200,1940,730000.0
3.0,3.75,2460,1.0,0,0,1940,520,1976,750000.0
3.0,1.5,960,1.0,0,0,960,0,1962,237000.0
3.0,2.5,3440,2.0,0,0,3440,0,1990,560000.0
3.0,2.75,3010,1.0,0,0,1890,1120,1970,745000.0
3.0,3.75,6030,2.0,0,0,4440,1590,1991,1825000.0
3.0,2.25,1990,2.0,0,0,1990,0,1967,180000.0
3.0,2.25,1990,2.0,0,0,1990,0,1967,309950.0
4.0,1.0,1710,1.5,0,0,1410,300,1913,715000.0
4.0,2.25,1890,1.5,0,0,1350,540,1918,620000.0
3.0,2.5,1990,2.0,0,0,1990,0,1996,330000.0
4.0,1.75,1600,1.0,0,0,1210,390,1973,525000.0
6.0,2.5,3820,1.0,0,0,2040,1780,1974,611000.0
4.0,2.5,2210,1.0,0,0,1490,720,1990,294000.0
3.0,1.75,2020,1.0,0,0,1480,540,1975,463000.0
3.0,2.0,1770,1.0,0,0,1770,0,1990,320900.0
4.0,2.5,2050,2.0,0,0,2050,0,2005,369950.0
4.0,2.75,3130,2.0,0,0,3130,0,1981,565000.0
4.0,1.5,3520,1.5,0,0,2270,1250,1929,589500.0
4.0,1.75,1810,2.0,0,0,1810,0,1977,400000.0
3.0,2.25,2150,1.0,0,0,1450,700,1977,458000.0
4.0,2.5,2495,2.0,0,0,2495,0,2002,436000.0
3.0,2.0,1290,1.0,0,1,1290,0,1950,310000.0
5.0,2.5,3004,2.0,0,0,3004,0,2006,398000.0
4.0,2.25,2070,1.0,0,0,1390,680,1977,625000.0
5.0,3.25,4050,2.0,0,0,4050,0,1990,1005000.0
2.0,1.0,960,1.0,0,0,740,220,1940,435000.0
3.0,2.25,1900,1.0,0,0,1300,600,1961,250000.0
3.0,1.5,1450,1.0,0,0,1450,0,1961,430000.0
4.0,3.5,2720,2.0,0,0,2250,470,2014,790000.0
5.0,5.25,4830,2.0,0,1,3930,900,1952,1681000.0
4.0,2.75,1920,1.0,0,0,1130,790,1992,250000.0
5.0,1.5,2540,2.0,0,3,2340,200,1954,1120000.0
3.0,1.5,1600,1.0,0,0,1050,550,1965,383900.0
4.0,2.5,2210,2.0,0,0,2210,0,2004,330000.0
3.0,2.5,2510,1.0,0,0,1910,600,1975,624000.0
5.0,2.0,2280,1.0,0,0,1140,1140,1951,383000.0
4.0,3.25,4400,2.0,0,0,4400,0,1993,687000.0
4.0,3.25,3160,2.0,0,0,2460,700,1997,558000.0
3.0,2.0,1380,2.0,0,0,1380,0,1971,275000.0
5.0,2.75,3320,1.0,0,0,2020,1300,1963,687500.0
3.0,2.5,1870,2.0,0,0,1870,0,1989,275000.0
3.0,3.5,3030,2.0,0,2,3030,0,1971,700000.0
2.0,1.75,1210,1.0,0,0,1210,0,1982,342500.0
4.0,2.5,2740,2.0,0,0,2740,0,1995,483500.0
3.0,1.75,1350,1.0,0,0,1350,0,1912,190000.0
3.0,1.75,1350,1.0,0,0,1350,0,1912,300000.0
3.0,2.0,1470,2.0,0,0,1000,470,2007,540000.0
3.0,1.75,1270,2.0,0,0,1270,0,1981,140000.0
4.0,1.75,1680,1.0,0,0,1560,120,1959,275000.0
3.0,2.75,2120,1.0,0,0,2120,0,1958,370000.0
2.0,1.0,1040,1.0,0,0,1040,0,1937,227000.0
4.0,1.0,1730,1.0,0,0,1010,720,1962,312000.0
2.0,1.0,1410,1.5,0,0,1410,0,1918,260000.0
3.0,2.5,1370,2.0,0,0,1370,0,1907,797000.0
6.0,2.0,2840,1.5,0,0,2720,120,1948,640000.0
4.0,1.75,3280,1.0,0,0,2080,1200,1976,605000.0
3.0,2.25,2070,1.0,0,0,1350,720,1987,329950.0
2.0,1.0,960,1.5,0,0,960,0,1946,180000.0
3.0,2.25,1470,1.0,0,0,1160,310,1985,220000.0
4.0,2.25,2430,1.5,0,0,1630,800,1928,723000.0
3.0,1.75,1430,1.0,0,0,1070,360,1928,375000.0
3.0,1.75,1760,1.0,0,0,1760,0,1962,388000.0
5.0,2.0,1730,1.0,0,0,1730,0,1944,249950.0
5.0,1.75,2290,1.0,0,0,1190,1100,1965,390000.0
4.0,1.75,1690,1.0,0,0,1690,0,1959,705000.0
4.0,2.5,3220,1.5,0,0,3220,0,1966,590000.0
4.0,1.75,2130,1.0,0,0,1370,760,1952,292000.0
3.0,2.5,2100,1.0,0,0,2100,0,1990,506000.0
4.0,2.5,2770,2.0,0,0,2770,0,1987,907500.0
4.0,3.25,4040,1.0,0,0,4040,0,1954,2271150.0
4.0,2.75,2500,1.5,0,0,1420,1080,1907,319500.0
5.0,1.75,1580,1.0,0,0,980,600,1913,265000.0
3.0,1.0,1130,1.0,0,0,1130,0,1954,237000.0
5.0,1.0,1500,1.5,0,0,1500,0,1966,235000.0
4.0,2.25,2230,1.5,0,2,1810,420,1928,740000.0
3.0,1.5,1550,1.0,0,0,1080,470,1978,359000.0
4.0,2.5,2230,2.0,0,0,2230,0,1999,334950.0
2.0,1.0,790,1.0,0,0,790,0,1947,259950.0
4.0,2.5,2230,2.0,0,0,2230,0,2006,253000.0
3.0,2.25,1710,2.0,0,0,1710,0,2004,561000.0
2.0,1.5,1260,1.0,0,0,1260,0,1941,455000.0
4.0,2.5,2420,1.0,0,0,920,1500,1968,675000.0
3.0,1.5,1090,1.0,0,0,1090,0,1967,267000.0
4.0,2.5,2689,2.0,0,0,2689,0,2006,368000.0
3.0,1.0,1620,1.5,0,0,1620,0,1928,599995.0
3.0,1.0,940,1.0,0,0,940,0,1966,342500.0
4.0,1.75,1940,1.0,0,0,1940,0,1974,252000.0
3.0,1.0,1590,1.0,0,0,1590,0,1961,247200.0
3.0,3.5,3020,2.0,0,0,2080,940,1954,910000.0
4.0,1.75,1870,1.0,0,0,1870,0,1969,419950.0
3.0,1.0,880,1.0,0,0,880,0,1966,160000.0
4.0,3.5,3030,3.0,0,0,3030,0,2014,799950.0
3.0,2.25,2140,2.0,0,0,2140,0,1986,400000.0
5.0,2.0,2050,1.0,0,0,1430,620,1956,210000.0
5.0,2.0,2050,1.0,0,0,1430,620,1956,475000.0
3.0,2.5,2090,2.0,0,0,2090,0,2008,355900.0
3.0,2.25,2520,1.0,0,0,1760,760,1977,420000.0
4.0,2.5,2630,1.0,0,0,1700,930,1977,710000.0
4.0,1.75,2560,1.0,0,0,1880,680,1974,518000.0
3.0,1.0,1200,1.0,0,0,1200,0,1937,375000.0
3.0,1.5,1010,1.0,0,0,1010,0,1953,185000.0
3.0,2.5,1520,2.0,0,0,1520,0,1986,402000.0
3.0,1.75,2170,1.0,0,0,2170,0,1976,585000.0
4.0,2.0,1980,2.0,0,0,1980,0,1910,500000.0
4.0,2.5,3070,2.0,0,0,2670,400,1927,1715000.0
5.0,3.5,5170,3.0,1,4,3520,1650,1998,1680000.0
2.0,2.0,1140,2.0,0,0,760,380,2014,570000.0
8.0,2.75,2530,2.0,0,0,1390,1140,1901,680000.0
3.0,2.25,1690,2.0,0,0,1690,0,1979,345000.0
4.0,2.5,2150,2.0,0,0,2150,0,2010,355000.0
3.0,1.5,1180,1.0,0,0,1180,0,1959,390000.0
3.0,1.0,1400,1.0,0,0,1400,0,1969,128000.0
3.0,1.75,1300,2.0,0,1,1300,0,1912,448500.0
3.0,1.75,1590,1.5,0,0,1590,0,1953,346000.0
3.0,1.75,1990,1.0,0,1,1330,660,1941,779000.0
3.0,1.75,1510,1.0,0,0,1510,0,1948,335000.0
4.0,3.25,2910,2.0,0,3,1830,1080,1914,1850000.0
3.0,2.5,2850,2.0,0,0,2850,0,1994,799990.0
3.0,2.5,2830,2.0,0,0,2830,0,2001,1075000.0
2.0,1.5,1110,3.0,0,0,1110,0,2000,371000.0
4.0,2.5,1900,1.0,0,0,1900,0,1967,620000.0
4.0,1.75,2290,1.0,0,0,1340,950,1960,343000.0
3.0,1.0,1010,1.0,0,0,1010,0,1969,265000.0
5.0,2.5,4670,2.0,0,0,4670,0,1998,1000000.0
3.0,2.5,3400,1.0,0,4,1870,1530,1955,825000.0
4.0,3.5,4070,2.0,0,0,4070,0,2004,889000.0
3.0,2.25,1630,1.0,0,0,1100,530,1977,305000.0
2.0,2.5,1700,2.0,0,0,1700,0,1976,407000.0
5.0,2.5,2070,1.0,0,0,1340,730,1967,613000.0
3.0,3.5,4660,2.0,1,4,4660,0,1975,1637500.0
3.0,3.75,2050,2.0,0,0,1550,500,1910,645000.0
4.0,3.5,4680,2.0,0,0,3360,1320,2005,1160000.0
3.0,2.25,2320,2.0,0,0,2320,0,1980,610000.0
3.0,2.5,3800,2.0,0,0,2730,1070,1994,450000.0
3.0,2.0,720,1.0,0,0,720,0,1947,300000.0
5.0,2.75,4400,1.0,0,3,2250,2150,1963,1120000.0
3.0,2.5,2260,2.0,0,0,2260,0,1992,418200.0
3.0,2.5,1650,2.0,0,0,1650,0,2004,250000.0
3.0,2.5,2560,2.0,0,0,2560,0,2002,619000.0
4.0,3.0,3720,3.0,0,0,3720,0,1979,500000.0
4.0,2.5,2590,2.0,0,0,2590,0,1986,465000.0
4.0,1.0,1750,1.0,0,0,1750,0,1942,322000.0
3.0,2.5,1620,2.0,0,0,1620,0,1989,276900.0
3.0,2.25,1700,1.0,0,0,1300,400,1990,660000.0
3.0,2.5,2450,2.0,0,0,2450,0,1990,480000.0
3.0,1.75,1610,1.0,0,0,1070,540,1951,925000.0
3.0,3.0,3730,1.0,0,0,2960,770,1979,825000.0
2.0,1.0,1210,1.0,0,0,780,430,1940,326000.0
3.0,1.0,1300,1.0,0,0,1300,0,1959,205000.0
2.0,1.0,850,1.5,0,0,850,0,1950,150000.0
3.0,2.5,1770,2.0,0,0,1770,0,2005,593567.0
3.0,2.5,2060,2.0,0,0,2060,0,1987,440000.0
3.0,2.5,3090,2.0,0,0,3090,0,1992,751000.0
2.0,1.75,1050,1.5,0,2,1050,0,1925,295000.0
3.0,2.0,1300,2.0,0,0,1300,0,1988,422500.0
3.0,1.0,1160,1.0,0,0,1160,0,1959,480000.0
4.0,2.5,3420,2.0,0,0,3420,0,2006,890900.0
4.0,2.75,2620,2.0,0,0,2620,0,2000,672500.0
4.0,1.5,1880,1.0,0,0,1080,800,1926,605000.0
5.0,3.25,4560,1.0,0,0,2490,2070,1963,1675000.0
4.0,2.5,2330,2.0,0,0,2330,0,1987,565000.0
4.0,1.75,2350,1.0,0,0,1720,630,1979,725000.0
3.0,3.0,1560,3.0,0,0,1560,0,2006,640000.0
4.0,1.0,1380,1.5,0,0,1380,0,1939,253750.0
6.0,2.75,3040,1.0,0,3,1760,1280,1958,799950.0
4.0,1.5,1350,1.0,0,0,1350,0,1959,595000.0
4.0,2.5,3180,2.0,0,1,3180,0,1977,850000.0
3.0,2.5,1790,2.0,0,0,1790,0,2009,366000.0
4.0,3.0,1986,2.0,0,2,1746,240,1922,715000.0
4.0,2.5,2400,2.0,0,0,2400,0,1992,300000.0
4.0,3.0,4590,2.0,0,0,3490,1100,1981,960000.0
3.0,2.0,1970,2.0,0,3,1970,0,1913,812000.0
3.0,1.0,1360,1.0,0,0,1360,0,1977,234950.0
4.0,2.0,2710,1.0,0,0,1460,1250,1919,656500.0
2.0,1.5,920,2.0,0,0,920,0,1995,255000.0
3.0,2.75,2000,1.0,0,0,1250,750,1960,538000.0
3.0,2.25,1920,1.0,0,0,1300,620,1961,260000.0
3.0,2.5,2678,2.0,0,0,2678,0,1998,546200.0
3.0,1.0,1220,1.0,0,0,890,330,1952,280500.0
3.0,1.75,1440,1.0,0,0,1050,390,1979,295000.0
4.0,1.75,2420,1.5,0,0,2420,0,1900,700000.0
3.0,2.0,2090,1.0,0,0,2090,0,1992,560000.0
4.0,2.75,4030,2.0,0,0,4030,0,1997,912000.0
3.0,1.75,1310,1.0,0,0,1310,0,1976,437000.0
3.0,2.5,1800,2.0,0,0,1800,0,2003,447000.0
4.0,1.0,1160,1.0,0,0,820,340,1913,500000.0
3.0,1.0,1160,1.0,0,0,880,280,1930,508300.0
3.0,1.5,1870,1.0,0,0,1300,570,1962,485000.0
7.0,5.75,3700,2.0,0,1,3700,0,1948,540000.0
3.0,2.25,2280,2.0,0,0,2280,0,1977,356000.0
4.0,2.0,1720,1.0,0,0,860,860,1949,525000.0
4.0,2.75,3630,2.0,0,0,3630,0,1999,962800.0
4.0,2.5,2040,2.0,0,0,2040,0,2003,315000.0
3.0,2.25,1750,3.0,0,0,1750,0,2001,525000.0
2.0,2.25,1550,2.0,0,0,1550,0,2007,325000.0
4.0,1.75,2500,1.0,0,0,1500,1000,1966,965800.0
4.0,1.0,1440,1.5,0,0,1440,0,1924,550000.0
4.0,1.0,1130,1.5,0,0,1130,0,1929,182200.0
3.0,1.0,1210,1.5,0,0,1210,0,1958,315000.0
2.0,1.0,960,1.0,0,0,960,0,1900,500000.0
5.0,2.5,2160,2.0,0,0,2160,0,1998,480000.0
3.0,1.75,3400,1.0,0,2,1820,1580,1957,1690000.0
5.0,3.25,3960,2.0,0,0,2690,1270,1989,525000.0
4.0,2.5,1900,2.0,0,0,1900,0,1988,407500.0
4.0,3.0,2620,2.0,0,0,2620,0,1987,443000.0
4.0,2.5,3150,2.0,0,0,3150,0,1966,1256500.0
3.0,1.0,1040,1.0,0,0,870,170,1924,642000.0
3.0,1.75,1540,1.0,0,0,1540,0,1964,520000.0
3.0,2.0,1820,1.5,0,0,1720,100,1941,750000.0
5.0,1.5,1930,1.5,0,0,1930,0,1929,855000.0
4.0,1.0,1430,1.5,0,0,1430,0,1934,275000.0
5.0,2.75,2920,1.5,0,0,1800,1120,1911,265000.0
3.0,2.5,3100,2.0,0,0,3100,0,1991,894400.0
2.0,1.0,1200,1.0,0,0,1200,0,1948,546000.0
2.0,2.5,2390,1.0,0,0,2390,0,2007,699950.0
3.0,2.0,1270,1.0,0,0,1270,0,1969,435000.0
4.0,1.5,1300,1.0,0,0,1300,0,1970,259500.0
4.0,3.25,2290,2.0,0,0,2290,0,2007,359950.0
3.0,1.75,1740,1.0,0,0,1740,0,1976,517000.0
3.0,1.0,1590,1.0,0,1,1280,310,1948,579000.0
4.0,2.0,2420,1.5,0,0,2420,0,1967,525000.0
4.0,2.5,2130,1.0,0,0,1500,630,1978,320000.0
4.0,1.75,1950,1.0,0,0,1370,580,1969,635000.0
4.0,2.5,2150,2.0,0,0,2150,0,1998,400000.0
3.0,1.75,1270,1.0,0,0,1270,0,1968,455000.0
3.0,1.75,1850,1.5,0,4,1850,0,1908,572000.0
2.0,1.5,1440,1.0,0,0,1140,300,1956,650000.0
3.0,1.5,1390,1.0,0,0,1390,0,1967,162500.0
2.0,2.5,1340,2.0,0,0,1150,190,2008,400000.0
3.0,1.0,1190,1.0,0,0,1190,0,1968,268300.0
6.0,4.5,3830,3.0,0,0,3050,780,1919,989000.0
3.0,1.75,1780,1.0,0,0,1280,500,1981,342000.0
4.0,2.5,3130,2.0,0,0,3130,0,2006,315000.0
4.0,2.75,1830,1.0,0,0,1320,510,1979,485000.0
4.0,2.5,2550,1.0,0,0,1750,800,1976,277500.0
4.0,3.5,3790,2.0,0,0,3790,0,1998,1295000.0
4.0,1.75,1800,1.5,0,0,1800,0,1912,385000.0
2.0,1.0,1630,1.0,0,0,830,800,1947,426000.0
4.0,2.0,1870,1.5,0,0,1870,0,1956,310000.0
4.0,2.0,1870,1.5,0,0,1870,0,1956,449000.0
2.0,1.0,980,1.0,0,0,980,0,1919,375000.0
3.0,2.25,2860,1.0,0,4,1920,940,1976,1187500.0
3.0,2.25,1470,2.0,0,0,1470,0,1985,468000.0
1.0,1.0,1160,2.0,0,0,1160,0,2000,336000.0
4.0,2.75,1940,2.0,0,0,1940,0,1990,392000.0
4.0,2.25,1630,1.0,0,0,1100,530,1977,412500.0
4.0,2.5,2755,2.0,0,0,2755,0,2001,545000.0
5.0,2.0,1430,1.5,0,0,1430,0,1947,133000.0
5.0,2.0,1430,1.5,0,0,1430,0,1947,440000.0
4.0,2.25,1400,1.0,0,0,1300,100,1961,294450.0
4.0,2.5,2520,2.0,0,0,2520,0,1987,335000.0
3.0,1.0,1290,1.0,0,0,1290,0,1956,362000.0
3.0,1.75,1400,1.0,0,0,1400,0,1977,322000.0
2.0,1.0,740,1.0,0,0,740,0,1943,230500.0
4.0,2.0,1710,1.0,0,0,1710,0,1950,380000.0
4.0,2.75,2414,2.0,0,0,2414,0,2006,292000.0
3.0,1.0,1040,1.0,0,0,1040,0,1954,172500.0
4.0,2.75,3540,1.5,0,1,1970,1570,1947,784000.0
4.0,2.75,2530,1.0,0,0,1700,830,1942,525000.0
3.0,2.5,2320,2.0,0,0,2320,0,2003,600000.0
3.0,2.5,2530,2.0,0,0,2530,0,1989,435000.0
5.0,2.75,2790,1.5,0,0,2790,0,1965,359900.0
4.0,1.75,1950,1.0,1,4,1150,800,1957,700000.0
3.0,2.0,1020,2.0,0,0,720,300,2009,280000.0
4.0,2.5,3110,2.0,0,0,3110,0,1997,655000.0
4.0,5.0,5310,1.0,0,4,3090,2220,1992,2480000.0
3.0,2.5,2580,2.0,0,0,2580,0,2001,499950.0
3.0,2.5,1380,2.0,0,0,1160,220,2008,540000.0
4.0,2.75,3980,2.0,0,0,3980,0,2002,970000.0
4.0,2.5,2080,1.0,0,0,1400,680,1989,330000.0
3.0,1.75,1530,2.0,0,0,1530,0,1978,474000.0
4.0,1.75,1930,1.0,0,0,1930,0,1968,670000.0
4.0,3.25,2330,2.0,0,3,2330,0,1918,1300000.0
4.0,2.5,3860,2.0,0,2,2940,920,1985,1160000.0
4.0,2.5,2880,2.0,0,0,2880,0,1988,440000.0
2.0,2.5,1590,2.0,0,0,1590,0,1997,411000.0
3.0,1.5,2150,1.5,0,0,1470,680,1928,500000.0
4.0,1.75,2300,1.5,1,4,2300,0,1934,1335000.0
6.0,3.25,2900,2.0,0,0,2300,600,1977,696000.0
3.0,2.25,1970,1.0,0,0,1180,790,1967,465000.0
4.0,2.5,1740,1.0,0,0,1220,520,1976,518000.0
3.0,1.75,1220,1.0,0,0,1220,0,1962,251000.0
3.0,2.0,1290,1.0,0,0,1290,0,1978,255000.0
2.0,1.0,780,1.0,0,0,780,0,1924,319000.0
4.0,2.75,2210,1.5,0,0,1470,740,1926,719000.0
5.0,3.5,5930,2.0,0,2,3920,2010,1996,1520000.0
4.0,2.5,1950,2.0,0,0,1950,0,2000,322000.0
4.0,1.0,1340,1.0,0,0,1340,0,1970,205000.0
3.0,1.0,1590,1.0,0,0,1060,530,1956,229000.0
3.0,2.25,1780,1.0,0,0,1350,430,1960,395000.0
2.0,1.0,760,1.0,0,0,760,0,1980,183000.0
3.0,1.75,1720,1.0,0,0,1170,550,1978,583500.0
3.0,2.5,2070,1.0,0,0,2070,0,1917,312000.0
3.0,1.75,1790,1.0,0,0,1410,380,1978,539000.0
4.0,2.75,3230,2.0,0,0,3230,0,2002,409000.0
3.0,1.75,1400,1.0,0,0,870,530,1951,510250.0
2.0,2.0,1370,1.0,0,0,1020,350,1952,535000.0
3.0,2.5,1600,2.0,0,0,1600,0,1996,280000.0
3.0,1.0,950,1.0,0,0,950,0,1958,286000.0
3.0,2.75,2210,1.0,0,1,1460,750,1968,710000.0
2.0,1.0,930,1.0,0,0,930,0,1940,395000.0
2.0,1.0,810,1.0,0,0,810,0,1949,237500.0
3.0,2.0,1630,1.0,0,0,850,780,1912,464000.0
3.0,1.75,1770,1.0,0,0,1770,0,1968,495000.0
1.0,1.0,710,1.0,0,0,710,0,1916,257500.0
4.0,3.5,3990,1.0,0,2,2300,1690,1999,570000.0
3.0,2.5,2310,2.0,0,0,2310,0,1986,362000.0
33.0,1.75,1620,1.0,0,0,1040,580,1947,640000.0
3.0,1.0,1140,1.0,0,0,1140,0,1972,172500.0
2.0,1.0,1040,1.0,0,0,1040,0,1910,596000.0
4.0,2.5,2170,1.0,0,0,1650,520,1980,840000.0
3.0,2.25,3370,1.0,1,4,1920,1450,1980,1600000.0
2.0,1.5,901,3.0,0,0,901,0,2001,435000.0
2.0,1.0,840,1.0,0,0,840,0,1949,251000.0
4.0,1.0,1650,1.0,0,0,1650,0,1964,282500.0
3.0,2.25,1380,1.0,0,0,1140,240,1987,265000.0
3.0,1.0,910,1.0,0,0,910,0,1969,330000.0
2.0,1.0,1230,1.0,0,0,1230,0,1928,435000.0
3.0,1.75,1740,1.0,0,0,1500,240,1948,827235.0
4.0,1.0,1290,1.5,0,0,1290,0,1957,249950.0
3.0,2.5,1950,2.0,0,0,1950,0,1988,400000.0
4.0,2.5,2150,2.0,0,0,2150,0,1990,300499.0
4.0,2.0,1560,1.0,0,0,1560,0,1959,449000.0
2.0,1.0,1120,1.0,0,0,1120,0,1923,500000.0
3.0,1.5,1790,1.0,0,0,1790,0,1953,865000.0
4.0,3.5,3290,2.0,0,1,2360,930,2006,899950.0
4.0,1.0,1540,1.5,0,0,1540,0,1961,370000.0
5.0,3.25,4240,2.0,0,0,3410,830,1980,442500.0
3.0,1.0,1010,1.0,0,0,1010,0,1973,310000.0
4.0,2.75,2970,1.5,0,1,2130,840,1918,1565000.0
4.0,2.25,2190,2.0,0,0,2190,0,1986,245000.0
2.0,1.0,700,1.0,0,0,700,0,1949,254950.0
6.0,4.5,3300,2.0,0,0,3300,0,1980,510000.0
3.0,2.25,1370,2.0,0,0,1370,0,1990,299950.0
4.0,2.5,2680,2.0,0,0,2680,0,2011,379950.0
3.0,1.0,1390,1.0,0,0,910,480,1926,350000.0
3.0,2.5,1700,2.0,0,0,1700,0,2000,300000.0
3.0,2.25,2510,1.5,0,2,1810,700,1932,994000.0
3.0,1.5,1700,1.0,0,0,1250,450,1956,315000.0
4.0,2.5,2180,1.0,0,0,2180,0,1968,480500.0
3.0,1.0,1770,1.5,0,0,1140,630,1926,373000.0
4.0,2.5,3290,2.0,0,0,3290,0,2003,728000.0
4.0,3.5,3040,2.0,0,1,2240,800,2002,415000.0
4.0,2.5,2460,2.0,0,0,2460,0,2003,427500.0
3.0,2.0,970,1.0,0,0,970,0,1972,339300.0
3.0,1.75,1320,1.0,0,0,1320,0,1948,313000.0
3.0,3.5,1900,2.0,0,0,1430,470,2008,431500.0
3.0,1.5,1220,1.5,0,0,1220,0,1950,415000.0
3.0,1.75,1470,1.0,0,0,1470,0,1978,490000.0
4.0,5.0,4630,2.0,0,3,4630,0,2005,1425000.0
3.0,1.5,1400,1.0,0,0,1400,0,1964,275000.0
2.0,1.0,1070,1.0,0,0,1070,0,1942,325000.0
5.0,3.75,3630,1.5,0,0,2470,1160,2004,1180000.0
4.0,1.5,1970,2.5,0,0,1970,0,1909,690000.0
4.0,2.0,2010,2.0,0,0,2010,0,1953,410000.0
4.0,2.5,2820,1.0,0,3,1770,1050,1952,960000.0
3.0,2.5,2530,2.0,0,0,2530,0,1990,299250.0
2.0,1.0,710,1.0,0,0,710,0,1953,239000.0
2.0,1.0,1210,1.0,0,0,1210,0,1949,235000.0
3.0,2.25,2370,2.0,0,0,2370,0,1979,587000.0
4.0,2.5,2300,2.0,0,0,2300,0,2001,431000.0
3.0,2.5,3110,2.0,0,1,2550,560,1946,1636000.0
3.0,1.75,1990,1.0,0,0,1090,900,1961,285000.0
3.0,3.0,2630,1.0,0,0,2630,0,1987,778000.0
3.0,1.0,1300,1.0,0,0,1300,0,1958,415000.0
2.0,1.75,1680,1.0,0,0,1680,0,2004,550285.0
3.0,2.25,2180,1.0,0,0,1660,520,1966,910000.0
3.0,2.5,2770,2.0,0,0,2770,0,1991,860000.0
3.0,1.75,2120,2.0,0,0,1980,140,1920,765000.0
4.0,2.5,2830,2.0,0,0,1980,850,1979,782000.0
3.0,3.5,1370,2.0,0,0,1180,190,2000,525000.0
3.0,2.5,2810,2.0,0,0,2810,0,1995,745000.0
3.0,3.5,3520,2.0,0,2,2760,760,2005,470000.0
3.0,1.75,1990,1.0,0,1,1320,670,1963,345000.0
3.0,2.25,2070,1.0,0,0,1170,900,1964,279000.0
3.0,1.5,1320,1.0,0,0,1320,0,1951,500000.0
3.0,1.0,1300,1.0,0,0,1300,0,1960,237000.0
3.0,1.75,1260,1.0,0,0,1260,0,1963,200500.0
4.0,1.75,2400,1.0,0,0,1250,1150,1957,387500.0
4.0,2.0,1950,1.0,0,0,1950,0,1961,392500.0
3.0,2.0,1430,1.0,0,0,1430,0,1957,305000.0
4.0,2.5,2110,1.0,0,2,2110,0,1968,981000.0
4.0,2.5,2980,2.0,0,0,2980,0,1990,680000.0
4.0,2.5,2068,2.0,0,0,2068,0,1976,276000.0
4.0,3.5,3380,2.0,0,0,3380,0,2000,655500.0
5.0,2.75,2810,1.0,0,0,1440,1370,1964,555000.0
2.0,1.0,930,1.0,0,0,930,0,1930,235000.0
3.0,1.0,1300,1.0,0,0,920,380,1950,325000.0
3.0,1.0,1320,1.0,0,0,880,440,1943,268950.0
3.0,1.5,1580,1.0,0,0,1050,530,1980,264500.0
3.0,2.5,1620,2.0,0,0,1620,0,1987,240000.0
3.0,2.5,2750,2.0,0,0,2750,0,2000,819000.0
2.0,1.5,2210,1.0,0,2,1530,680,1951,850000.0
4.0,2.25,1740,1.0,0,2,1160,580,1957,294950.0
3.0,2.25,2120,2.0,0,1,1420,700,1973,693000.0
4.0,2.5,2780,2.0,0,0,2780,0,1989,478000.0
2.0,1.0,830,1.0,0,0,830,0,1950,222000.0
4.0,2.5,2070,2.0,0,0,2070,0,1996,635000.0
3.0,3.25,1390,2.0,0,0,1140,250,2005,469000.0
4.0,2.5,2610,2.0,0,0,2610,0,2005,350000.0
5.0,1.0,1460,1.5,0,0,1290,170,1936,180000.0
4.0,2.25,3390,1.0,0,0,1640,1750,1964,490000.0
3.0,1.5,1360,1.0,0,0,860,500,1911,360000.0
4.0,2.5,2807,2.0,0,0,2807,0,1996,630000.0
4.0,1.0,1340,1.5,0,0,1340,0,1931,615000.0
3.0,2.25,1340,2.0,0,0,1340,0,1989,279950.0
3.0,1.0,1160,1.0,0,0,1160,0,1952,317000.0
4.0,2.25,2470,1.0,0,0,1600,870,1978,618000.0
5.0,1.75,2000,1.0,0,2,1000,1000,1962,620000.0
3.0,1.0,1110,1.0,0,0,1110,0,1956,345000.0
3.0,1.5,2240,1.0,0,0,1220,1020,1952,608000.0
4.0,2.25,1920,2.0,0,0,1920,0,1967,325000.0
3.0,1.75,2270,1.0,0,0,2270,0,1968,475000.0
3.0,3.0,1530,1.0,0,0,1020,510,1992,154000.0
5.0,3.0,3330,2.0,0,0,2610,720,1977,1190000.0
4.0,2.5,2643,2.0,0,0,2643,0,2012,376950.0
2.0,2.0,1250,1.0,0,0,1250,0,1957,500000.0
3.0,2.5,3230,1.0,0,0,2100,1130,1964,499950.0
3.0,1.0,880,1.0,0,0,880,0,1967,230000.0
4.0,2.5,2220,2.0,0,0,2220,0,2014,652600.0
3.0,1.75,1130,1.0,0,0,1130,0,1978,185000.0
3.0,1.0,1450,1.0,0,0,1050,400,1958,274950.0
2.0,1.0,760,1.0,0,0,760,0,1920,447000.0
2.0,1.0,1150,1.0,0,0,1150,0,1950,129000.0
5.0,3.0,2720,2.0,0,0,2720,0,1969,436000.0
3.0,1.75,2080,2.0,0,0,2080,0,1906,825000.0
3.0,1.0,1080,1.0,0,0,1080,0,1952,225000.0
3.0,2.5,1890,2.0,0,0,1890,0,1996,265000.0
3.0,1.5,1500,2.0,0,0,1500,0,1984,765000.0
4.0,2.0,1960,1.5,0,0,1260,700,1926,509000.0
4.0,1.75,2570,1.0,0,0,2570,0,1958,762450.0
5.0,1.5,1830,1.0,0,2,1030,800,1955,465000.0
3.0,1.75,1980,1.0,0,1,1090,890,1910,564000.0
2.0,1.0,1130,1.0,0,0,1130,0,1942,384500.0
3.0,2.0,2010,1.5,0,2,2010,0,1986,415000.0
2.0,1.75,1820,1.0,0,0,910,910,1948,345000.0
4.0,2.5,2340,2.0,0,0,2340,0,2001,465950.0
3.0,1.75,1780,1.0,0,0,1210,570,1979,325000.0
3.0,1.75,1780,1.0,0,0,1210,570,1979,500000.0
4.0,2.5,2450,1.0,0,0,1410,1040,1978,450000.0
4.0,3.0,2410,1.0,0,0,1210,1200,1969,475000.0
5.0,1.75,3380,1.0,0,0,1690,1690,1963,1346400.0
3.0,1.5,1710,2.0,0,0,1710,0,1920,747000.0
3.0,1.75,1740,1.0,0,0,1740,0,1954,395000.0
3.0,2.5,1995,3.0,0,0,1760,235,2005,505000.0
3.0,2.0,1760,1.0,0,0,1100,660,1947,215000.0
4.0,3.5,3970,2.0,0,0,3970,0,2000,775000.0
4.0,2.5,3000,2.0,0,0,3000,0,2013,540000.0
3.0,1.75,1540,1.0,0,0,1540,0,1957,392500.0
3.0,2.0,2160,1.0,0,0,2160,0,1951,987000.0
3.0,2.0,2160,1.0,0,0,2160,0,1951,1190000.0
3.0,2.0,1810,2.0,0,0,1810,0,1987,252500.0
3.0,3.5,2440,2.0,0,0,1970,470,2000,730000.0
6.0,2.75,3200,1.0,0,2,1600,1600,1953,497300.0
4.0,2.5,2970,2.0,0,0,2970,0,1998,640000.0
5.0,2.0,2290,1.0,0,0,1190,1100,1964,580000.0
3.0,1.75,1820,1.0,0,0,1820,0,1967,377000.0
4.0,3.5,3010,2.0,0,0,2370,640,1999,1280000.0
3.0,1.5,1360,2.0,0,0,1120,240,2003,396500.0
4.0,2.5,2080,2.0,0,0,2080,0,1998,300000.0
3.0,1.0,1110,1.5,0,0,1110,0,1946,532000.0
2.0,1.75,1560,1.0,0,0,1560,0,2004,579000.0
4.0,2.5,3520,2.0,0,3,3140,380,1929,1400000.0
5.0,1.75,2280,1.0,0,1,1380,900,1949,571000.0
3.0,1.75,1370,1.0,0,0,1370,0,1988,301950.0
3.0,3.0,2340,2.0,0,0,2160,180,1925,660000.0
4.0,2.5,3170,2.0,0,2,3170,0,2001,455000.0
3.0,1.75,1380,1.0,0,0,1380,0,1986,375000.0
4.0,2.5,2700,2.0,0,0,2700,0,1999,470000.0
3.0,2.5,1300,2.0,0,0,1300,0,1983,374990.0
2.0,2.5,1900,2.0,0,0,1900,0,2006,541500.0
3.0,2.5,3750,2.0,0,0,3750,0,2001,782500.0
3.0,2.25,1552,2.0,0,0,1552,0,2012,264000.0
4.0,2.5,2500,2.0,0,0,2500,0,1991,640000.0
3.0,2.0,1770,1.0,0,0,1770,0,1952,660000.0
5.0,3.5,4210,2.0,0,3,4210,0,1995,1365000.0
3.0,2.5,2170,2.0,0,0,2170,0,1994,389950.0
2.0,1.0,1510,1.0,0,0,1510,0,1951,226000.0
3.0,1.75,1870,1.0,0,0,1870,0,1959,390000.0
3.0,2.25,1570,2.0,0,0,1570,0,1984,485000.0
4.0,2.5,2480,2.0,0,0,2480,0,2000,840000.0
5.0,3.5,3580,1.5,0,0,2140,1440,1937,600000.0
2.0,1.0,1480,1.0,0,0,1080,400,1950,331000.0
3.0,2.0,2610,1.0,0,0,1310,1300,1941,780000.0
3.0,1.75,1700,2.0,0,0,1700,0,1993,300000.0
3.0,1.75,1240,1.0,0,0,1240,0,1968,361810.0
3.0,1.0,1660,1.0,0,0,1000,660,1946,467000.0
3.0,1.75,1620,1.5,0,0,1620,0,1918,399000.0
3.0,1.75,1130,1.5,0,0,1130,0,1908,315450.0
3.0,1.0,1310,1.5,0,0,1310,0,1906,600000.0
4.0,2.0,1710,1.0,0,0,910,800,1977,247500.0
3.0,1.0,2140,1.0,0,0,2140,0,1957,330000.0
4.0,2.25,2350,1.5,0,0,2350,0,1972,500000.0
3.0,1.0,1570,1.0,0,0,1570,0,1963,367500.0
3.0,2.5,2780,1.0,0,0,2780,0,1993,560000.0
4.0,1.75,2540,1.0,0,3,1320,1220,1948,655000.0
5.0,2.75,2500,1.0,0,0,1250,1250,1968,530000.0
3.0,2.25,2080,1.0,0,2,1380,700,1993,270000.0
3.0,2.0,1760,2.0,0,2,1290,470,1988,437500.0
3.0,1.75,1760,1.0,0,0,1760,0,1957,575000.0
4.0,2.5,1940,2.0,0,0,1940,0,1990,278000.0
4.0,2.5,3010,2.0,0,0,3010,0,2000,568500.0
4.0,3.0,2460,1.0,0,0,2460,0,2012,280000.0
2.0,1.0,750,1.0,0,0,750,0,1920,250000.0
3.0,0.75,1300,1.0,0,0,680,620,1950,247500.0
5.0,2.75,3710,1.5,0,3,2340,1370,1977,1250000.0
4.0,2.5,2360,1.0,0,0,1920,440,1986,535000.0
3.0,2.5,3190,2.0,0,0,3190,0,2014,814842.0
4.0,2.5,2181,2.0,0,0,2181,0,2006,340000.0
3.0,1.75,1890,2.0,0,0,1890,0,1952,359950.0
3.0,1.75,2610,1.5,0,0,1680,930,1934,750000.0
4.0,2.0,3090,2.5,0,0,3090,0,1918,1220000.0
2.0,1.0,860,1.0,0,0,860,0,1956,370000.0
3.0,1.0,1000,1.0,0,0,1000,0,1980,329950.0
3.0,2.5,2760,2.0,0,0,2760,0,1990,500000.0
4.0,2.5,3490,2.0,0,0,3490,0,1990,734000.0
4.0,2.5,2960,2.0,0,0,2960,0,2006,385000.0
2.0,1.0,1280,1.0,0,0,840,440,1917,230000.0
4.0,3.5,3230,1.0,0,1,1640,1590,2000,1385000.0
3.0,2.0,1830,1.0,0,0,1230,600,1953,210000.0
3.0,1.75,1420,1.0,0,0,1420,0,1974,293000.0
3.0,1.0,1580,1.5,0,0,1580,0,1900,465000.0
3.0,2.25,1960,1.0,0,0,1130,830,1984,449000.0
2.0,1.75,1670,1.0,0,0,1670,0,1965,325000.0
3.0,2.0,1670,1.0,0,0,1670,0,1958,180000.0
6.0,3.0,2960,1.0,0,0,1790,1170,1968,650000.0
4.0,2.75,2420,1.0,0,0,1670,750,1946,665000.0
3.0,2.0,1420,1.0,0,0,1420,0,1966,324450.0
4.0,1.75,2170,1.0,0,2,1370,800,1975,588000.0
4.0,1.0,1310,1.5,0,0,1160,150,1945,200000.0
4.0,1.75,1830,1.0,0,0,1060,770,1962,383000.0
3.0,2.0,1360,1.0,0,0,730,630,1986,499950.0
5.0,2.5,3440,1.0,0,2,1760,1680,1976,549000.0
5.0,3.0,2010,1.0,0,0,1290,720,1990,465000.0
3.0,2.5,2450,2.0,0,0,2450,0,1990,450000.0
4.0,2.5,3030,2.0,0,0,1580,1450,1991,799900.0
4.0,2.5,2480,1.0,0,2,1470,1010,1973,495000.0
3.0,3.5,4310,2.0,0,2,3140,1170,1988,1200000.0
4.0,2.5,2120,2.0,0,0,2120,0,1983,637000.0
4.0,1.0,2210,2.0,0,0,2210,0,1901,589000.0
3.0,1.75,1400,1.0,0,0,1400,0,1976,305000.0
4.0,2.25,2760,2.0,0,0,1790,970,1910,600000.0
4.0,2.5,2550,2.0,0,0,2550,0,1992,587000.0
2.0,2.5,2220,2.0,0,0,2220,0,2000,1425000.0
4.0,1.0,1320,1.0,0,0,1320,0,1914,250000.0
3.0,3.0,2440,2.0,0,0,1640,800,1982,515000.0
4.0,2.75,3780,2.0,0,0,3780,0,1999,833000.0
3.0,3.25,4720,2.0,0,2,3190,1530,1998,860000.0
4.0,3.0,2360,1.0,0,0,1760,600,1949,550000.0
2.0,1.0,890,1.0,0,0,890,0,1919,180000.0
4.0,1.75,1770,1.0,0,0,1170,600,1968,507000.0
3.0,2.0,1720,1.0,0,0,1720,0,1994,427000.0
3.0,3.5,2490,2.0,0,0,2020,470,1999,616950.0
4.0,1.75,1890,1.0,0,0,1010,880,1969,372000.0
2.0,1.0,1020,1.0,0,0,1020,0,1930,290000.0
4.0,2.75,2420,2.0,0,0,2420,0,1997,329990.0
3.0,1.75,1600,1.0,0,0,1600,0,1948,393500.0
5.0,3.25,3370,1.0,0,2,2000,1370,1982,1550000.0
4.0,2.25,1720,1.0,0,0,1720,0,1973,240000.0
3.0,1.0,1090,1.0,0,0,1090,0,1973,285000.0
3.0,1.5,1090,1.0,0,0,1090,0,1987,382500.0
4.0,3.75,3600,1.0,0,0,3600,0,1951,1925000.0
3.0,2.5,2760,1.0,0,2,1760,1000,1956,800000.0
4.0,3.5,2770,2.0,0,0,2770,0,1967,550000.0
4.0,1.75,2520,1.0,0,0,2040,480,1954,387846.0
4.0,2.0,1960,1.0,0,0,1960,0,1980,367500.0
5.0,1.0,1760,2.0,0,0,1760,0,1902,780500.0
3.0,1.75,1090,1.0,0,0,850,240,1950,680000.0
5.0,1.75,1960,1.0,0,0,1960,0,1968,434400.0
2.0,1.0,1220,1.0,0,0,1220,0,1947,370000.0
3.0,1.75,1730,1.0,0,0,1350,380,1971,465000.0
3.0,2.0,1830,1.0,0,0,1830,0,1979,323000.0
4.0,2.5,1600,2.0,0,0,1600,0,2009,270000.0
3.0,1.75,2040,1.0,0,2,2040,0,1980,1320000.0
4.0,2.5,2710,2.0,0,0,2710,0,2003,560000.0
3.0,1.0,1140,1.0,0,0,840,300,1907,450000.0
2.0,1.0,930,1.0,0,0,930,0,1924,290000.0
3.0,2.0,1010,1.0,0,0,1010,0,1980,354000.0
5.0,3.0,2380,2.0,0,0,2380,0,1909,705000.0
3.0,2.25,1860,1.0,0,0,1240,620,1977,445000.0
3.0,1.0,1440,1.0,0,0,1440,0,1968,229900.0
4.0,2.5,2980,2.0,0,0,2980,0,2001,610000.0
3.0,3.25,2670,2.0,0,2,2670,0,2000,535000.0
3.0,1.75,2150,1.0,0,0,2150,0,1960,437400.0
5.0,2.75,3160,2.0,0,0,1740,1420,1978,540000.0
3.0,2.0,1890,1.0,0,0,1470,420,1949,570000.0
3.0,2.5,2810,2.0,0,0,2810,0,2004,533000.0
3.0,2.5,2690,2.0,0,0,2690,0,2004,555000.0
3.0,1.75,1230,1.0,0,0,1230,0,1984,239950.0
3.0,1.0,950,1.0,0,0,950,0,1977,350000.0
2.0,1.0,1200,1.0,0,0,980,220,1943,245000.0
4.0,1.75,1670,1.0,0,0,1670,0,1947,456000.0
4.0,2.25,2140,1.0,0,0,1470,670,1977,465000.0
2.0,1.75,1440,1.0,0,2,1440,0,2008,445000.0
5.0,2.75,3050,1.0,0,0,1800,1250,1966,517850.0
5.0,2.75,2570,2.0,0,0,2570,0,1996,329000.0
3.0,2.5,1840,2.0,0,0,1840,0,1997,512500.0
2.0,1.0,1250,1.0,0,0,1250,0,1947,365000.0
3.0,1.0,1410,1.0,0,0,1410,0,1948,450500.0
3.0,1.0,1560,1.0,0,0,1560,0,1952,915000.0
3.0,1.0,960,1.0,0,0,960,0,1960,205000.0
4.0,2.5,1870,2.0,0,0,1870,0,1992,314000.0
2.0,1.0,900,1.0,0,0,900,0,1946,496000.0
4.0,1.0,2050,1.0,0,0,1280,770,1957,329950.0
4.0,2.0,2400,2.0,0,0,2400,0,1913,375000.0
3.0,2.5,1850,2.0,0,0,1850,0,1989,623000.0
4.0,1.5,1220,1.0,0,0,1220,0,1980,310000.0
3.0,3.25,3140,1.0,0,0,1760,1380,1984,532500.0
4.0,2.25,2410,2.0,0,2,1800,610,1929,960000.0
4.0,2.5,3130,2.0,0,0,3130,0,1994,598000.0
3.0,2.5,2300,2.0,0,2,2300,0,1998,683000.0
5.0,2.5,2840,1.0,0,0,1590,1250,1962,425000.0
5.0,2.75,1800,1.5,0,0,1400,400,1926,533000.0
3.0,1.0,1190,1.0,0,0,1190,0,1953,375000.0
3.0,2.0,1710,2.0,0,0,1710,0,1988,250500.0
4.0,1.75,1900,1.5,0,0,1360,540,1922,257000.0
3.0,1.0,880,1.0,0,0,880,0,1945,218000.0
3.0,2.0,2060,1.0,0,0,1030,1030,1929,460000.0
3.0,1.0,1360,1.5,0,0,760,600,1941,255544.0
2.0,2.0,1680,1.0,0,0,1680,0,2008,560000.0
4.0,2.5,2980,2.0,0,0,2980,0,2011,480000.0
5.0,1.75,2130,1.0,0,0,1500,630,1968,1300000.0
3.0,2.75,2650,1.0,0,0,2650,0,1989,580000.0
3.0,2.5,1700,1.0,0,0,1160,540,1998,475000.0
4.0,2.5,2680,1.0,1,4,1590,1090,1956,1309500.0
3.0,2.5,2530,1.0,0,0,2530,0,1980,700000.0
3.0,2.5,2520,2.0,0,0,2520,0,1988,590000.0
3.0,2.5,1630,1.0,0,0,1630,0,1990,264500.0
2.0,1.0,730,1.0,0,0,730,0,1918,465000.0
3.0,1.0,910,1.0,0,2,910,0,1971,290000.0
4.0,4.5,4510,2.0,0,2,4510,0,1998,1815000.0
3.0,1.0,1110,1.0,0,0,1110,0,1957,416000.0
4.0,2.0,1450,1.0,0,0,1450,0,1962,360000.0
5.0,2.75,2910,1.0,0,0,1590,1320,1977,585083.0
4.0,2.75,2600,1.5,0,0,1620,980,1936,840000.0
2.0,1.0,730,1.0,0,0,730,0,1943,81000.0
3.0,2.25,2440,1.0,0,1,2440,0,1950,1285000.0
4.0,1.75,2290,1.0,0,0,1390,900,1963,326000.0
2.0,1.0,720,1.0,0,2,720,0,1925,447000.0
3.0,1.0,940,1.5,0,0,940,0,1958,185000.0
3.0,2.5,1540,2.0,0,0,1540,0,1982,439950.0
3.0,1.5,1140,1.5,0,0,1140,0,1967,234000.0
4.0,2.5,2100,2.0,0,0,2100,0,1964,485000.0
4.0,1.75,2670,2.0,0,0,2020,650,1941,750000.0
4.0,2.0,2750,2.0,0,0,2130,620,1901,865000.0
4.0,2.5,2570,1.0,0,0,1590,980,1979,287500.0
3.0,1.75,1660,1.0,0,0,1130,530,1976,375000.0
3.0,2.25,1700,1.0,0,0,850,850,1969,565000.0
4.0,3.0,1530,2.0,0,0,1530,0,2010,260000.0
3.0,1.0,1260,1.0,0,0,1260,0,1943,190000.0
5.0,2.0,2760,1.0,0,0,1380,1380,1964,399950.0
3.0,2.5,1830,2.0,0,0,1830,0,1990,275000.0
3.0,2.75,2160,1.0,0,0,1380,780,1987,528000.0
3.0,2.0,1770,1.0,0,0,1770,0,1948,315000.0
2.0,2.25,2210,1.0,0,0,1410,800,1968,614306.0
3.0,3.5,4560,2.0,0,2,4560,0,1990,1490000.0
3.0,2.5,2110,2.0,0,0,2110,0,2004,590000.0
3.0,1.0,1130,1.0,0,0,1130,0,1908,261500.0
4.0,2.5,1960,2.0,0,0,1960,0,2001,300000.0
3.0,2.25,2230,1.5,0,2,1450,780,1928,439000.0
5.0,2.25,2350,1.0,0,0,2350,0,1961,277554.0
3.0,2.0,1340,1.0,0,0,1340,0,1931,215000.0
2.0,2.25,2160,2.0,1,4,2160,0,1956,1200000.0
4.0,2.0,1700,1.0,0,0,850,850,1950,420000.0
3.0,2.5,1650,2.0,0,0,1650,0,2003,485000.0
3.0,2.0,1540,1.0,0,0,1540,0,1954,202500.0
5.0,3.25,3920,2.0,0,0,3920,0,2007,710000.0
4.0,2.5,3250,2.0,0,0,3250,0,2009,535000.0
4.0,1.75,1360,1.0,0,0,1360,0,1966,260000.0
3.0,2.0,1480,1.0,0,0,1480,0,1992,254000.0
4.0,2.5,2360,2.0,0,0,2360,0,2001,600000.0
3.0,2.5,1800,2.0,0,0,1800,0,2001,285000.0
4.0,3.75,2540,2.0,0,0,2540,0,1998,800000.0
3.0,1.0,1200,1.0,0,0,1200,0,1943,165000.0
2.0,1.0,710,1.0,0,0,710,0,1943,216500.0
4.0,2.5,2640,2.0,0,0,2640,0,2011,387990.0
4.0,2.5,3010,2.0,0,0,3010,0,2006,500000.0
4.0,2.5,2770,2.0,0,0,2770,0,2001,650000.0
4.0,2.5,2310,2.0,0,0,2310,0,2008,646000.0
4.0,3.0,2060,1.0,0,0,1430,630,1992,323400.0
3.0,2.5,1880,2.0,0,0,1880,0,2007,300000.0
5.0,2.0,2280,1.5,0,0,1340,940,1947,712500.0
3.0,1.75,1380,1.5,0,0,1380,0,1900,550000.0
3.0,1.0,1180,1.0,0,0,1180,0,1969,400000.0
4.0,1.75,1650,1.0,0,0,1100,550,1977,255000.0
3.0,1.75,2030,2.0,0,2,2030,0,1963,660000.0
4.0,2.25,2110,1.0,0,2,1600,510,1941,925000.0
4.0,2.25,2130,1.0,0,0,1330,800,1965,534000.0
3.0,1.0,1690,1.0,0,0,1690,0,1969,215000.0
3.0,2.5,2510,1.5,0,4,2510,0,1968,1950000.0
5.0,4.25,3530,2.0,0,0,3530,0,2001,1400000.0
3.0,1.75,1470,1.0,0,0,1470,0,1990,212000.0
3.0,1.75,1840,1.0,0,0,1840,0,1966,265000.0
3.0,1.75,1860,1.5,0,0,1300,560,1918,400000.0
4.0,2.5,1940,2.0,0,0,1940,0,1992,311500.0
4.0,3.5,4420,2.0,0,0,4420,0,2003,2328000.0
2.0,1.0,800,1.0,0,0,800,0,1944,225000.0
4.0,2.5,3700,1.0,0,4,2620,1080,1988,1250000.0
3.0,1.0,1400,1.0,0,0,1400,0,1948,380000.0
4.0,2.5,2250,2.0,0,0,2250,0,1991,600000.0
3.0,2.25,2230,2.0,0,0,2230,0,1987,600000.0
3.0,2.5,1950,2.0,0,0,1950,0,2001,315000.0
5.0,1.0,2550,2.5,0,0,2550,0,1905,847000.0
4.0,2.5,2750,2.0,0,0,2750,0,1998,730000.0
4.0,2.0,2290,1.0,0,0,2290,0,1955,1058000.0
4.0,2.25,2350,2.0,0,0,2350,0,1977,1620000.0
2.0,1.75,1720,1.0,0,0,860,860,1948,664000.0
4.0,3.0,2810,2.0,0,0,2810,0,2007,454450.0
3.0,1.0,940,1.0,0,0,940,0,1955,341000.0
4.0,1.0,1190,1.5,0,0,1190,0,1946,276693.0
2.0,1.0,1390,1.0,0,0,1390,0,1969,185000.0
2.0,2.5,1660,2.0,0,0,1660,0,1981,160000.0
4.0,2.5,1920,2.0,0,0,1920,0,1998,270000.0
4.0,1.5,1460,1.0,0,0,1460,0,1958,300000.0
3.0,1.5,1370,1.0,0,0,1370,0,1957,264950.0
2.0,1.0,1050,1.0,0,0,840,210,1943,209950.0
3.0,2.5,3360,2.0,0,0,3360,0,2006,850000.0
4.0,2.5,3160,2.0,0,0,3160,0,1983,645000.0
4.0,2.25,2480,2.0,0,0,2480,0,1973,855000.0
4.0,1.5,2720,2.0,0,0,2720,0,1994,632500.0
3.0,2.5,2070,2.0,0,0,2070,0,1987,289950.0
2.0,1.75,2170,1.0,0,2,2170,0,1952,850000.0
4.0,2.75,3260,2.0,0,0,3260,0,2013,565000.0
3.0,2.5,2250,2.0,0,0,2250,0,1999,792000.0
3.0,2.25,1950,1.0,0,0,1200,750,1987,260000.0
3.0,2.0,2220,1.0,0,0,2220,0,1991,585000.0
3.0,1.75,1330,1.0,0,0,1000,330,1981,295500.0
4.0,2.0,1190,1.5,0,0,1190,0,1946,329000.0
3.0,1.75,2770,1.0,0,0,1570,1200,1976,750000.0
4.0,2.5,2310,2.0,0,0,2310,0,1997,495000.0
3.0,1.75,1580,1.0,0,2,1330,250,1947,672500.0
5.0,3.25,2800,1.5,0,0,1910,890,1932,1307000.0
3.0,2.5,1500,2.0,0,0,1500,0,1994,405000.0
3.0,1.75,2140,1.0,0,1,1070,1070,1947,620000.0
4.0,2.25,2330,1.0,0,0,1450,880,1973,615000.0
6.0,2.25,3830,1.0,0,2,2440,1390,1962,887000.0
4.0,2.75,4510,2.5,0,2,3270,1240,1941,1057000.0
4.0,1.75,2160,1.0,0,0,1660,500,1974,753000.0
3.0,2.25,3170,2.0,0,0,2230,940,1975,1600000.0
4.0,3.5,5550,2.0,0,2,3350,2200,2000,3710000.0
3.0,1.5,1520,1.0,0,0,1520,0,1954,365000.0
4.0,2.75,3410,2.0,0,0,3410,0,1982,870000.0
4.0,2.5,1830,2.0,0,0,1830,0,2003,321000.0
3.0,2.5,1550,2.0,0,0,1550,0,2000,280000.0
3.0,2.5,1520,2.0,0,0,1520,0,2004,288000.0
3.0,2.0,1240,1.0,0,0,620,620,1939,248500.0
4.0,2.5,2380,2.0,0,0,2380,0,1999,330000.0
5.0,3.5,2720,2.0,0,0,1830,890,1988,740000.0
3.0,2.5,2210,2.0,0,0,2210,0,1998,445000.0
2.0,1.0,1050,1.0,0,0,1050,0,1959,198500.0
7.0,2.5,1940,2.0,0,0,1940,0,1994,280000.0
3.0,2.25,1420,2.0,0,0,1420,0,1981,336500.0
3.0,2.5,1690,2.0,0,0,1690,0,1989,267000.0
3.0,1.0,1160,1.0,0,0,1160,0,1968,315000.0
4.0,2.5,2040,2.0,0,0,2040,0,1988,545000.0
3.0,1.75,1840,1.0,0,0,1840,0,1989,274950.0
2.0,1.0,1440,1.0,0,2,1210,230,1948,500000.0
3.0,1.0,1390,1.5,0,0,1390,0,1954,299000.0
3.0,2.5,1470,2.0,0,0,1160,310,2005,420000.0
3.0,2.5,1776,3.0,0,0,1604,172,2006,620000.0
3.0,2.25,1640,1.0,0,0,1180,460,1967,575950.0
4.0,2.5,2860,2.0,0,0,2860,0,2000,666500.0
4.0,1.5,1740,1.0,0,0,1020,720,1962,180000.0
3.0,1.75,1390,1.0,0,0,1390,0,1962,261350.0
4.0,3.5,2730,1.0,0,0,1660,1070,1948,1030000.0
3.0,1.75,1435,1.0,0,0,1435,0,1969,390000.0
3.0,1.0,1640,1.0,0,0,1090,550,1954,253500.0
4.0,2.5,2630,2.0,0,0,2630,0,1986,625000.0
4.0,2.5,1580,1.0,0,0,1580,0,1959,255000.0
3.0,2.5,1740,2.0,0,0,1740,0,2009,257000.0
2.0,1.75,1900,1.0,1,4,1100,800,1954,869000.0
4.0,2.5,3130,2.0,0,0,3130,0,1990,745000.0
4.0,3.5,3500,2.0,0,0,3500,0,1999,1350000.0
3.0,1.75,2130,1.0,0,0,1090,1040,1956,350000.0
3.0,2.5,950,2.0,0,0,950,0,2003,475000.0
3.0,2.5,1720,2.0,0,0,1720,0,1987,540000.0
2.0,1.0,830,1.0,0,0,830,0,1996,175000.0
2.0,0.75,660,1.0,0,0,660,0,1912,100000.0
5.0,1.0,2590,2.0,0,0,2310,280,1907,890000.0
3.0,2.5,1600,2.0,0,0,1600,0,2000,280000.0
4.0,4.25,4390,2.0,0,3,3320,1070,2003,1050000.0
4.0,2.5,3560,2.0,0,0,3560,0,1988,486000.0
5.0,2.5,2860,2.0,0,0,2860,0,1958,670000.0
3.0,2.5,1640,2.0,0,0,1640,0,1987,480000.0
3.0,1.75,1500,1.0,0,0,1060,440,1947,440000.0
3.0,3.25,3990,2.0,0,2,2870,1120,1922,1500000.0
4.0,2.5,2610,2.0,0,0,2610,0,1988,743700.0
3.0,1.75,1470,1.0,0,0,1470,0,1988,449950.0
2.0,1.0,700,1.0,0,0,700,0,1945,367000.0
4.0,3.25,3960,2.0,0,0,3960,0,2001,1185000.0
3.0,1.0,900,1.0,0,0,900,0,1959,201000.0
3.0,1.75,2010,2.0,0,0,2010,0,1922,575000.0
3.0,2.5,1940,1.0,0,0,1420,520,1979,295000.0
3.0,1.0,1510,1.0,0,0,1510,0,1946,190000.0
2.0,3.0,2020,1.0,0,0,1350,670,1952,742500.0
6.0,3.5,4430,2.0,0,0,3000,1430,2001,875000.0
4.0,3.5,4010,2.0,0,3,3150,860,1990,1387000.0
4.0,2.25,3070,2.0,0,0,3070,0,1970,600000.0
3.0,1.5,1460,1.0,0,0,1460,0,1956,207000.0
4.0,2.75,3260,2.0,0,0,3260,0,2003,650000.0
2.0,1.0,830,1.0,0,0,830,0,1922,275000.0
4.0,2.5,2390,2.0,0,0,2150,240,1924,1200000.0
3.0,2.0,1130,1.0,0,0,1130,0,1944,262500.0
2.0,1.0,1120,1.0,0,0,1120,0,1946,399000.0
4.0,1.5,1410,1.0,0,0,1410,0,1966,139000.0
3.0,2.5,1750,2.0,0,0,1750,0,1991,575000.0
2.0,1.0,1040,1.0,0,0,1040,0,1926,580000.0
3.0,2.25,1630,2.0,0,0,1630,0,2004,468000.0
3.0,1.0,1380,1.0,0,0,940,440,1963,230000.0
4.0,4.0,3680,2.0,0,0,3680,0,1990,675000.0
3.0,1.0,1250,1.0,0,0,1250,0,1970,318000.0
5.0,3.5,2660,2.0,0,0,1980,680,1996,332100.0
2.0,1.0,620,1.0,0,0,620,0,1963,175000.0
4.0,2.25,2600,2.0,0,0,2600,0,1979,817000.0
4.0,3.0,2150,2.0,0,0,2150,0,1953,1200000.0
3.0,1.75,1470,1.0,0,2,1070,400,1916,525000.0
3.0,1.0,1380,1.5,0,0,1380,0,1915,189000.0
3.0,2.5,1680,2.0,0,0,1120,560,2014,629950.0
1.0,1.0,1000,1.0,1,3,1000,0,1950,641500.0
3.0,2.25,1630,1.0,0,2,1230,400,1983,490000.0
3.0,1.75,1790,1.0,0,0,1360,430,1976,415000.0
2.0,1.0,890,1.0,0,0,890,0,1951,250000.0
3.0,1.5,1290,1.0,0,0,820,470,1952,781000.0
4.0,2.25,2420,1.0,0,0,1400,1020,1973,400000.0
4.0,3.0,3680,2.0,0,2,2890,790,2008,935000.0
4.0,2.5,3020,1.0,0,0,1600,1420,1979,575000.0
4.0,3.25,4240,2.0,0,2,4240,0,2006,1660000.0
5.0,2.75,3130,1.0,0,0,1580,1550,1973,302300.0
2.0,1.0,900,1.0,0,0,900,0,1940,355000.0
3.0,2.25,2880,1.0,0,2,1710,1170,1958,1538000.0
4.0,1.75,2390,1.0,0,0,2390,0,1964,926250.0
3.0,1.75,1450,1.0,0,0,1050,400,1955,300000.0
3.0,1.75,1070,1.0,0,0,1070,0,1978,361500.0
3.0,1.5,1740,1.0,0,0,1740,0,1963,616000.0
2.0,1.75,1210,2.0,0,0,1210,0,2014,395000.0
3.0,1.5,2100,1.0,0,0,2100,0,1954,245000.0
3.0,1.0,1060,1.0,0,0,1060,0,1962,206000.0
4.0,2.5,3280,1.0,0,0,2190,1090,1972,706000.0
3.0,1.5,1660,1.5,0,0,1660,0,1937,578000.0
5.0,3.0,3070,2.0,0,0,3070,0,2005,341950.0
3.0,1.0,1150,1.0,0,0,1150,0,1922,305000.0
3.0,2.75,1710,1.0,0,0,1590,120,1909,575000.0
3.0,1.0,1180,1.0,0,0,1180,0,1959,330000.0
4.0,2.25,2130,2.0,0,0,2130,0,1972,445000.0
3.0,1.0,1050,1.0,0,0,1050,0,1951,333000.0
4.0,2.5,2520,2.0,0,0,2520,0,2005,598500.0
2.0,1.0,700,1.0,0,0,700,0,1943,225000.0
4.0,2.5,2640,2.0,0,0,2640,0,1998,570000.0
5.0,2.0,2330,1.0,0,0,1310,1020,1956,630000.0
5.0,2.25,2830,2.0,0,0,2830,0,1977,779000.0
4.0,3.5,3720,2.0,0,3,3720,0,2004,760000.0
5.0,1.75,1890,1.0,0,0,1890,0,1960,322968.0
4.0,2.5,2910,2.0,0,0,2910,0,1998,595000.0
4.0,1.0,1300,1.0,0,0,1300,0,1941,321000.0
3.0,2.25,2770,2.0,0,0,2770,0,1985,653000.0
4.0,1.75,2520,1.0,1,4,1420,1100,1960,750000.0
3.0,1.0,1340,1.0,0,0,1080,260,1910,530000.0
2.0,1.75,1060,2.0,0,0,960,100,2008,352750.0
4.0,2.5,2480,2.0,0,0,2480,0,1992,424950.0
5.0,2.75,2220,1.0,0,0,1230,990,1973,427000.0
4.0,2.5,3220,2.0,0,0,2420,800,2000,558000.0
2.0,2.0,1600,1.0,0,0,1600,0,1954,438200.0
1.0,1.0,640,1.0,0,0,640,0,1918,340000.0
4.0,3.75,3610,3.0,0,0,3290,320,1994,830005.0
4.0,3.25,3420,2.0,0,0,2330,1090,2008,548000.0
3.0,1.75,1840,1.0,0,0,1040,800,1952,411715.0
4.0,4.0,2790,2.0,0,0,2790,0,1999,865000.0
6.0,4.25,5860,2.0,0,3,4150,1710,2013,1750000.0
3.0,3.0,3450,2.0,0,0,3450,0,1983,688000.0
4.0,2.5,2350,2.0,0,0,2350,0,2003,399950.0
3.0,1.0,1250,1.5,0,0,970,280,1903,555000.0
3.0,2.0,2000,1.0,0,0,1100,900,1916,677000.0
3.0,2.0,2260,1.0,0,0,1780,480,1985,539000.0
3.0,1.75,1510,1.0,0,0,950,560,1939,410000.0
2.0,2.25,1800,2.0,0,0,1800,0,1979,472000.0
3.0,2.5,2420,1.0,0,3,1620,800,1957,755000.0
5.0,1.75,1750,1.0,0,0,1750,0,1966,269900.0
4.0,2.5,2660,2.0,0,0,2660,0,1977,667400.0
3.0,2.25,2640,1.0,0,0,2640,0,1995,1220000.0
3.0,2.5,1460,2.0,0,0,1180,280,2007,544000.0
2.0,1.0,1570,1.5,0,3,1570,0,1924,800000.0
3.0,1.0,1010,1.0,0,0,1010,0,1975,315000.0
4.0,1.0,1200,1.5,0,0,1200,0,1944,227000.0
4.0,2.5,4040,2.0,0,0,4040,0,2000,765000.0
3.0,3.0,1820,3.0,0,0,1540,280,2006,625000.0
4.0,5.0,5810,2.0,0,0,3790,2020,2004,1875000.0
4.0,2.5,3010,1.0,0,2,1510,1500,1979,822600.0
4.0,2.5,1910,1.0,0,0,1160,750,1970,515000.0
4.0,2.0,1640,1.0,0,0,930,710,1982,377000.0
3.0,1.0,1480,1.0,0,1,1480,0,1954,600000.0
4.0,1.75,2520,1.0,0,0,1680,840,1965,525300.0
4.0,3.0,2840,1.0,0,2,1990,850,1974,760000.0
2.0,1.0,840,1.0,0,0,840,0,1907,202000.0
3.0,2.0,1730,1.0,0,0,1730,0,1997,470000.0
3.0,2.5,3140,2.0,0,0,3140,0,1991,810000.0
3.0,1.0,1480,1.0,0,0,1080,400,1967,175000.0
4.0,1.75,1920,1.0,0,0,960,960,1952,440000.0
2.0,1.0,770,1.0,0,0,770,0,1951,197000.0
3.0,1.0,1010,1.0,0,2,1010,0,1943,254000.0
3.0,1.0,1460,1.5,0,0,1460,0,2002,405000.0
2.0,1.0,940,1.0,0,0,940,0,1949,416000.0
4.0,2.75,2840,3.0,0,0,2840,0,2014,779950.0
4.0,2.75,1910,1.0,0,0,1430,480,1980,200000.0
4.0,2.5,2430,2.0,0,0,2430,0,1992,658100.0
2.0,1.75,1610,1.0,0,0,950,660,1996,397000.0
3.0,3.75,2780,2.0,0,0,2780,0,1999,815000.0
2.0,1.0,1160,1.0,0,0,1160,0,1949,345000.0
4.0,2.5,1850,2.0,0,0,1850,0,1989,305500.0
3.0,2.25,2120,1.0,0,0,2120,0,1997,340000.0
5.0,2.5,2620,1.0,0,0,1400,1220,1979,330000.0
4.0,2.5,2060,2.0,0,0,2060,0,2004,269000.0
3.0,1.0,1060,1.0,0,0,1060,0,1966,349950.0
3.0,1.0,1500,1.0,0,0,1500,0,1953,431000.0
4.0,1.75,2380,2.0,0,1,1820,560,1946,735000.0
5.0,3.0,3045,2.0,0,0,3045,0,1999,414000.0
3.0,2.5,1700,2.0,0,0,1700,0,1992,619500.0
3.0,1.75,1240,1.0,0,0,1240,0,1957,675000.0
3.0,1.0,1410,1.0,0,0,1410,0,1971,380500.0
3.0,1.5,880,1.0,0,0,880,0,1945,253000.0
2.0,1.0,740,1.0,0,0,740,0,1949,157500.0
4.0,2.0,2030,1.0,0,0,2030,0,1976,627000.0
4.0,2.5,2090,1.0,0,0,1140,950,2001,469500.0
2.0,1.0,920,1.0,0,0,920,0,1939,319950.0
3.0,1.0,1180,1.0,0,0,1180,0,1968,249500.0
3.0,1.0,1260,1.5,0,0,1260,0,1907,485000.0
5.0,3.0,3690,1.0,0,4,2070,1620,1967,1125000.0
3.0,1.75,1700,1.0,0,0,1200,500,1978,314500.0
2.0,1.0,770,1.0,0,0,770,0,1948,220000.0
3.0,2.5,2020,1.0,0,0,1330,690,1958,444950.0
4.0,2.5,2030,1.0,0,0,1330,700,1985,598000.0
4.0,3.5,2690,2.0,0,0,2690,0,2002,699850.0
3.0,2.5,1750,2.0,0,0,1750,0,1991,595000.0
4.0,2.5,3270,2.0,0,0,3270,0,1993,735000.0
4.0,2.5,2330,2.0,0,0,2330,0,1978,542500.0
3.0,1.75,1720,1.0,0,0,1140,580,1978,450000.0
3.0,2.0,2420,1.0,0,0,1420,1000,1959,298500.0
2.0,1.0,710,2.0,0,0,710,0,1943,403950.0
2.0,1.0,710,1.0,0,0,710,0,1942,271000.0
2.0,1.0,1510,1.0,0,0,1510,0,1923,335000.0
2.0,2.25,1610,2.0,0,0,1610,0,1979,305000.0
3.0,3.0,1880,2.0,0,0,1520,360,2007,630000.0
2.0,1.75,1220,1.0,0,0,860,360,1921,253000.0
4.0,1.75,2060,1.0,0,0,1070,990,1957,395000.0
3.0,2.5,1340,1.0,0,0,1140,200,1981,265000.0
2.0,1.0,1030,1.0,0,0,1030,0,1959,225000.0
4.0,2.5,2717,2.0,0,0,2717,0,2005,338500.0
2.0,1.75,1360,1.0,0,0,860,500,1975,300000.0
2.0,1.0,1260,2.0,0,0,1260,0,1945,255000.0
4.0,3.0,2240,2.0,0,0,2240,0,1992,337000.0
3.0,2.25,2080,2.0,0,0,2080,0,1988,324900.0
3.0,2.75,2760,1.0,0,0,1690,1070,1967,821000.0
4.0,2.75,3000,1.0,0,0,3000,0,1975,500000.0
4.0,3.5,3310,2.0,0,2,2200,1110,2010,885000.0
4.0,2.0,1630,1.0,0,0,1630,0,1968,360000.0
3.0,1.0,900,1.0,0,0,900,0,1972,304000.0
2.0,1.0,880,1.0,0,0,760,120,1918,376000.0
4.0,1.5,1620,1.0,0,0,1620,0,1956,425000.0
3.0,1.75,1610,1.0,0,0,1090,520,1973,1180500.0
3.0,2.5,1730,2.0,0,0,1730,0,2005,187000.0
2.0,1.5,1640,1.5,0,0,1540,100,1916,710000.0
3.0,1.75,1840,1.0,0,0,1370,470,1974,585000.0
5.0,4.0,4700,2.0,0,0,4700,0,2002,1400000.0
4.0,3.5,4500,1.0,0,0,3340,1160,1990,1980000.0
3.0,1.75,1780,1.0,0,0,1420,360,1979,250000.0
4.0,2.75,3800,2.0,0,3,3800,0,1986,950000.0
3.0,2.5,2980,2.0,0,0,2980,0,1992,725000.0
4.0,2.5,2780,1.0,0,0,1590,1190,1978,505000.0
1.0,1.0,560,1.0,0,0,560,0,1947,90000.0
4.0,2.0,2060,2.0,0,0,2060,0,1968,400000.0
3.0,1.0,1140,1.0,0,0,1140,0,1954,407000.0
3.0,1.5,1890,1.5,0,0,1890,0,1919,651000.0
3.0,2.25,2090,1.0,0,0,1350,740,1978,485000.0
4.0,2.75,3460,2.0,0,0,3460,0,1932,460000.0
2.0,1.0,1320,1.0,0,0,880,440,1942,369000.0
2.0,1.0,1240,1.0,0,1,1000,240,1943,355000.0
2.0,1.0,810,1.0,0,0,810,0,1980,155000.0
3.0,1.0,1880,1.5,0,0,1880,0,1924,1000000.0
4.0,2.5,2680,2.0,0,0,2680,0,1988,419625.0
3.0,2.0,2040,2.0,0,0,2040,0,1954,435000.0
4.0,1.75,2180,1.0,0,0,1290,890,1977,379000.0
4.0,2.25,1870,2.0,0,0,1870,0,2009,293000.0
4.0,2.75,2310,1.0,0,0,1790,520,1989,592100.0
3.0,1.75,1120,1.0,0,0,1120,0,1944,362000.0
3.0,1.0,1340,1.0,0,0,1340,0,1959,227000.0
3.0,1.75,1260,1.0,0,0,1260,0,1970,335500.0
3.0,1.75,1200,1.5,0,0,1200,0,1977,213000.0
5.0,2.5,2400,2.0,0,0,2400,0,2004,338000.0
3.0,1.0,940,1.0,0,0,940,0,1954,163500.0
2.0,1.0,860,1.0,0,0,860,0,1949,199988.0
3.0,2.25,2390,1.0,0,1,1980,410,1948,1185000.0
4.0,2.5,3130,2.0,0,0,3130,0,2005,320000.0
6.0,2.25,3550,1.0,0,0,2960,590,1948,450000.0
2.0,2.0,1470,2.0,0,0,1470,0,2005,249900.0
2.0,1.0,910,1.0,0,0,910,0,1957,223000.0
4.0,4.0,2630,1.0,0,0,1470,1160,1963,631000.0
4.0,2.25,1780,1.0,0,0,1060,720,1963,350000.0
3.0,1.75,1430,1.0,0,0,900,530,1925,279000.0
5.0,2.0,2730,1.0,0,0,1510,1220,1962,310000.0
2.0,1.0,900,1.0,0,0,900,0,1954,185000.0
3.0,2.5,1740,1.0,0,0,1130,610,1977,445000.0
4.0,2.5,2905,2.0,0,0,2905,0,2003,365000.0
3.0,1.5,2230,1.0,0,0,1390,840,1959,333500.0
3.0,2.25,1680,1.0,0,0,1340,340,1960,385000.0
3.0,1.5,1240,1.0,0,0,1240,0,1954,345000.0
3.0,3.0,3230,2.0,0,3,2220,1010,1998,1260000.0
4.0,2.5,2560,1.0,0,0,1280,1280,1965,440000.0
3.0,2.5,2600,2.0,0,0,2600,0,2002,444500.0
4.0,1.0,1200,1.0,1,3,1200,0,1972,340000.0
4.0,1.0,1660,1.5,0,0,1660,0,1915,680000.0
3.0,1.75,1140,1.0,0,0,1140,0,1982,420000.0
3.0,2.25,3050,2.0,0,0,3050,0,1988,438500.0
2.0,1.0,800,1.0,0,0,800,0,1942,109500.0
4.0,2.75,1700,1.0,0,0,1200,500,1964,461000.0
4.0,1.75,2630,1.0,0,0,2630,0,1963,968000.0
3.0,1.75,1960,1.0,0,0,980,980,1950,355000.0
3.0,1.5,1180,1.0,0,0,1180,0,1962,249000.0
5.0,2.5,1960,1.0,0,0,1360,600,1969,256500.0
5.0,2.5,4250,1.0,0,1,2490,1760,1984,1810000.0
3.0,2.25,1950,1.0,0,0,1950,0,1966,269000.0
4.0,3.5,3600,2.0,0,0,2720,880,1947,1350000.0
3.0,2.25,2060,1.0,0,0,1610,450,1975,885000.0
3.0,2.0,1640,1.0,0,0,1090,550,1971,455000.0
4.0,2.5,2730,1.5,0,0,2230,500,1909,980000.0
3.0,1.75,1530,1.0,0,0,1530,0,1942,412500.0
4.0,3.5,3060,2.0,0,0,3060,0,2007,740000.0
4.0,2.25,2860,2.0,0,3,2130,730,1933,1298000.0
2.0,1.5,1030,3.0,0,0,1030,0,2008,326000.0
4.0,2.5,2460,2.0,0,0,2460,0,1998,568500.0
4.0,2.5,2500,2.0,0,0,2500,0,2013,620000.0
3.0,1.75,1830,2.0,0,0,1490,340,1947,283000.0
6.0,3.25,2820,2.0,0,0,1930,890,1917,875000.0
4.0,2.25,3750,2.0,0,0,2440,1310,1924,1310000.0
3.0,2.5,2070,2.0,0,0,2070,0,2003,289950.0
3.0,2.5,1780,1.0,0,0,1250,530,1974,252500.0
4.0,2.25,2200,1.0,0,0,1480,720,1959,376000.0
4.0,2.5,3240,1.0,0,0,1860,1380,1977,635700.0
4.0,2.5,2880,2.0,0,0,2880,0,1996,710000.0
3.0,1.75,1570,1.0,0,2,980,590,1947,440000.0
3.0,2.5,3180,1.0,0,0,1810,1370,2006,439000.0
2.0,1.5,1310,1.5,0,0,1310,0,1970,455000.0
2.0,1.0,910,1.0,0,0,910,0,1981,225000.0
3.0,1.0,1460,1.0,0,0,1460,0,1959,250000.0
4.0,3.25,3410,2.0,0,0,2470,940,1992,585000.0
3.0,1.75,2720,1.5,0,0,1580,1140,1925,685000.0
5.0,2.75,2280,1.0,0,0,1300,980,1959,420000.0
2.0,1.0,670,1.0,0,0,670,0,1960,245000.0
4.0,2.0,1480,1.0,0,0,1480,0,1957,275000.0
3.0,2.0,2330,1.0,0,0,1390,940,1986,270000.0
4.0,3.0,2170,2.0,0,0,1710,460,1997,767250.0
3.0,2.0,1760,1.0,0,0,1760,0,1943,229000.0
3.0,1.0,1240,1.5,0,0,1240,0,1928,400000.0
5.0,3.25,5210,2.5,0,4,4940,270,1911,2195000.0
5.0,2.0,2800,1.0,0,0,1400,1400,1963,665000.0
4.0,2.25,2060,2.0,0,0,2060,0,1988,500000.0
5.0,2.0,2360,1.0,0,0,2360,0,1968,355500.0
4.0,2.5,2370,2.0,0,0,2370,0,1998,369000.0
2.0,1.0,720,1.0,0,0,720,0,1951,338500.0
3.0,1.0,950,1.0,0,0,780,170,1949,256000.0
3.0,2.5,1980,2.0,0,0,1980,0,1994,470000.0
3.0,2.5,2540,2.0,0,1,2540,0,1940,675000.0
4.0,2.75,2760,1.0,0,0,1400,1360,1997,369950.0
5.0,3.5,2950,2.0,0,3,2350,600,2005,615000.0
5.0,3.0,3640,2.0,0,0,3640,0,1996,1200690.0
3.0,1.75,2150,2.0,0,0,1870,280,1921,950000.0
4.0,2.5,2760,2.0,0,0,2760,0,1993,799500.0
2.0,1.0,840,1.0,0,0,840,0,1952,187000.0
5.0,2.25,2890,2.0,0,0,2890,0,1977,598000.0
3.0,2.25,2060,1.0,0,0,1340,720,1967,429950.0
5.0,2.25,1700,1.5,0,0,1700,0,1962,347950.0
3.0,2.5,3560,2.0,0,0,3560,0,1987,851000.0
3.0,1.0,1210,1.0,0,0,1210,0,1957,205000.0
3.0,2.25,1590,1.0,0,0,1110,480,1979,225000.0
4.0,2.25,2620,1.0,0,0,1520,1100,1979,705000.0
5.0,2.5,3190,2.0,0,0,3190,0,2003,535000.0
3.0,2.0,1450,2.0,0,0,1450,0,1990,222500.0
2.0,1.5,1270,2.0,0,0,1000,270,2006,313500.0
3.0,2.25,2730,2.0,0,2,2730,0,1992,632000.0
3.0,2.0,1840,2.0,0,0,1840,0,2012,467000.0
3.0,2.25,1970,1.0,0,0,1380,590,1978,339000.0
3.0,2.75,3200,2.0,0,0,3200,0,2004,712000.0
3.0,1.0,1060,1.0,0,0,1060,0,1967,335000.0
3.0,3.25,1740,2.0,0,0,1360,380,2007,470000.0
3.0,1.0,810,1.0,0,0,810,0,1968,367000.0
3.0,2.5,2460,2.0,0,0,2460,0,2007,440500.0
4.0,1.0,2100,1.0,0,0,1050,1050,1968,305000.0
3.0,1.75,1530,1.0,0,2,1020,510,1948,635000.0
3.0,2.25,1670,1.5,0,3,1670,0,1903,1020000.0
2.0,2.5,1175,2.0,0,0,740,435,2005,342000.0
3.0,2.25,2130,1.0,0,0,1270,860,1978,283000.0
4.0,2.75,2470,1.0,0,0,1280,1190,1978,430000.0
4.0,2.5,1700,2.0,0,0,1700,0,2000,245000.0
3.0,2.5,2600,2.0,0,0,2600,0,2004,355500.0
3.0,1.0,1460,1.0,0,0,1460,0,1934,395000.0
4.0,2.25,2010,2.0,0,0,2010,0,1988,324900.0
3.0,1.75,1320,1.5,0,0,1320,0,1918,660000.0
3.0,2.5,3150,2.0,0,0,3150,0,1990,570000.0
3.0,2.5,1960,2.0,0,0,1960,0,1984,552321.0
2.0,1.75,2050,1.0,0,0,2050,0,1950,1100000.0
3.0,1.5,1800,1.0,0,0,1800,0,1950,237000.0
2.0,1.0,1210,1.5,0,0,1210,0,1922,402000.0
3.0,2.25,1830,1.0,0,0,1830,0,1963,470000.0
3.0,1.75,1880,1.0,0,0,940,940,1927,395900.0
2.0,1.75,860,1.0,0,0,860,0,1948,442000.0
4.0,2.75,2890,2.0,0,0,2890,0,1997,795000.0
3.0,2.0,1390,1.0,0,0,1130,260,1980,190500.0
4.0,2.75,3340,2.0,0,0,3340,0,1996,808000.0
4.0,2.5,2040,2.0,0,0,2040,0,1998,500000.0
4.0,2.75,3010,2.0,0,0,3010,0,1996,775000.0
5.0,1.75,2110,1.0,0,0,1100,1010,1962,300000.0
5.0,1.75,2110,1.0,0,0,1100,1010,1962,496000.0
4.0,2.5,2510,2.0,0,2,2510,0,2006,448000.0
2.0,2.25,2770,1.0,0,3,1570,1200,1969,645000.0
3.0,1.75,1120,1.5,0,0,1120,0,1925,464600.0
3.0,1.0,1530,2.0,0,0,1530,0,1901,590000.0
3.0,2.5,1800,2.0,0,0,1690,110,2004,399000.0
2.0,1.0,1030,1.0,0,0,1030,0,1925,305000.0
3.0,1.75,1210,1.0,0,0,1210,0,1976,478000.0
1.0,1.0,1090,1.0,0,0,1090,0,1958,598800.0
4.0,2.25,1790,1.0,0,0,1110,680,1973,430000.0
4.0,1.5,1550,1.0,0,0,1180,370,1963,433000.0
4.0,2.75,2400,1.0,0,0,1170,1230,1961,420000.0
4.0,1.75,2470,2.0,0,2,2470,0,1937,585000.0
3.0,1.0,1170,1.0,0,0,1170,0,1969,255000.0
3.0,1.0,1120,1.0,0,0,1120,0,1961,305000.0
4.0,1.0,1040,1.5,0,0,1040,0,1944,396000.0
4.0,2.5,2460,2.0,0,0,2460,0,1989,347500.0
4.0,2.5,3690,2.0,0,0,3690,0,1987,900000.0
3.0,1.75,1960,1.0,0,0,1400,560,1982,425000.0
3.0,2.5,1920,2.0,0,0,1920,0,1995,429000.0
3.0,2.25,1670,2.0,0,0,1220,450,2002,540000.0
3.0,2.0,1340,1.0,0,0,890,450,1974,324950.0
3.0,2.25,2610,2.0,0,0,1980,630,1926,1049000.0
4.0,1.75,1540,1.0,0,0,1260,280,1966,221000.0
3.0,2.0,1640,1.0,0,0,1640,0,1948,405000.0
3.0,2.5,2100,1.0,0,0,2100,0,1953,1150000.0
4.0,1.75,1930,1.0,0,0,1510,420,1972,588000.0
3.0,2.0,1430,1.0,0,0,1430,0,1994,234950.0
4.0,1.5,2430,1.5,0,0,1730,700,1928,580000.0
5.0,3.0,2460,1.0,0,0,1840,620,1991,637000.0
4.0,2.25,2490,1.0,0,0,1490,1000,1953,704000.0
2.0,1.0,880,1.0,0,0,880,0,1938,210000.0
4.0,2.5,2110,2.0,0,0,2110,0,2000,772000.0
4.0,1.75,1850,2.0,0,0,1850,0,1941,763000.0
2.0,1.5,2060,1.5,0,0,2060,0,1930,213500.0
2.0,1.0,1360,1.0,0,0,680,680,1924,255000.0
3.0,2.0,2000,1.0,0,0,1430,570,1978,423500.0
3.0,1.5,1810,1.0,0,0,1810,0,1954,520000.0
3.0,2.75,2230,1.0,0,0,1460,770,1977,550000.0
3.0,2.75,1820,1.0,0,0,1820,0,1997,795000.0
4.0,3.0,2740,2.0,0,0,2240,500,2003,495000.0
4.0,2.5,2710,2.0,0,0,2710,0,1997,455000.0
2.0,1.0,910,1.0,0,0,910,0,1947,85000.0
4.0,2.0,1980,1.5,0,0,1980,0,1924,239000.0
3.0,1.0,1040,1.0,0,0,1040,0,1959,184900.0
4.0,2.25,2810,1.0,0,0,1610,1200,1979,386000.0
4.0,2.5,2000,2.0,0,0,2000,0,1999,415000.0
3.0,1.0,1530,1.0,0,0,1210,320,1962,387000.0
6.0,4.0,5110,2.5,0,0,5110,0,1906,2140000.0
4.0,2.25,3133,2.0,0,0,2533,600,1965,685000.0
4.0,2.5,2020,1.0,0,0,1070,950,1941,340000.0
2.0,1.0,750,1.0,0,0,750,0,1926,422000.0
3.0,2.5,1980,2.0,0,0,1980,0,1994,442000.0
3.0,1.0,1200,1.0,0,0,920,280,1943,280000.0
5.0,2.5,3580,2.0,0,0,3580,0,2000,1150000.0
3.0,2.5,2010,2.0,0,0,2010,0,1990,279000.0
4.0,2.0,1730,1.0,0,0,1060,670,1924,569000.0
5.0,3.5,5960,2.0,0,2,4770,1190,1984,1355000.0
2.0,1.0,860,1.0,0,0,860,0,1960,209950.0
3.0,1.5,1370,1.0,0,0,1370,0,1939,468000.0
3.0,1.75,1360,1.0,0,0,1360,0,1963,237100.0
4.0,2.5,2530,2.0,0,0,2530,0,1993,336000.0
4.0,2.0,1680,2.0,0,0,1680,0,1900,500000.0
3.0,2.5,1580,2.0,0,0,1580,0,1995,290000.0
7.0,3.5,3890,2.0,0,4,2840,1050,1968,1185000.0
5.0,2.0,1600,1.5,0,0,1600,0,1927,365000.0
3.0,1.0,1200,1.0,0,0,1200,0,1975,146300.0
3.0,1.75,1760,1.0,0,0,1760,0,1977,554000.0
3.0,2.0,1670,1.0,0,0,1170,500,1972,424000.0
4.0,3.5,4640,2.0,0,2,3210,1430,2007,1348000.0
4.0,1.5,1800,1.5,0,0,1800,0,1950,508500.0
3.0,1.75,1210,1.0,0,0,1210,0,1985,244500.0
2.0,2.5,1280,2.0,0,0,1280,0,2005,206000.0
3.0,2.0,1650,2.0,0,0,1650,0,1945,643500.0
4.0,1.75,1590,2.0,0,0,1590,0,1922,372500.0
5.0,2.0,1900,1.0,0,2,1720,180,1957,630000.0
2.0,2.5,1500,2.0,0,0,1500,0,2005,418000.0
4.0,2.5,2689,2.0,0,0,2689,0,2006,425000.0
4.0,2.75,3250,2.0,0,0,3250,0,2007,800000.0
2.0,1.0,960,1.0,0,0,960,0,1951,208000.0
3.0,1.75,1650,1.0,0,0,1650,0,1977,476000.0
3.0,2.5,1690,2.0,0,0,1690,0,2003,277500.0
3.0,1.75,2790,1.0,0,0,1410,1380,1970,478000.0
4.0,2.75,2310,3.0,0,0,2310,0,1979,890000.0
3.0,3.5,1790,3.0,0,0,1390,400,2000,450000.0
3.0,1.0,1230,1.0,0,0,1230,0,1965,205000.0
3.0,2.0,1620,1.5,0,0,1620,0,1929,665000.0
4.0,2.75,2440,1.0,0,0,1440,1000,1966,518000.0
4.0,2.25,2100,2.0,0,0,2100,0,1979,465000.0
3.0,2.5,3040,2.0,0,0,3040,0,2003,330000.0
4.0,3.0,2490,2.0,0,0,2490,0,2007,449400.0
3.0,2.75,2690,1.0,0,0,2690,0,2007,829000.0
4.0,1.75,2190,1.0,0,0,2190,0,1964,450000.0
3.0,1.75,1490,1.0,0,0,1490,0,1959,310000.0
3.0,2.25,2530,2.0,0,0,2530,0,1985,615000.0
3.0,2.0,2060,1.0,0,0,1120,940,1947,605000.0
3.0,2.25,1970,2.0,0,0,1970,0,1977,437500.0
3.0,1.75,1400,1.5,0,0,1400,0,1925,545000.0
3.0,2.5,3680,1.0,0,0,2390,1290,1985,770000.0
5.0,2.25,3000,2.0,0,0,3000,0,1975,600000.0
3.0,1.0,1440,2.0,0,0,1440,0,1910,560000.0
5.0,5.75,7730,2.0,0,0,6660,1070,2004,1920000.0
3.0,1.0,1170,1.5,0,0,1170,0,1924,457000.0
2.0,1.0,1770,1.5,0,0,1520,250,1949,585000.0
3.0,2.0,1860,1.0,0,0,1860,0,1985,560000.0
2.0,1.0,770,1.0,0,0,770,0,1917,345000.0
4.0,3.5,3820,2.0,0,2,2440,1380,1955,550000.0
4.0,2.5,3190,2.0,0,0,3190,0,2006,589950.0
3.0,1.5,1320,1.0,0,0,1320,0,1970,327000.0
2.0,2.25,1730,2.0,1,2,1730,0,1947,800000.0
3.0,1.0,1010,1.0,0,0,1010,0,1966,150000.0
2.0,2.5,1140,3.0,0,0,1140,0,2007,425000.0
3.0,1.0,860,1.0,0,0,860,0,1973,350000.0
3.0,1.75,1540,2.0,0,0,1540,0,1978,273000.0
4.0,2.25,2160,1.0,0,0,1080,1080,1961,750000.0
3.0,1.5,1450,1.0,0,0,1450,0,1963,240000.0
3.0,1.75,1830,1.0,0,0,1830,0,1978,400000.0
3.0,1.5,1630,1.0,0,0,980,650,1980,230000.0
4.0,2.5,2500,2.0,0,0,2500,0,1990,372000.0
3.0,1.75,1470,1.0,0,0,1030,440,1984,459500.0
3.0,2.5,2380,2.0,0,0,2380,0,1995,582000.0
4.0,2.5,2170,1.0,0,0,1420,750,1969,465000.0
3.0,2.0,2120,1.0,0,0,2120,0,1991,386000.0
3.0,2.5,1530,2.0,0,0,1530,0,1998,546000.0
3.0,1.75,2710,1.0,0,0,2060,650,1965,278000.0
3.0,2.5,2860,2.0,0,0,2860,0,2004,540000.0
4.0,1.75,2800,2.0,0,0,2800,0,1934,529000.0
4.0,1.0,1120,1.5,0,0,1120,0,1946,554000.0
3.0,1.0,1730,1.0,0,0,1430,300,1963,210000.0
2.0,1.0,1010,1.0,0,0,1010,0,1926,225000.0
4.0,2.5,2350,2.0,0,0,2350,0,1990,561600.0
6.0,5.25,2860,2.0,0,0,2860,0,1978,300000.0
4.0,3.5,4285,2.0,0,1,3485,800,1946,1650000.0
4.0,3.75,4060,2.0,0,0,4060,0,2002,1017100.0
3.0,1.0,1310,1.0,0,0,960,350,1962,150000.0
2.0,1.75,2320,1.0,0,0,1400,920,1948,400950.0
4.0,2.25,2210,2.0,0,0,2210,0,1985,620000.0
4.0,2.75,2090,1.5,0,0,1680,410,1941,449000.0
4.0,2.5,2240,1.0,0,2,1250,990,1926,630000.0
2.0,1.0,1180,1.0,0,0,1180,0,1949,336000.0
4.0,1.75,1560,1.0,0,0,1560,0,1965,299950.0
4.0,2.0,1970,1.0,0,0,1350,620,1962,352500.0
2.0,1.0,840,1.0,0,0,840,0,1925,150000.0
2.0,1.0,840,1.0,0,0,840,0,1925,175000.0
3.0,2.0,1830,1.0,0,0,1830,0,1989,305000.0
4.0,3.75,4475,2.0,1,4,2659,1816,1999,2574000.0
3.0,1.5,1800,1.0,0,0,1200,600,1941,607500.0
2.0,1.0,1250,1.0,0,0,950,300,1920,505000.0
3.0,1.75,2440,1.0,0,0,1220,1220,1962,280500.0
3.0,2.5,2910,2.0,0,2,2910,0,1993,610000.0
5.0,2.75,3060,2.0,0,0,3060,0,2003,381000.0
5.0,2.25,2230,1.0,0,0,1320,910,1978,482000.0
3.0,1.0,1270,1.0,0,0,1270,0,1977,379950.0
4.0,4.5,4300,2.0,0,0,4300,0,1985,2500000.0
3.0,2.25,1580,1.0,0,0,1180,400,1992,425000.0
4.0,2.25,2570,2.0,0,0,2570,0,1980,580000.0
2.0,1.0,860,1.0,0,0,860,0,1952,605000.0
1.0,1.0,820,1.0,0,0,760,60,2007,194000.0
4.0,2.25,2090,2.0,0,0,2090,0,1987,546200.0
4.0,3.5,3560,2.0,0,0,2560,1000,2014,1395000.0
3.0,1.75,1860,1.0,0,0,1240,620,1961,315000.0
3.0,1.5,900,1.5,0,0,900,0,1941,465000.0
2.0,1.0,1160,1.0,0,0,580,580,1963,330000.0
4.0,2.75,3100,2.0,0,0,3100,0,1998,795000.0
4.0,2.25,2300,1.0,0,0,1280,1020,1977,265000.0
4.0,2.5,3110,2.0,0,4,2040,1070,1990,1300000.0
3.0,1.0,1130,1.0,0,0,1130,0,1942,126500.0
4.0,2.5,2920,2.0,0,0,2920,0,2004,760000.0
2.0,1.25,1230,2.0,0,0,1050,180,2009,540000.0
5.0,2.75,2190,1.0,0,0,1370,820,1978,446000.0
1.0,0.75,850,1.0,0,2,850,0,1903,170000.0
3.0,2.5,1500,1.0,0,0,1000,500,1972,379000.0
9.0,4.0,4620,2.5,0,0,3870,750,1915,1400000.0
4.0,2.75,3150,2.0,0,0,3150,0,2004,800000.0
3.0,1.0,1300,1.0,0,0,1300,0,1962,260000.0
5.0,2.5,3160,1.0,0,0,1580,1580,1960,820000.0
3.0,1.75,2070,1.0,0,3,2070,0,1999,449950.0
3.0,2.25,1790,1.0,0,0,1220,570,1974,392000.0
3.0,2.5,1650,2.0,0,0,1650,0,1999,465000.0
4.0,2.5,2070,1.0,0,0,1230,840,1977,449950.0
3.0,1.5,1580,1.5,0,0,1180,400,1923,520000.0
4.0,2.25,2170,1.0,0,0,1420,750,1975,546800.0
4.0,2.75,2220,1.0,0,0,1560,660,1953,825000.0
3.0,1.75,1440,1.0,0,0,1440,0,1985,337000.0
2.0,1.0,720,1.0,0,0,720,0,1942,333000.0
2.0,2.0,1120,2.0,0,0,760,360,2004,380000.0
3.0,2.5,1970,2.0,0,0,1970,0,1992,280000.0
3.0,1.5,1420,1.0,0,0,1420,0,1990,202000.0
4.0,2.5,2250,2.0,0,0,2250,0,2001,585000.0
4.0,2.0,2630,1.0,0,1,1330,1300,1956,435000.0
4.0,3.5,4740,2.0,0,0,4740,0,2003,1200000.0
2.0,2.25,1280,2.0,0,0,1280,0,1992,364000.0
3.0,1.0,1260,1.0,0,0,1260,0,1946,300000.0
2.0,1.75,1930,1.0,0,0,1930,0,2006,558000.0
1.0,1.5,1048,1.0,0,0,1048,0,1942,199950.0
3.0,2.25,1640,1.0,0,0,1640,0,1962,515000.0
4.0,2.5,2380,2.0,0,0,2380,0,2004,590000.0
4.0,2.0,2530,1.0,0,0,2220,310,1964,813500.0
4.0,2.5,2700,2.0,0,0,2700,0,1992,725000.0
3.0,2.25,2330,1.5,0,0,2330,0,1971,490000.0
3.0,2.25,2160,2.0,0,0,2160,0,1994,277000.0
4.0,1.5,1470,1.0,0,0,1470,0,1976,325000.0
4.0,2.5,2280,2.0,0,0,2280,0,1995,649800.0
3.0,1.0,1280,1.5,0,0,1280,0,1903,425000.0
2.0,1.0,850,1.0,0,0,850,0,1975,460000.0
3.0,3.25,4610,2.0,0,0,4610,0,1984,750000.0
5.0,2.5,2690,1.0,0,0,1790,900,1960,469000.0
4.0,1.75,2440,1.0,0,0,1340,1100,1954,566000.0
3.0,2.5,1930,2.0,0,0,1930,0,1996,407500.0
2.0,1.0,800,1.0,0,0,800,0,1942,353500.0
3.0,2.25,2430,1.0,0,0,2430,0,1974,524000.0
4.0,2.5,1990,2.0,0,0,1990,0,1994,264950.0
3.0,2.5,2550,2.0,0,0,2550,0,1990,547500.0
3.0,2.25,1370,2.0,0,0,1370,0,1993,264500.0
3.0,2.0,2020,1.0,0,0,1020,1000,1963,507500.0
3.0,3.5,1560,2.0,0,0,1180,380,2006,560000.0
5.0,4.0,5610,2.0,0,0,4090,1520,1996,995000.0
6.0,2.0,3560,2.5,0,2,3560,0,1900,835000.0
3.0,1.5,2120,1.0,0,0,1220,900,1949,440000.0
3.0,2.5,2920,1.0,0,2,1460,1460,1955,1015000.0
2.0,1.0,1340,1.0,0,2,1340,0,1947,300000.0
3.0,1.0,1230,1.5,0,0,1230,0,1916,125000.0
4.0,3.5,2840,2.0,0,0,1920,920,1910,986000.0
4.0,2.5,2080,1.0,0,0,1680,400,1950,315000.0
4.0,2.5,2070,2.0,0,0,2070,0,1996,320000.0
4.0,3.25,4010,2.0,0,0,4010,0,2003,972000.0
3.0,2.5,2190,1.0,0,0,1540,650,1957,760000.0
4.0,3.0,1730,2.0,0,0,1730,0,1920,265000.0
2.0,1.0,1250,1.0,0,0,1250,0,1948,355000.0
3.0,1.0,1300,1.0,0,0,1300,0,1927,300000.0
5.0,2.5,2080,1.0,0,0,1460,620,1975,474950.0
4.0,2.0,2180,2.0,0,0,2180,0,1977,470000.0
3.0,1.0,1630,1.0,0,0,1630,0,1969,437500.0
2.0,1.5,1840,1.0,0,0,1040,800,1928,520000.0
2.0,1.0,1370,1.0,0,0,1370,0,1950,237600.0
2.0,1.0,950,1.0,0,0,950,0,1972,162950.0
3.0,1.75,1690,1.0,0,0,1690,0,1903,457000.0
3.0,2.5,1780,1.0,0,0,1210,570,1980,635000.0
4.0,3.0,2840,1.5,0,0,2060,780,1931,735000.0
2.0,2.5,2000,2.0,0,4,2000,0,1992,910000.0
3.0,3.25,1570,2.0,0,0,1290,280,2006,346500.0
4.0,2.5,2370,1.0,0,0,1630,740,1984,655000.0
3.0,1.75,1610,1.0,0,0,1610,0,1977,425000.0
3.0,1.0,1300,1.0,0,0,1300,0,1959,137000.0
3.0,2.5,2620,2.0,0,0,2620,0,1988,557500.0
4.0,2.25,3060,2.0,0,0,3060,0,1992,415000.0
5.0,2.25,2780,2.0,0,0,2780,0,1978,830000.0
4.0,3.0,4270,2.0,0,0,4270,0,1991,949000.0
3.0,1.0,1310,1.0,0,0,1310,0,1986,420000.0
2.0,1.0,1100,1.0,0,0,1100,0,1951,353000.0
3.0,1.75,1480,1.5,0,0,1480,0,1980,560000.0
3.0,2.5,1270,3.0,0,0,1270,0,2001,445700.0
4.0,1.0,1270,1.5,0,0,1270,0,1918,226000.0
3.0,1.0,890,1.0,0,0,890,0,1960,358000.0
3.0,1.75,1480,1.0,0,0,740,740,1954,501000.0
4.0,2.5,3240,1.0,0,0,1840,1400,1972,609000.0
4.0,3.25,4280,2.0,0,0,3050,1230,2002,734950.0
5.0,2.5,3210,1.0,0,0,1830,1380,1968,725000.0
3.0,2.25,1870,1.0,0,0,1390,480,1975,350500.0
5.0,2.5,3990,1.0,0,0,1990,2000,1962,610000.0
2.0,1.0,1160,1.0,0,0,910,250,1940,605125.0
4.0,2.25,2940,2.0,0,0,2940,0,1970,1388000.0
3.0,2.25,1850,2.0,0,0,1850,0,1981,550000.0
2.0,1.75,1060,2.0,0,0,760,300,2003,335000.0
3.0,2.0,1100,1.0,0,0,1100,0,1969,397000.0
3.0,2.0,1190,1.0,0,0,1190,0,1994,240000.0
3.0,2.0,1030,1.0,0,0,1030,0,1970,240000.0
2.0,1.5,1140,1.0,0,0,1140,0,1949,262500.0
3.0,1.5,2260,1.0,0,0,1200,1060,1940,440000.0
3.0,1.0,1140,1.5,0,0,1140,0,1910,160000.0
4.0,1.0,1860,1.5,0,0,1860,0,1901,427000.0
4.0,3.5,4080,2.0,0,0,4080,0,2005,920000.0
4.0,2.5,3280,2.0,0,4,2180,1100,1911,2300000.0
4.0,2.5,2870,2.0,0,0,2870,0,1977,480000.0
4.0,1.75,2300,1.0,0,0,1960,340,1977,615000.0
3.0,2.0,2230,1.5,0,0,1290,940,1915,736500.0
3.0,2.5,1920,2.5,0,0,1600,320,2004,542500.0
2.0,1.0,700,1.0,0,0,700,0,1952,191000.0
4.0,2.5,2740,2.0,0,0,2740,0,1991,730000.0
5.0,2.25,3440,2.0,0,2,3440,0,1901,1225000.0
1.0,1.0,650,1.0,0,0,650,0,1967,129000.0
3.0,1.5,1500,1.0,0,0,1500,0,1957,284000.0
3.0,2.5,2490,2.0,0,0,2490,0,2003,645000.0
3.0,1.5,1330,1.0,0,0,1330,0,1968,218000.0
4.0,3.5,3190,2.0,0,2,2120,1070,1999,675000.0
3.0,2.5,1590,2.0,0,0,1110,480,1984,575000.0
2.0,1.0,830,1.0,0,0,830,0,1950,225000.0
3.0,2.25,1810,2.0,0,0,1810,0,1989,626000.0
4.0,2.5,2910,2.0,0,0,2910,0,2001,499950.0
4.0,1.75,2180,1.0,0,0,1090,1090,1956,405000.0
3.0,1.0,1090,1.0,0,0,1090,0,1969,152500.0
4.0,2.5,2160,2.0,0,0,2160,0,1994,325000.0
3.0,1.0,2110,1.0,0,0,1110,1000,1924,475300.0
3.0,1.75,2180,1.0,0,0,1210,970,1967,485000.0
3.0,2.5,2100,2.0,0,0,1500,600,1919,720000.0
3.0,1.75,1410,1.0,0,0,1410,0,1924,465000.0
3.0,1.5,1020,1.0,0,0,920,100,1930,489000.0
5.0,5.25,5090,2.0,0,0,5090,0,2006,3100000.0
3.0,2.25,2090,1.0,0,0,1280,810,1977,288000.0
3.0,1.75,1350,1.0,0,0,1350,0,1968,225000.0
3.0,1.75,2650,1.0,0,1,2240,410,1952,499000.0
5.0,3.0,3520,2.0,0,0,2100,1420,1985,632000.0
3.0,2.5,2040,2.0,0,0,2040,0,1992,580000.0
4.0,1.5,2340,2.0,0,0,2100,240,1912,730000.0
4.0,2.25,1770,2.0,0,0,1770,0,1998,325000.0
3.0,1.75,1100,1.0,0,0,1100,0,1964,421000.0
3.0,2.5,1490,2.0,0,0,1490,0,1998,316000.0
2.0,1.0,1460,1.0,0,0,880,580,1914,415000.0
3.0,2.25,1350,2.0,0,0,1350,0,2003,401000.0
3.0,0.75,1030,1.0,0,0,1030,0,1944,229950.0
3.0,1.75,1820,1.0,0,0,1820,0,1966,539950.0
3.0,2.0,1170,1.0,0,0,1170,0,1919,335000.0
3.0,2.5,1450,2.0,0,0,1450,0,2004,339000.0
4.0,1.75,2200,1.0,0,0,1100,1100,1918,414950.0
4.0,2.0,1610,1.0,0,0,1610,0,1966,650000.0
3.0,2.5,2690,2.0,0,0,2690,0,1994,445000.0
3.0,2.25,1850,2.0,0,0,1850,0,1974,295000.0
4.0,2.25,2250,2.0,0,0,2010,240,1912,975000.0
3.0,1.5,1580,1.0,0,0,1580,0,1961,296500.0
4.0,2.75,2030,1.0,0,0,1550,480,1979,440000.0
5.0,1.5,1890,1.0,0,0,1890,0,1962,420000.0
3.0,2.5,2140,2.0,0,0,2140,0,1994,302000.0
4.0,1.75,1770,1.0,0,0,1770,0,1986,350000.0
3.0,1.75,3320,1.5,0,3,2260,1060,1933,667000.0
3.0,2.0,1640,1.0,0,0,910,730,1941,645000.0
4.0,2.75,1820,1.0,0,0,1220,600,1988,430000.0
4.0,1.0,1410,1.0,0,0,810,600,1925,413000.0
3.0,1.0,1240,1.0,0,0,1240,0,1968,420000.0
3.0,2.25,1780,1.0,0,0,1230,550,1979,495000.0
4.0,4.5,4240,2.0,0,0,4240,0,2004,2187730.0
4.0,2.5,3570,2.0,0,0,3570,0,1990,965000.0
4.0,2.5,1900,1.0,0,0,1200,700,2008,500000.0
3.0,1.0,1010,1.5,0,0,1010,0,1919,636100.0
4.0,2.5,2870,2.0,0,0,2870,0,1986,720000.0
3.0,1.75,1620,1.0,0,0,1340,280,1962,298000.0
2.0,1.75,1480,1.0,0,0,740,740,1925,409000.0
4.0,2.5,2650,2.0,0,0,2650,0,2005,370000.0
5.0,1.0,1410,1.0,0,0,1410,0,1967,230000.0
3.0,2.0,1360,1.0,0,0,1360,0,1952,290000.0
4.0,2.25,2930,1.0,0,0,1560,1370,1977,420000.0
4.0,2.5,3500,2.0,0,2,3500,0,1995,917000.0
5.0,3.25,3160,2.0,0,2,2180,980,2005,957000.0
3.0,2.25,1710,2.0,0,0,1710,0,1989,482000.0
3.0,1.75,2180,2.0,0,0,2180,0,1990,488000.0
5.0,2.5,2870,2.0,0,0,2870,0,2014,760369.0
2.0,1.0,1500,1.0,0,0,1500,0,1950,170000.0
3.0,2.5,2120,1.0,0,0,1230,890,1976,625000.0
3.0,1.5,1590,1.0,0,0,1080,510,1976,357000.0
3.0,2.25,1830,1.0,0,0,1350,480,1989,583000.0
3.0,2.0,1210,1.0,0,0,1210,0,1954,173250.0
4.0,2.0,1590,1.5,0,0,1590,0,1956,414050.0
3.0,1.75,1050,1.5,0,0,950,100,1928,400000.0
3.0,2.0,1550,1.5,0,0,1550,0,1982,537000.0
4.0,2.25,2070,2.0,0,0,2070,0,1977,465000.0
3.0,2.25,1740,1.0,0,0,1740,0,1969,425000.0
4.0,2.0,1700,1.0,0,0,1080,620,1940,445000.0
2.0,1.0,1200,1.0,0,0,1200,0,1958,179950.0
3.0,2.5,1710,2.0,0,0,1710,0,1996,275000.0
4.0,2.5,1840,2.0,0,0,1840,0,1994,190000.0
3.0,1.75,1900,1.0,0,0,1280,620,1982,385000.0
4.0,1.0,2300,1.0,0,0,1220,1080,1928,303000.0
3.0,1.0,970,1.0,0,0,970,0,1967,165000.0
2.0,2.0,1270,1.0,0,0,1270,0,1944,600000.0
3.0,2.25,3130,2.0,0,0,3130,0,1978,710000.0
5.0,3.25,4230,2.0,0,0,2720,1510,1990,875000.0
3.0,2.5,1480,2.0,0,0,1480,0,1996,269950.0
4.0,2.5,3310,2.0,0,0,3310,0,2001,838000.0
4.0,2.0,1590,1.0,0,0,1590,0,1951,670500.0
4.0,1.5,1690,1.0,0,0,1290,400,1960,420000.0
3.0,1.5,1690,1.0,0,0,1430,260,1952,370000.0
3.0,1.75,1500,1.0,0,0,1500,0,1957,360000.0
4.0,2.5,2320,2.0,0,0,2320,0,1991,562500.0
3.0,2.5,3300,1.0,0,0,1650,1650,1961,360500.0
3.0,2.25,1445,2.0,0,0,1300,145,2003,389999.0
4.0,3.0,1890,1.0,0,0,1270,620,1967,450000.0
4.0,2.0,1760,1.0,0,0,1060,700,1962,247500.0
3.0,1.0,1050,1.0,0,0,1050,0,1948,208000.0
3.0,2.5,1980,2.0,0,0,1980,0,1993,455000.0
4.0,1.75,2120,1.0,0,0,1060,1060,1950,379400.0
3.0,1.5,760,1.0,0,0,760,0,1906,190000.0
3.0,1.0,1300,1.0,0,0,1300,0,1977,326188.0
2.0,2.5,1160,2.0,0,0,1160,0,1998,168000.0
4.0,2.5,2340,2.0,0,0,2340,0,2003,314000.0
4.0,2.75,2710,2.0,0,0,2710,0,2000,630000.0
3.0,1.75,1440,1.0,0,0,1440,0,1957,550000.0
4.0,2.25,1980,2.0,0,0,1980,0,1981,530000.0
3.0,1.75,1680,1.0,0,0,1680,0,1966,637500.0
3.0,2.5,1390,2.0,0,0,1390,0,1999,400000.0
5.0,2.75,3100,2.0,0,2,3100,0,1950,700000.0
3.0,2.5,1680,2.0,0,0,1680,0,1991,272000.0
4.0,2.5,2710,2.0,0,0,2710,0,2004,600000.0
2.0,1.0,840,1.5,0,0,840,0,1943,450600.0
3.0,2.25,2090,2.0,0,2,2090,0,1988,550000.0
3.0,1.0,1120,1.0,0,0,1120,0,1987,225000.0
3.0,1.5,1210,1.0,0,0,1210,0,1969,132825.0
3.0,1.5,1210,1.0,0,0,1210,0,1969,219950.0
5.0,2.0,1940,1.0,0,0,970,970,1945,580000.0
3.0,1.75,1930,1.0,0,2,1300,630,1980,568000.0
3.0,1.75,1270,1.0,0,0,1030,240,1990,406000.0
3.0,1.75,1680,1.5,0,0,1170,510,1929,469000.0
3.0,2.5,2090,2.0,0,0,2090,0,2000,415000.0
3.0,1.5,1000,1.0,0,0,1000,0,1956,390000.0
3.0,1.75,1350,1.0,0,0,1350,0,1967,251000.0
3.0,2.5,3280,2.0,0,1,2440,840,2001,750000.0
4.0,2.5,2390,2.0,0,0,1760,630,1988,845000.0
3.0,1.5,1860,1.0,0,0,1860,0,1966,350000.0
3.0,1.0,1380,1.0,0,0,790,590,1944,322000.0
4.0,2.25,3070,2.0,0,0,2740,330,2010,664500.0
3.0,1.75,2190,1.5,0,2,2190,0,1923,988000.0
2.0,1.75,1990,1.0,0,0,1090,900,1952,625000.0
2.0,1.0,930,1.0,0,2,930,0,1951,675000.0
3.0,1.75,2070,1.0,0,0,1420,650,1967,503000.0
4.0,2.25,2170,1.0,0,2,1270,900,1960,431000.0
3.0,1.75,1910,1.0,0,0,1290,620,1964,250000.0
4.0,2.5,2100,2.0,0,0,2100,0,2006,268500.0
6.0,3.25,3560,2.0,0,4,3560,0,1952,1070000.0
4.0,2.5,2290,2.0,0,0,2290,0,2001,295000.0
3.0,2.25,2130,1.0,0,0,1590,540,1977,780000.0
3.0,2.5,2160,2.0,0,0,2160,0,1999,354000.0
2.0,1.0,860,1.0,0,0,860,0,1949,305000.0
5.0,2.75,2880,2.0,0,0,2880,0,2005,733000.0
4.0,2.75,2100,1.0,0,0,1720,380,1968,640000.0
4.0,2.5,2360,1.0,0,2,1630,730,1973,840000.0
5.0,3.25,3680,1.5,0,0,3680,0,1927,1475000.0
3.0,1.0,1560,1.0,0,0,1140,420,1952,525000.0
4.0,2.75,1680,1.0,0,0,1680,0,1966,625000.0
3.0,2.0,1380,3.0,0,0,1380,0,2015,350000.0
4.0,2.75,2610,3.0,0,0,1910,700,1910,650000.0
2.0,1.0,870,1.0,0,2,870,0,1950,435000.0
3.0,1.0,1210,1.0,0,1,1210,0,1955,660000.0
3.0,1.0,1150,1.0,0,0,1150,0,1970,350000.0
3.0,2.5,3110,1.0,0,2,1560,1550,1967,435000.0
6.0,1.5,2550,1.0,0,0,1750,800,1958,375900.0
3.0,3.0,2430,1.0,0,0,2150,280,1983,272000.0
3.0,1.75,1460,1.0,0,0,1040,420,1979,233000.0
4.0,1.5,1330,1.5,0,2,1330,0,1915,500000.0
4.0,1.75,2040,1.0,0,0,1440,600,1977,540000.0
3.0,2.5,2375,2.0,0,0,2375,0,2002,712000.0
4.0,2.5,2480,2.0,0,0,2480,0,2005,425000.0
3.0,1.75,1580,1.0,0,0,790,790,1944,242000.0
5.0,3.25,2740,1.0,0,0,1390,1350,1977,515000.0
4.0,1.75,1920,2.0,0,0,1920,0,1970,415000.0
3.0,2.75,2200,1.0,0,3,1570,630,1977,375000.0
3.0,1.0,910,1.0,0,0,910,0,1971,182500.0
3.0,1.5,1860,1.0,0,0,1240,620,1963,310000.0
3.0,1.75,1510,1.0,0,0,1060,450,1947,360000.0
4.0,3.5,3920,2.0,0,0,3920,0,2004,889000.0
2.0,1.0,1330,1.0,0,0,1330,0,1952,450500.0
4.0,2.25,1964,2.0,0,0,1964,0,2013,342000.0
3.0,2.0,1520,1.0,0,0,1520,0,1996,413000.0
5.0,4.0,3720,2.0,0,0,3720,0,2005,960000.0
2.0,1.0,770,1.0,0,0,770,0,1947,180000.0
4.0,2.5,3210,2.0,0,0,3210,0,1995,770000.0
3.0,1.75,1070,1.0,0,0,1070,0,1994,224400.0
3.0,1.5,1430,1.0,0,0,1430,0,1956,280000.0
3.0,2.5,1670,2.0,0,0,1670,0,2000,500000.0
2.0,1.0,710,1.0,0,0,710,0,1943,153000.0
3.0,2.25,1920,1.0,0,0,1060,860,1921,385000.0
2.0,1.0,750,1.0,0,0,750,0,1947,325000.0
4.0,3.0,2210,2.0,0,0,2210,0,2004,315000.0
4.0,2.5,1660,2.0,0,0,1660,0,1994,294999.0
3.0,1.75,1910,1.5,0,0,1910,0,1963,175000.0
3.0,1.75,1910,1.5,0,0,1910,0,1963,299000.0
2.0,1.0,780,1.0,0,0,780,0,1937,146000.0
3.0,2.25,1650,1.0,0,0,1500,150,1962,290000.0
3.0,3.25,3230,2.0,0,3,3230,0,2005,1776000.0
2.0,1.0,810,1.0,0,0,810,0,1919,367500.0
4.0,2.5,2750,2.0,0,0,2750,0,1994,535000.0
3.0,2.5,1650,2.0,0,0,1650,0,1998,334999.0
3.0,1.75,1960,1.0,0,0,1080,880,1952,655000.0
4.0,3.5,2790,1.5,0,0,2790,0,1985,1298000.0
4.0,2.25,2230,1.0,0,0,1300,930,1977,480000.0
3.0,1.5,1280,1.0,0,0,850,430,1941,465000.0
3.0,2.0,1240,1.0,0,0,1240,0,1967,297950.0
3.0,2.0,1860,1.5,0,0,1110,750,1915,590000.0
4.0,2.75,2410,1.0,0,0,1410,1000,1950,805000.0
3.0,2.25,1960,1.0,0,0,1490,470,1984,204250.0
3.0,2.25,1710,2.0,0,0,1710,0,1994,500000.0
4.0,2.5,3480,1.0,0,0,1980,1500,1977,490000.0
4.0,3.75,3480,1.0,0,4,1870,1610,1951,2500000.0
3.0,2.5,2960,2.0,1,3,2960,0,1990,750000.0
4.0,2.5,2670,2.0,0,0,2330,340,2002,405000.0
2.0,1.0,700,1.0,0,0,700,0,1953,209995.0
4.0,2.5,2830,2.0,0,0,2830,0,1998,680000.0
3.0,1.75,1120,1.0,0,0,860,260,1948,355000.0
2.0,1.0,1310,1.0,0,0,1310,0,1942,280000.0
3.0,2.25,1710,1.0,0,0,1210,500,1978,385000.0
4.0,2.75,2200,1.0,0,0,1100,1100,1962,505000.0
4.0,3.25,3310,2.0,0,0,2380,930,1991,429900.0
4.0,2.5,2280,2.0,0,0,2280,0,1989,560000.0
3.0,2.0,1640,1.0,0,0,1040,600,1977,231000.0
2.0,1.0,750,1.0,0,0,750,0,1943,135000.0
4.0,3.0,3520,1.0,0,0,1980,1540,1954,800000.0
3.0,2.5,2720,2.0,0,0,2720,0,2002,420000.0
3.0,1.0,1660,1.0,0,0,1660,0,1963,360000.0
4.0,2.5,2560,2.0,0,0,2560,0,1992,642000.0
3.0,2.0,1080,1.0,0,0,1080,0,1985,379950.0
3.0,1.75,2050,1.5,0,0,2050,0,1959,745000.0
4.0,2.0,2670,1.5,0,0,1780,890,1930,630000.0
3.0,2.5,1730,2.0,0,0,1730,0,1985,250000.0
3.0,1.0,990,1.0,0,0,990,0,1968,275000.0
6.0,3.0,3560,1.0,0,0,1780,1780,1957,435000.0
2.0,1.0,700,1.0,0,0,700,0,1941,175000.0
4.0,1.75,1880,1.5,0,0,1090,790,1944,560000.0
4.0,2.25,1870,1.0,0,0,1170,700,1959,325000.0
3.0,2.75,2500,2.0,0,0,2500,0,1905,1185000.0
3.0,2.5,2570,2.0,0,0,2570,0,1989,399950.0
4.0,2.5,2940,2.0,0,0,2940,0,1991,752000.0
4.0,3.5,3930,2.0,0,0,3930,0,2003,1200000.0
4.0,1.5,2150,1.0,0,0,2150,0,1952,400000.0
3.0,2.0,1330,1.0,0,0,630,700,1900,240000.0
5.0,2.5,3220,2.0,0,0,3220,0,2003,640000.0
3.0,2.5,2710,2.0,0,0,2710,0,1998,564450.0
3.0,1.5,1630,1.0,0,0,1630,0,1948,300000.0
3.0,2.5,1680,2.0,0,0,1680,0,2003,286000.0
3.0,2.5,1930,2.0,0,0,1930,0,2004,531800.0
4.0,2.25,2140,1.0,0,0,1550,590,1977,502000.0
4.0,2.25,4070,2.0,0,0,4070,0,1968,993500.0
3.0,1.0,1350,1.0,0,0,1350,0,1954,450000.0
4.0,3.5,4270,2.0,0,0,4270,0,2008,997950.0
3.0,1.0,1320,1.5,0,0,1320,0,1913,526000.0
3.0,1.75,2100,1.0,0,0,1230,870,1952,335000.0
2.0,1.0,710,1.0,0,0,710,0,1926,187250.0
3.0,2.25,2350,1.0,0,0,1020,1330,1948,735000.0
3.0,1.0,1180,1.0,0,0,1180,0,1951,425000.0
3.0,1.0,1250,1.0,0,0,1250,0,1945,110000.0
3.0,2.0,1490,1.0,0,0,1490,0,1994,305000.0
3.0,1.0,1000,1.0,0,0,1000,0,1962,212000.0
5.0,4.25,4050,1.0,0,2,2150,1900,1979,1380000.0
5.0,2.25,2300,1.0,0,0,1300,1000,1963,298950.0
3.0,1.75,1330,1.0,0,0,1330,0,1977,525000.0
4.0,3.25,3200,2.0,0,0,3200,0,2004,707000.0
3.0,2.75,2590,2.0,0,0,2590,0,1993,695000.0
3.0,2.75,2590,2.0,0,0,2590,0,1993,796500.0
4.0,2.5,2030,1.0,0,0,1150,880,1973,420000.0
5.0,2.5,2700,1.0,0,0,1950,750,1955,625000.0
3.0,1.75,1670,1.0,0,0,1670,0,1957,620000.0
5.0,2.75,3090,1.0,0,0,3090,0,1953,1450000.0
5.0,2.5,2650,2.0,0,0,2650,0,1984,549950.0
4.0,2.0,1440,1.0,0,0,1440,0,1943,275000.0
3.0,2.5,2820,1.0,0,3,1780,1040,1979,705000.0
3.0,1.75,1690,1.0,0,0,1060,630,1976,197000.0
3.0,1.75,1420,1.0,0,0,1420,0,1991,265000.0
4.0,1.75,1790,1.0,0,0,1050,740,1951,297000.0
3.0,1.75,1320,1.0,0,0,1320,0,1970,207500.0
3.0,2.5,1509,3.0,0,0,1509,0,2014,410000.0
3.0,2.0,1610,1.0,0,0,1610,0,1994,268000.0
4.0,1.75,1550,1.0,0,3,1550,0,1967,330000.0
3.0,1.0,1160,1.0,0,0,1160,0,1917,417500.0
4.0,2.25,2500,2.0,0,0,2500,0,1979,760000.0
3.0,2.5,1540,3.0,0,0,1390,150,1995,499000.0
4.0,2.5,1910,2.0,0,0,1910,0,1987,620000.0
3.0,2.5,2340,2.0,0,0,2340,0,1992,315000.0
3.0,2.5,2060,2.0,0,0,2060,0,1994,624950.0
3.0,2.25,1960,1.0,0,0,1960,0,1961,525000.0
2.0,1.5,1150,2.0,0,0,1150,0,1982,300000.0
4.0,2.75,2330,1.0,0,0,1560,770,1977,299900.0
3.0,2.5,2210,1.0,0,0,1450,760,1966,299000.0
4.0,2.75,3260,1.0,0,0,2170,1090,1968,1880000.0
4.0,1.75,1900,1.0,0,0,1900,0,1958,265000.0
2.0,1.75,1610,1.5,0,0,1610,0,1948,280000.0
3.0,1.0,1340,1.0,0,0,1340,0,1978,124740.0
3.0,2.75,3170,1.0,0,0,3170,0,1957,1085000.0
8.0,3.5,4440,2.0,0,3,3140,1300,1959,1970000.0
4.0,1.0,1370,1.5,0,0,1370,0,1948,219000.0
5.0,1.0,1420,1.5,0,0,1420,0,1926,569950.0
2.0,2.0,1030,1.0,0,0,1030,0,1938,212500.0
3.0,2.25,1820,1.0,0,0,1320,500,1960,680000.0
4.0,1.5,2650,2.0,0,0,2400,250,1909,1457000.0
3.0,1.0,910,1.0,0,0,910,0,1971,300000.0
3.0,2.5,1680,2.0,0,0,1120,560,2014,629950.0
2.0,1.75,1550,1.0,0,0,970,580,1969,349900.0
4.0,2.5,2780,2.0,0,0,2780,0,2001,690000.0
5.0,4.0,4070,2.0,0,0,4070,0,2014,1454000.0
3.0,2.5,3240,2.0,0,0,3240,0,1987,1288000.0
4.0,3.5,3650,2.0,0,0,2550,1100,1996,696000.0
3.0,2.25,2180,2.0,0,0,2180,0,1976,650000.0
3.0,3.5,2480,2.0,0,0,2480,0,1998,640000.0
5.0,2.5,3180,1.0,0,0,3180,0,1978,499950.0
4.0,2.5,3630,2.0,0,0,3630,0,1997,490000.0
5.0,2.5,3160,2.0,0,0,3160,0,2003,685000.0
4.0,1.0,1370,2.0,0,0,1370,0,1942,387500.0
2.0,1.5,1070,2.0,0,0,1000,70,2005,401750.0
4.0,2.0,2180,1.0,0,0,1170,1010,1977,254950.0
4.0,2.25,2420,2.0,0,0,2420,0,1977,500000.0
4.0,2.5,3290,2.0,0,0,3290,0,2003,856500.0
3.0,1.0,1430,1.0,0,0,1080,350,1919,552000.0
4.0,2.5,1890,1.0,0,0,1500,390,1978,506500.0
3.0,2.25,1760,2.0,0,0,1760,0,1988,500000.0
4.0,2.75,2230,1.0,0,0,1400,830,1968,280000.0
3.0,1.75,1630,1.0,0,0,1330,300,1979,308000.0
3.0,2.5,2350,2.0,0,0,2350,0,1989,613500.0
3.0,1.75,1550,1.0,0,0,1050,500,1976,255000.0
3.0,2.5,3550,2.0,0,0,3550,0,1977,545000.0
4.0,2.5,2720,1.0,0,0,1360,1360,1966,620000.0
3.0,1.75,1740,1.5,0,0,1740,0,1949,450000.0
4.0,1.75,1840,1.0,0,0,1090,750,1976,279000.0
3.0,2.5,2010,2.0,0,0,2010,0,2009,625000.0
3.0,1.75,1670,1.0,0,0,1320,350,1987,274950.0
3.0,1.75,1820,1.0,0,0,1040,780,1952,423000.0
2.0,1.0,720,1.0,0,1,720,0,1950,350000.0
4.0,1.75,2370,1.0,0,0,1460,910,1968,305000.0
3.0,1.75,2120,1.0,0,3,1060,1060,1966,368000.0
3.0,1.75,1290,1.0,0,0,1290,0,1984,232000.0
4.0,3.0,1800,2.0,0,0,1800,0,2000,250000.0
3.0,1.75,1230,1.0,0,0,1230,0,1966,220000.0
3.0,2.0,1380,1.0,0,0,750,630,1986,435000.0
2.0,1.0,740,1.0,0,0,740,0,1922,350000.0
5.0,2.5,1720,1.5,0,0,1720,0,1970,206325.0
5.0,2.5,1720,1.5,0,0,1720,0,1970,339000.0
4.0,2.5,2100,1.0,0,0,2100,0,1969,399000.0
2.0,1.0,1210,1.0,0,0,900,310,1950,529000.0
4.0,2.5,2210,2.0,0,0,2210,0,1999,640000.0
4.0,2.5,2470,3.0,0,0,2470,0,2004,735000.0
5.0,2.5,2760,1.0,0,0,1600,1160,1960,378000.0
3.0,2.0,2540,1.5,0,3,1600,940,1905,775000.0
3.0,4.25,5150,2.5,0,2,4170,980,1954,2250000.0
4.0,4.5,3420,3.0,0,0,3420,0,2014,1350000.0
4.0,2.5,2270,1.0,0,0,1540,730,1967,380000.0
4.0,2.5,2270,1.0,0,0,1540,730,1967,624900.0
3.0,2.5,1470,2.0,0,0,1160,310,2005,379770.0
3.0,1.75,1280,1.0,0,0,1030,250,1976,340000.0
4.0,2.75,2830,2.0,0,0,2830,0,2005,515500.0
4.0,2.25,1970,1.5,0,0,1500,470,1908,600000.0
1.0,1.0,1390,1.0,0,0,1390,0,1960,400000.0
4.0,1.0,1020,1.5,0,0,1020,0,1947,364000.0
4.0,2.5,2250,2.0,0,0,2250,0,1989,440000.0
2.0,1.0,800,1.0,0,0,800,0,1954,285000.0
3.0,1.0,1560,1.5,0,0,1560,0,1915,669000.0
4.0,2.0,2100,1.0,0,0,1050,1050,1962,475000.0
2.0,1.0,990,1.0,0,0,990,0,1911,747000.0
3.0,1.5,1060,1.0,0,0,1060,0,1981,317000.0
2.0,1.0,1270,1.0,0,0,1270,0,1941,390000.0
4.0,2.5,2740,2.0,0,0,2740,0,2012,1070000.0
4.0,2.75,2470,1.0,0,3,1570,900,1960,1205000.0
3.0,1.75,1970,1.0,0,0,1130,840,1908,580000.0
4.0,2.5,2070,1.0,0,0,1370,700,1969,518000.0
3.0,1.75,1010,1.0,0,0,1010,0,1969,147500.0
4.0,2.25,2220,1.0,0,0,1450,770,1965,555000.0
2.0,2.0,1090,3.0,0,0,1090,0,2008,427500.0
3.0,2.5,4310,1.5,0,4,2510,1800,1982,1735000.0
3.0,2.5,1490,2.0,0,0,1490,0,2002,265950.0
2.0,1.0,700,1.0,0,0,700,0,1950,247500.0
4.0,1.0,1450,1.0,0,0,1450,0,1943,244000.0
3.0,2.5,2120,2.0,0,0,2120,0,1989,578550.0
4.0,2.5,1670,2.0,0,0,1670,0,2005,451000.0
2.0,1.75,1810,2.0,0,0,1810,0,2004,489000.0
2.0,1.0,710,1.0,0,0,710,0,1915,190000.0
3.0,3.0,2540,1.0,0,0,1580,960,1978,475000.0
3.0,2.0,1420,1.5,0,0,1420,0,1905,485000.0
3.0,2.75,2440,2.0,0,0,1840,600,1987,530000.0
4.0,2.5,2570,2.0,0,0,2570,0,1994,379000.0
5.0,2.5,3090,2.0,0,0,3090,0,1964,1629000.0
3.0,1.75,2050,1.5,0,0,1300,750,1926,739000.0
3.0,1.0,920,1.0,0,0,920,0,1969,189950.0
4.0,3.0,2320,2.0,0,0,2160,160,1999,637500.0
3.0,3.0,3450,1.0,0,4,1960,1490,1949,2225000.0
3.0,1.0,1660,1.0,0,0,960,700,1963,209950.0
3.0,1.0,1130,1.0,0,0,830,300,1944,460000.0
4.0,2.5,2550,2.0,0,0,2550,0,1998,543500.0
4.0,2.75,2420,2.0,0,0,2420,0,2005,376000.0
3.0,2.25,1470,2.0,0,0,1470,0,2005,430000.0
4.0,2.5,2030,1.0,0,0,1530,500,1953,515000.0
7.0,2.75,2310,1.5,0,0,2310,0,1915,580000.0
5.0,3.5,3370,2.0,0,1,2650,720,1998,600000.0
3.0,1.75,1900,1.5,0,0,1900,0,1919,476800.0
3.0,1.5,1940,2.0,0,0,1740,200,1916,815000.0
3.0,2.5,2420,2.0,0,0,2420,0,1998,455600.0
3.0,1.0,1010,1.0,0,0,1010,0,1969,270000.0
5.0,4.0,2710,3.0,0,0,2380,330,1974,1200000.0
2.0,1.5,1340,1.5,0,0,1340,0,1903,525000.0
3.0,1.75,1310,1.0,0,0,1310,0,1979,242000.0
4.0,2.5,2650,1.0,0,0,1680,970,1960,715000.0
3.0,2.75,1890,2.0,0,0,1890,0,1999,475000.0
4.0,3.0,2580,2.0,0,0,2580,0,1999,370000.0
4.0,2.75,3500,2.0,0,0,3500,0,2005,788600.0
2.0,1.0,1040,1.0,0,0,1040,0,1912,160000.0
5.0,1.75,1930,2.0,0,0,1930,0,1930,800000.0
4.0,3.0,2190,2.0,0,0,2190,0,1992,520000.0
3.0,1.75,1530,2.0,0,0,1530,0,1985,725000.0
4.0,1.0,1480,1.5,0,0,1480,0,1914,335000.0
4.0,2.5,3620,1.0,0,4,2220,1400,1993,919000.0
3.0,2.75,3370,2.0,0,0,2650,720,1986,425000.0
5.0,2.5,2100,1.0,0,0,1140,960,1983,420000.0
4.0,3.0,3370,2.0,0,0,3370,0,1981,905000.0
2.0,1.0,2240,1.0,0,0,1120,1120,1940,435000.0
3.0,2.5,1650,2.0,0,0,1650,0,2003,438000.0
4.0,2.75,2630,2.0,0,0,2630,0,1994,725000.0
4.0,1.75,2330,2.0,0,0,1300,1030,1924,840000.0
3.0,2.5,1970,2.0,0,0,1970,0,1978,425500.0
3.0,2.5,2820,1.0,0,4,1770,1050,1985,853505.0
2.0,1.0,590,1.5,0,0,590,0,1983,398000.0
3.0,2.5,2060,2.0,0,0,2060,0,2007,418500.0
3.0,1.5,1890,1.5,0,0,1890,0,1929,826000.0
4.0,2.5,2810,2.0,0,0,2810,0,1997,742000.0
4.0,1.0,1470,1.5,0,0,1470,0,1924,180000.0
4.0,1.75,2190,2.0,0,0,2190,0,1978,286000.0
3.0,2.5,1440,2.0,0,0,1440,0,2003,421200.0
3.0,3.0,2480,1.0,0,0,1500,980,1994,390000.0
4.0,2.5,2780,2.0,0,0,2780,0,2002,739000.0
4.0,3.0,2180,2.0,0,0,2180,0,1968,499900.0
3.0,2.25,3340,1.0,0,0,3340,0,1950,670000.0
3.0,2.25,2560,1.5,0,0,2150,410,1910,842500.0
2.0,2.25,1600,2.0,0,0,1600,0,1978,492500.0
3.0,2.5,2230,3.0,0,3,2230,0,1996,836500.0
2.0,1.0,900,2.0,0,0,900,0,1945,334000.0
3.0,1.0,1010,1.0,0,0,1010,0,1977,179900.0
3.0,2.0,1580,1.0,0,0,870,710,1940,563000.0
3.0,2.5,1890,2.0,0,0,1890,0,2003,310000.0
4.0,2.25,2160,1.0,0,0,1460,700,1965,335000.0
4.0,2.25,2160,1.0,0,0,1460,700,1965,499950.0
2.0,1.0,1410,1.5,0,0,1410,0,1927,658500.0
2.0,1.5,1430,3.0,0,0,1430,0,1999,297000.0
6.0,1.75,2380,2.0,0,0,2380,0,1917,725000.0
3.0,2.25,2206,1.0,0,2,866,1340,1983,780000.0
3.0,1.0,1030,1.0,0,0,880,150,1947,252500.0
3.0,2.5,1070,2.0,0,0,720,350,2005,330000.0
3.0,2.5,2320,1.0,0,0,1730,590,1990,525000.0
2.0,1.75,1270,1.0,0,0,1270,0,1982,365000.0
4.0,3.0,2570,2.0,0,2,2570,0,1930,500000.0
3.0,1.0,920,1.0,0,0,920,0,1969,179950.0
3.0,2.0,1790,1.0,0,0,1790,0,2007,440000.0
1.0,0.75,480,1.0,0,0,480,0,1948,145000.0
4.0,3.0,2483,2.0,0,0,2483,0,2005,331000.0
3.0,2.25,2140,2.0,0,0,2140,0,1905,780000.0
3.0,1.75,1900,1.0,0,0,1300,600,1965,855000.0
3.0,2.25,1650,1.0,0,0,1290,360,1986,225000.0
3.0,1.0,1510,1.0,0,0,1510,0,1966,199000.0
3.0,1.75,2910,1.5,0,0,2910,0,1979,550000.0
4.0,4.25,4960,2.5,0,0,3680,1280,1909,1425000.0
3.0,2.0,2710,1.5,0,0,1880,830,1929,805000.0
3.0,1.5,1810,1.0,0,0,950,860,1983,261000.0
3.0,1.0,940,1.0,0,0,940,0,1968,347000.0
3.0,2.25,1600,1.0,0,0,1090,510,1979,390000.0
4.0,2.5,2640,2.0,0,0,2640,0,2000,436000.0
5.0,3.25,3890,1.0,0,0,2260,1630,1977,1802750.0
3.0,2.5,1630,3.0,0,0,1630,0,2004,557000.0
3.0,1.0,830,1.0,0,0,830,0,1959,135000.0
3.0,2.5,1800,2.0,0,0,1800,0,1993,425000.0
3.0,2.25,2060,1.0,0,0,1070,990,1964,648752.0
4.0,3.0,4040,1.0,0,0,2020,2020,1972,1388000.0
4.0,2.75,1910,1.0,0,0,1160,750,1977,630100.0
4.0,2.5,2800,2.0,0,0,2800,0,1999,739000.0
3.0,1.5,1320,2.0,0,0,1320,0,1986,269000.0
3.0,1.0,1220,1.0,0,0,1220,0,1942,250000.0
5.0,2.75,3100,2.0,0,0,3100,0,2007,475000.0
1.0,1.0,550,1.0,0,0,550,0,1916,290000.0
3.0,1.0,1080,1.5,0,0,1080,0,1953,219000.0
2.0,1.0,880,1.0,0,0,880,0,1918,416000.0
2.0,1.0,720,1.0,0,0,720,0,1949,179000.0
4.0,2.75,2030,1.0,0,0,2030,0,1988,302000.0
4.0,2.0,2040,2.0,0,1,2040,0,1961,565000.0
3.0,1.0,1570,1.0,0,0,1070,500,1962,281700.0
2.0,1.0,1500,1.0,0,0,1500,0,1902,480000.0
4.0,2.5,3180,2.0,0,0,3180,0,1988,775000.0
3.0,1.75,1260,1.0,0,0,1260,0,1947,375000.0
3.0,1.5,1390,2.0,0,0,1390,0,1979,345000.0
3.0,3.0,2850,1.0,0,0,2240,610,1977,300000.0
4.0,2.5,2070,2.0,0,0,2070,0,2002,364950.0
3.0,3.25,2650,1.0,0,2,1760,890,1956,410000.0
3.0,1.75,1220,1.0,0,0,1220,0,1978,231000.0
3.0,2.0,1630,1.0,0,0,1630,0,1987,445000.0
2.0,2.5,1785,2.0,0,0,1595,190,1975,530000.0
3.0,2.5,1260,2.0,0,0,840,420,2008,353500.0
3.0,1.5,1380,1.0,0,0,1380,0,1960,209950.0
3.0,1.75,2330,1.0,0,0,1320,1010,1950,650000.0
2.0,1.0,840,1.0,0,0,840,0,1948,325000.0
3.0,2.25,1730,1.0,0,0,1180,550,1978,257000.0
4.0,2.5,2230,2.0,0,0,2230,0,2002,337000.0
3.0,2.5,1790,2.0,0,0,1790,0,2005,541000.0
3.0,2.5,2280,2.0,0,0,2280,0,1984,577500.0
3.0,2.5,2430,1.0,0,1,1270,1160,1978,560000.0
5.0,3.0,3730,1.5,0,0,2160,1570,1927,979700.0
5.0,3.0,2230,1.0,0,0,1150,1080,1960,750000.0
2.0,1.0,770,1.0,0,2,770,0,1923,407500.0
4.0,1.75,1814,1.0,0,0,944,870,1951,530000.0
4.0,1.75,1920,1.0,0,0,1000,920,1977,235000.0
4.0,2.5,1860,1.5,0,0,1170,690,1928,715000.0
5.0,3.0,2750,1.0,0,0,1730,1020,1957,795000.0
4.0,2.5,1930,1.0,0,0,1930,0,1968,465000.0
3.0,2.5,1950,2.0,0,0,1950,0,1990,287600.0
6.0,3.0,2470,2.0,0,0,2470,0,1982,630000.0
3.0,2.25,1630,1.0,0,0,1310,320,1986,445000.0
4.0,2.25,2110,1.0,0,0,1630,480,1978,490000.0
3.0,1.75,1490,1.0,0,1,1250,240,1954,565000.0
3.0,2.5,1740,2.0,0,0,1320,420,2008,330000.0
4.0,2.75,1900,1.0,0,2,1300,600,1961,463000.0
5.0,4.0,4510,2.0,0,0,4510,0,1969,1870000.0
3.0,1.0,1090,1.5,0,0,1090,0,1912,219500.0
3.0,1.75,1720,1.0,0,0,1420,300,1959,622200.0
2.0,3.25,1400,3.0,0,0,1400,0,2000,474800.0
4.0,2.5,2090,1.0,0,0,1320,770,1965,465000.0
3.0,1.75,1580,1.0,0,0,1580,0,1966,389950.0
4.0,2.5,2620,2.0,0,0,2620,0,1984,650000.0
3.0,2.0,1500,1.0,0,0,870,630,2003,395000.0
4.0,2.5,2030,2.0,0,0,2030,0,2001,304500.0
3.0,1.0,1020,1.0,0,0,1020,0,1949,307000.0
3.0,2.5,1540,1.0,0,0,770,770,1938,485000.0
5.0,3.0,3910,1.0,0,0,2890,1020,1960,1562000.0
5.0,4.25,3920,2.0,0,0,3920,0,1955,650500.0
4.0,2.5,3180,2.0,0,0,3180,0,1986,960000.0
3.0,2.5,2330,2.0,0,0,2330,0,1997,710000.0
3.0,2.5,2600,1.5,1,4,2150,450,1912,540000.0
4.0,1.75,1950,1.0,0,0,1040,910,1951,601000.0
5.0,1.75,3250,1.0,0,2,1650,1600,1965,463828.0
4.0,1.0,1130,1.5,0,0,1130,0,1944,293000.0
3.0,2.5,2620,2.0,0,0,2620,0,2002,597500.0
2.0,1.0,1120,1.0,0,2,1120,0,1932,240000.0
3.0,1.75,1800,1.0,0,0,1800,0,1968,284000.0
4.0,1.75,2180,1.0,0,2,2000,180,1966,440000.0
3.0,1.75,1960,1.0,0,0,980,980,1948,340000.0
3.0,1.75,1960,1.0,0,0,980,980,1948,363000.0
2.0,1.0,1150,1.0,0,0,1150,0,1910,270000.0
4.0,2.5,2800,2.0,0,0,2800,0,1997,365000.0
3.0,2.0,1310,1.0,0,0,780,530,1986,428000.0
3.0,1.75,2340,1.0,0,0,2340,0,1988,600000.0
3.0,2.5,1430,1.0,0,0,1430,0,1960,405000.0
4.0,2.5,2340,1.0,0,1,1610,730,1981,339900.0
3.0,1.0,1290,1.0,0,0,1290,0,1956,275000.0
2.0,1.0,760,1.0,0,0,760,0,1941,361600.0
6.0,2.0,2780,2.5,0,0,2780,0,1955,325000.0
3.0,2.0,2090,1.5,0,0,1530,560,1931,1050000.0
4.0,3.0,3060,1.0,0,2,2460,600,1957,959750.0
3.0,1.0,1110,1.0,0,0,1110,0,1962,210000.0
3.0,2.0,1790,1.5,0,0,1790,0,1998,258000.0
3.0,1.5,1830,1.0,0,0,1830,0,1962,468000.0
4.0,3.5,2850,2.0,0,2,1970,880,1905,710000.0
3.0,1.0,1420,1.0,0,0,1420,0,1941,268000.0
2.0,1.0,790,1.0,0,0,790,0,1930,115000.0
3.0,2.5,2300,2.0,0,0,2300,0,1998,500000.0
3.0,2.5,2440,1.0,0,0,2440,0,1996,431000.0
3.0,2.0,1310,1.0,0,0,870,440,1995,241500.0
3.0,1.0,1380,1.0,0,0,1380,0,1963,300000.0
4.0,2.5,2790,2.0,0,0,2790,0,1987,982000.0
3.0,2.5,1360,2.0,0,0,1360,0,1988,248500.0
4.0,2.5,2510,2.0,0,0,2510,0,1998,665000.0
3.0,3.0,4560,2.0,0,2,4040,520,2001,1215000.0
2.0,1.0,780,1.0,0,0,780,0,1918,380000.0
3.0,2.0,1410,1.0,0,0,1410,0,1940,220000.0
4.0,2.0,2530,1.5,0,0,1910,620,1910,631500.0
3.0,2.0,1270,1.0,0,0,1270,0,1972,386100.0
4.0,4.5,3180,2.0,0,3,1990,1190,1929,1050000.0
2.0,1.75,1450,1.5,0,0,1350,100,1903,650000.0
4.0,1.75,2040,1.0,0,0,1160,880,1959,545000.0
4.0,2.5,2650,2.0,0,0,2650,0,1984,870000.0
3.0,1.75,1240,1.0,0,0,1240,0,1973,380000.0
2.0,1.0,820,1.0,0,2,820,0,1957,265000.0
2.0,1.0,1890,1.5,0,0,1890,0,1909,645500.0
3.0,2.0,1270,2.0,0,0,1270,0,1911,570000.0
4.0,2.5,3350,1.0,0,2,1760,1590,1995,1200000.0
2.0,1.0,1550,1.5,0,0,1550,0,1927,605000.0
3.0,1.0,920,1.0,0,0,920,0,1962,199500.0
2.0,1.0,950,1.0,0,0,950,0,1941,445000.0
4.0,1.75,2040,1.0,0,0,1020,1020,1917,495000.0
4.0,1.75,1870,2.0,0,0,1200,670,1937,594000.0
3.0,1.75,1720,1.0,0,0,900,820,1943,465000.0
2.0,1.0,1020,1.0,0,0,1020,0,1915,160000.0
4.0,2.5,2690,2.0,0,0,2690,0,1998,340000.0
4.0,2.0,3090,1.0,0,0,3090,0,1990,870000.0
3.0,1.5,1070,1.0,0,0,1070,0,1940,249000.0
4.0,2.25,2050,2.0,0,0,2050,0,1994,500000.0
3.0,1.5,1660,2.0,0,0,1660,0,1981,220000.0
5.0,1.75,2810,1.0,0,0,1520,1290,1965,368500.0
4.0,2.25,2460,1.0,0,0,1720,740,1977,439950.0
3.0,1.75,1230,1.0,0,0,1230,0,1970,179900.0
4.0,2.5,2360,2.0,0,0,2360,0,2003,490000.0
4.0,1.75,1730,1.0,0,0,980,750,1955,425000.0
4.0,2.5,2770,2.0,0,0,2770,0,1991,533300.0
4.0,2.0,1770,2.0,0,0,1630,140,1924,447500.0
5.0,2.75,3030,2.0,0,0,3030,0,1980,768000.0
3.0,1.75,2380,1.5,0,0,1320,1060,1935,285000.0
3.0,1.75,1780,1.0,0,0,1780,0,1979,336900.0
4.0,1.5,1540,2.0,0,0,1540,0,1967,415000.0
3.0,2.25,1580,2.0,0,0,1580,0,1994,500000.0
4.0,2.5,3200,2.0,0,0,3200,0,2003,337000.0
4.0,2.5,2220,2.0,0,0,2220,0,2002,419950.0
4.0,2.75,2240,2.0,0,0,1380,860,1946,290000.0
2.0,1.75,1640,1.0,0,0,1040,600,1948,349950.0
3.0,1.5,1170,1.0,0,0,1170,0,1960,330000.0
4.0,2.25,3160,1.0,0,0,3160,0,1981,965000.0
3.0,2.5,2100,2.0,0,0,2100,0,1986,515000.0
4.0,2.5,2600,2.0,0,0,2600,0,1996,665000.0
3.0,1.75,1630,1.5,0,0,1630,0,1985,265000.0
3.0,2.0,2850,1.0,0,3,2340,510,2004,545400.0
4.0,3.0,2560,2.0,0,0,2560,0,2004,350000.0
2.0,1.5,980,2.0,0,0,840,140,2001,260000.0
3.0,3.25,5480,2.0,1,4,5480,0,1991,2510000.0
3.0,2.0,2160,1.5,0,0,2160,0,2000,355000.0
3.0,3.0,3030,1.5,0,0,2080,950,1929,879000.0
4.0,3.5,3560,2.0,0,3,2590,970,2006,833000.0
2.0,1.0,760,1.0,0,0,760,0,1943,261590.0
3.0,3.0,2260,2.0,0,0,2260,0,1909,512500.0
2.0,1.75,1560,1.0,0,0,880,680,1946,600000.0
5.0,3.0,2270,1.0,0,0,1340,930,1995,417500.0
5.0,3.0,3480,2.0,0,0,3480,0,1964,970000.0
3.0,2.25,1900,2.0,0,0,1900,0,1992,316000.0
4.0,3.0,2350,1.0,0,0,1650,700,1989,397500.0
3.0,2.5,2390,1.0,0,3,1700,690,1952,1350000.0
4.0,2.5,3730,2.0,0,0,3730,0,1997,840000.0
2.0,1.0,1780,1.0,0,3,1780,0,1954,270000.0
4.0,2.5,1630,2.0,0,0,1630,0,2003,312900.0
2.0,1.0,1130,1.5,0,0,1130,0,1945,325000.0
3.0,1.75,2140,1.0,0,0,1070,1070,1952,680000.0
4.0,2.5,3220,2.0,0,0,3220,0,1994,763000.0
1.0,1.0,800,1.5,0,0,800,0,1950,375000.0
3.0,2.5,1800,2.0,0,0,1690,110,2004,475000.0
2.0,2.5,809,2.0,0,0,809,0,2003,219000.0
3.0,2.25,1820,1.0,0,0,1240,580,1977,415000.0
2.0,1.0,580,1.0,0,0,580,0,1943,90000.0
2.0,1.0,580,1.0,0,0,580,0,1943,220000.0
3.0,2.0,2900,1.0,0,2,1520,1380,1959,616000.0
2.0,1.0,1140,1.0,0,0,1140,0,1968,269500.0
2.0,1.0,1060,1.0,0,0,1060,0,1917,395350.0
4.0,3.0,2320,1.0,0,0,1260,1060,1943,770000.0
4.0,2.5,3450,2.0,0,0,3450,0,2000,840000.0
2.0,1.0,1760,1.0,0,0,1310,450,1950,428950.0
4.0,3.75,3370,2.0,0,0,3370,0,2005,800000.0
4.0,1.0,1940,1.5,0,0,1940,0,1947,401000.0
4.0,2.0,2520,1.0,0,0,1600,920,1955,303697.0
3.0,1.0,1360,1.0,0,0,1360,0,1956,355000.0
2.0,1.0,800,1.0,0,0,800,0,1960,350000.0
4.0,2.5,3010,2.0,0,0,3010,0,1992,754999.0
3.0,1.75,2340,2.0,0,2,2340,0,1988,982218.0
3.0,2.0,1780,1.0,0,0,1780,0,1992,406500.0
4.0,3.25,4200,2.0,0,0,4200,0,1993,1650000.0
2.0,1.75,1720,1.0,0,0,860,860,1925,565000.0
2.0,1.0,830,1.0,0,0,830,0,1920,160000.0
3.0,1.0,1090,1.0,0,0,890,200,1954,220000.0
5.0,4.25,5040,2.0,0,0,5040,0,2004,1284000.0
5.0,2.75,3500,2.0,0,2,2950,550,1927,970000.0
3.0,1.0,1080,1.0,0,0,1080,0,1950,115000.0
3.0,1.0,1080,1.0,0,0,1080,0,1950,124000.0
3.0,1.0,1080,1.0,0,0,1080,0,1950,157000.0
3.0,1.0,870,1.0,0,0,870,0,1969,183000.0
4.0,2.5,2830,2.0,0,0,2830,0,2000,527000.0
4.0,2.0,1880,2.0,0,0,1880,0,1978,407193.0
4.0,2.75,3600,2.0,0,0,2610,990,2004,970000.0
4.0,2.5,2340,2.0,0,0,2340,0,1921,535000.0
3.0,2.0,2040,1.0,0,0,810,1230,1910,245000.0
3.0,1.75,1310,1.0,0,0,1310,0,1993,337000.0
3.0,2.0,1470,1.0,0,0,1090,380,1950,630000.0
3.0,1.75,1370,1.0,0,0,1370,0,1983,320000.0
3.0,1.0,1080,1.5,0,0,990,90,1942,228500.0
3.0,2.5,1990,2.0,0,0,1990,0,1990,293000.0
3.0,1.0,1310,1.0,0,0,1310,0,1958,447000.0
3.0,1.75,1640,1.0,0,0,1130,510,1988,226500.0
3.0,2.25,1770,1.0,0,0,1350,420,1976,436000.0
3.0,2.5,2050,2.0,0,0,2050,0,2005,451000.0
3.0,1.0,1170,2.0,0,0,1170,0,1986,315000.0
2.0,1.0,1340,1.0,0,0,1340,0,1951,450000.0
3.0,1.5,2240,1.0,0,0,1120,1120,1955,635000.0
2.0,1.0,880,1.0,0,0,880,0,1951,292500.0
3.0,2.5,2170,2.0,0,0,2170,0,2004,329900.0
2.0,1.5,1260,1.5,0,0,1260,0,1926,531000.0
3.0,1.75,1880,1.0,0,0,1380,500,1967,725000.0
3.0,2.5,1620,1.0,0,0,1620,0,1955,355300.0
3.0,2.5,1610,2.0,0,0,1610,0,1996,280000.0
4.0,2.75,3330,2.0,0,0,3330,0,1995,1095000.0
4.0,2.0,1370,2.0,0,0,1370,0,1951,605004.0
2.0,1.0,690,1.0,0,0,690,0,1949,260000.0
4.0,2.5,3170,2.0,0,0,2570,600,1925,748000.0
2.0,2.0,1990,1.0,0,0,1010,980,1941,776000.0
4.0,1.0,1080,1.5,0,0,1080,0,1924,425000.0
4.0,1.0,1870,1.5,0,0,1090,780,1928,230000.0
3.0,1.75,1670,1.0,0,0,1370,300,1958,418000.0
4.0,2.5,2800,2.0,0,0,2800,0,2001,440000.0
5.0,2.75,3460,2.0,0,0,3460,0,2011,858450.0
3.0,2.0,1930,1.0,0,0,1930,0,1969,390000.0
4.0,3.0,2370,2.0,0,0,1750,620,1969,957000.0
3.0,1.0,1180,1.0,0,0,1180,0,1950,507000.0
2.0,1.0,1320,1.5,0,0,1320,0,1928,575000.0
3.0,1.75,1350,1.5,0,0,1350,0,1925,700000.0
2.0,1.5,1068,2.0,0,0,1068,0,1990,239950.0
3.0,1.0,1580,1.0,0,0,1040,540,1978,253000.0
4.0,1.0,1690,1.5,0,0,1690,0,1907,540000.0
3.0,4.0,5120,3.0,0,2,4490,630,2008,1550000.0
4.0,2.5,3960,2.0,0,0,3960,0,2000,805000.0
4.0,3.25,2420,1.5,0,0,1870,550,1911,920000.0
3.0,2.5,1910,2.0,0,0,1910,0,1988,496600.0
3.0,2.25,1440,1.0,0,0,1130,310,1983,246000.0
5.0,3.0,2320,1.0,0,0,1510,810,1963,350000.0
3.0,2.0,1670,1.5,0,0,1670,0,1931,585000.0
3.0,1.75,1390,1.0,0,0,1390,0,1966,450000.0
3.0,2.5,2620,2.0,0,0,2620,0,1992,746000.0
3.0,2.5,3040,2.0,0,0,3040,0,2004,598555.0
3.0,2.5,2990,1.0,1,4,1560,1430,1976,820000.0
3.0,2.25,1740,1.0,0,0,1210,530,1998,266500.0
2.0,1.0,2360,1.0,0,2,1180,1180,1947,370000.0
3.0,2.75,2240,2.5,0,0,1650,590,1901,625000.0
4.0,2.0,1610,1.0,0,0,1610,0,1979,243500.0
2.0,1.0,700,1.0,0,0,700,0,1945,340000.0
5.0,3.0,2730,1.0,0,0,1670,1060,2014,559950.0
3.0,2.75,1780,1.0,0,0,1080,700,1980,315000.0
3.0,2.5,3070,2.0,0,0,3070,0,2003,753000.0
3.0,3.0,2060,2.0,0,0,2060,0,1907,800000.0
3.0,2.25,1360,1.5,0,0,1360,0,1934,550000.0
3.0,2.0,1430,1.0,0,0,1430,0,1953,465000.0
3.0,2.25,1840,2.0,0,0,1840,0,2003,465000.0
4.0,2.25,2000,2.0,0,0,2000,0,1976,710000.0
3.0,2.5,1820,2.0,0,0,1820,0,1988,505000.0
3.0,1.75,2330,2.0,0,0,2330,0,1964,690000.0
2.0,2.0,1070,1.0,0,0,1070,0,1980,217500.0
2.0,1.0,930,1.0,0,0,930,0,1909,500000.0
2.0,2.0,1040,1.0,0,2,1040,0,1921,325000.0
4.0,2.25,1960,2.0,0,0,1960,0,1984,500000.0
3.0,3.25,2970,2.0,0,3,2040,930,1991,721500.0
3.0,1.5,2200,1.5,0,0,2200,0,1932,924000.0
6.0,4.5,3810,1.0,0,4,3810,0,1969,2005000.0
2.0,1.5,830,2.0,0,0,830,0,2009,345000.0
4.0,3.5,3920,2.0,0,0,3920,0,1999,825000.0
3.0,2.0,2870,1.0,0,0,1350,1520,1980,560000.0
3.0,2.0,2560,1.0,0,0,1330,1230,1987,599000.0
3.0,1.5,1350,1.0,0,0,1350,0,1941,211000.0
4.0,2.25,1240,1.0,0,0,910,330,1974,425000.0
4.0,2.75,3210,1.0,0,2,1810,1400,1976,750000.0
3.0,2.5,1690,2.0,0,0,1690,0,2003,479000.0
4.0,2.5,2550,2.0,0,0,2550,0,1992,612500.0
5.0,1.75,3240,2.0,0,0,2690,550,1963,605000.0
4.0,2.5,3560,2.0,0,0,3560,0,2001,1364000.0
3.0,2.5,2160,1.0,0,0,2160,0,2007,389900.0
4.0,2.5,3060,2.0,0,0,3060,0,2006,710000.0
3.0,2.5,1690,2.0,0,0,1690,0,1992,295000.0
3.0,2.25,1520,2.0,0,0,1520,0,1992,275250.0
4.0,2.5,2040,2.0,0,0,2040,0,1994,250000.0
3.0,2.0,2360,1.0,0,0,2180,180,1951,709000.0
4.0,1.75,1360,1.5,0,0,1360,0,1928,399500.0
3.0,2.5,2000,2.0,0,0,2000,0,1992,225000.0
3.0,2.5,1650,2.0,0,0,1650,0,2001,500000.0
3.0,3.0,2500,2.0,0,0,2500,0,1997,364900.0
3.0,1.5,1140,1.0,0,0,1140,0,1976,356000.0
3.0,1.5,2140,1.5,0,0,2140,0,1978,616750.0
3.0,2.75,2870,2.0,0,2,2870,0,1984,755000.0
2.0,1.0,830,1.0,0,0,830,0,1950,327500.0
3.0,2.25,1960,2.0,0,0,1960,0,1984,605000.0
4.0,1.5,1130,1.0,0,0,1130,0,1968,179950.0
5.0,2.75,3630,2.0,0,0,3630,0,2000,633000.0
4.0,2.0,1764,1.0,0,0,1764,0,1942,349950.0
3.0,2.75,2770,1.0,0,0,1650,1120,1959,1080000.0
3.0,2.5,2650,2.0,0,0,2650,0,2002,425000.0
3.0,2.75,2500,2.0,0,0,2370,130,1979,990000.0
3.0,1.0,2710,2.0,0,3,2710,0,1950,410000.0
3.0,2.25,2490,2.0,0,0,2490,0,1975,590000.0
3.0,1.75,1500,1.0,0,0,1500,0,1979,242000.0
3.0,2.0,1160,1.0,0,0,580,580,1931,775000.0
4.0,1.5,1880,1.0,0,2,1440,440,1954,680000.0
3.0,2.5,1340,2.0,0,0,1340,0,2002,217000.0
3.0,2.5,1960,2.0,0,0,1960,0,1999,395000.0
3.0,2.25,2030,1.0,0,0,1500,530,1984,572500.0
5.0,3.0,2200,1.0,0,0,1440,760,1987,559900.0
3.0,2.0,2540,1.5,0,0,1840,700,1930,845000.0
3.0,2.0,1520,1.0,0,0,1520,0,1993,241000.0
3.0,2.25,2360,2.0,0,0,2080,280,1913,1325000.0
3.0,1.75,1340,1.5,0,0,1340,0,1919,475000.0
2.0,1.5,1400,2.0,0,0,1400,0,1940,575000.0
4.0,2.75,3030,1.0,0,0,1680,1350,1959,455000.0
3.0,2.5,3200,1.0,0,0,3200,0,2000,839000.0
4.0,1.5,1580,1.0,0,0,1030,550,1955,475000.0
2.0,1.0,2120,1.0,0,0,1060,1060,1923,600000.0
2.0,1.0,1640,1.0,0,0,1040,600,1937,515000.0
3.0,2.25,1890,1.0,0,0,1520,370,1977,425000.0
4.0,2.0,1710,1.5,0,0,1710,0,1907,565000.0
2.0,2.0,1140,1.0,0,0,1140,0,1924,498000.0
4.0,3.0,2720,2.0,0,0,1800,920,1919,739000.0
2.0,1.75,1650,1.0,0,0,950,700,1947,355000.0
3.0,1.75,1790,1.0,0,0,1330,460,1979,263000.0
4.0,1.75,1680,1.5,0,0,1680,0,1948,375000.0
3.0,1.75,2200,1.0,0,0,1250,950,1964,322000.0
2.0,1.0,830,1.0,0,0,830,0,1941,325000.0
2.0,1.0,770,1.0,0,0,770,0,1943,290000.0
4.0,2.5,3280,2.0,0,0,3280,0,2001,809950.0
3.0,3.25,2080,2.0,0,2,1220,860,1984,969500.0
4.0,2.5,2790,2.0,0,0,2790,0,1989,665000.0
5.0,3.5,4150,2.0,0,0,4150,0,2006,635000.0
3.0,2.25,1780,2.0,0,0,1780,0,1987,272450.0
4.0,1.75,1460,1.0,0,0,1460,0,1967,427000.0
3.0,1.0,1410,1.0,0,0,1410,0,1958,261500.0
4.0,2.25,2170,1.0,0,0,1300,870,1976,488800.0
2.0,1.0,690,1.0,0,0,690,0,1918,340000.0
4.0,3.0,3000,2.0,0,0,3000,0,2003,398950.0
3.0,1.0,870,1.0,0,0,870,0,1969,217000.0
4.0,2.5,3170,1.0,0,0,1910,1260,1978,799000.0
4.0,1.0,1540,1.0,0,0,770,770,1969,160000.0
3.0,1.0,1270,1.0,0,0,1270,0,1968,447000.0
3.0,1.75,2190,1.0,0,0,1480,710,1957,765000.0
4.0,3.5,4410,2.0,0,0,4410,0,1989,1320000.0
4.0,2.5,2790,2.0,0,0,2480,310,2004,445000.0
3.0,1.0,1510,1.0,0,0,1170,340,1953,310000.0
2.0,1.75,1800,1.0,0,3,990,810,1952,380000.0
4.0,1.0,2410,1.0,0,0,1510,900,1957,325000.0
4.0,2.75,2250,1.0,0,0,1480,770,1975,345000.0
3.0,1.0,950,1.5,0,0,950,0,1929,300000.0
4.0,1.75,2860,1.0,0,0,1710,1150,1978,530000.0
4.0,1.75,2860,1.0,0,0,1710,1150,1978,583500.0
2.0,1.0,1560,1.0,0,0,1130,430,1954,410000.0
2.0,1.5,1940,1.0,0,0,970,970,1937,535000.0
4.0,3.25,3580,1.5,1,4,3480,100,1915,2050000.0
4.0,2.5,2040,2.0,0,0,2040,0,1999,345000.0
5.0,1.0,1700,1.5,0,0,1700,0,1954,539000.0
4.0,2.5,3700,1.0,0,0,1920,1780,1973,590000.0
2.0,1.75,1050,1.0,0,0,1050,0,1974,187000.0
3.0,2.0,1690,1.0,0,0,1690,0,1969,270000.0
2.0,1.0,1120,1.0,0,0,1120,0,1939,546000.0
3.0,1.75,1490,2.0,0,0,1090,400,2008,520000.0
5.0,2.0,2220,1.5,0,0,1390,830,1925,515000.0
3.0,2.5,2160,1.5,0,0,1880,280,1939,990000.0
2.0,1.0,870,1.0,0,0,870,0,1937,382000.0
3.0,1.75,1900,1.0,0,0,1900,0,1956,1210000.0
4.0,3.5,3370,2.0,0,2,2470,900,2008,900000.0
3.0,2.75,3370,1.5,0,1,2310,1060,1910,675000.0
2.0,1.0,880,1.0,0,0,880,0,1909,460000.0
2.0,1.0,940,1.0,0,0,940,0,1952,234000.0
3.0,1.0,1340,1.0,0,0,1340,0,1974,399000.0
3.0,1.5,1440,1.0,0,0,1440,0,1959,253500.0
3.0,1.5,1750,1.0,0,0,1750,0,1952,475000.0
5.0,3.5,3990,2.0,0,0,2910,1080,2004,740000.0
3.0,2.5,2860,2.0,0,0,2860,0,2000,799000.0
4.0,2.5,1940,2.0,0,0,1940,0,2003,390000.0
2.0,1.5,1400,1.0,0,0,1400,0,1947,421000.0
3.0,2.5,1770,2.0,0,0,1770,0,1987,296500.0
4.0,2.0,1710,1.5,0,0,1710,0,1926,895000.0
4.0,2.5,2810,2.0,0,0,2810,0,2003,386000.0
3.0,1.0,1580,1.0,0,0,1580,0,1955,424000.0
3.0,1.0,1580,1.5,0,0,1580,0,1926,749000.0
3.0,1.0,1440,1.5,0,0,1440,0,1937,523000.0
4.0,2.5,2420,2.0,0,0,2420,0,1998,389000.0
4.0,1.5,1930,1.0,0,0,1930,0,1946,270000.0
3.0,1.0,1190,1.0,0,0,1190,0,1943,275000.0
4.0,2.5,2240,1.0,0,2,1310,930,1979,287500.0
2.0,2.5,2550,2.5,0,0,2550,0,1993,345000.0
2.0,1.0,920,1.0,0,0,920,0,1910,427000.0
4.0,1.75,1520,1.0,0,0,1000,520,1955,508450.0
3.0,2.0,1460,1.5,0,0,1460,0,1912,705000.0
1.0,1.5,1900,1.5,0,0,1450,450,1977,550000.0
3.0,1.5,1430,1.0,0,0,1430,0,1955,380000.0
3.0,2.5,2500,2.0,0,0,2500,0,2001,539900.0
2.0,1.0,720,1.0,0,0,720,0,1943,330000.0
2.0,1.0,1140,1.0,0,0,850,290,1947,455000.0
4.0,4.0,3530,2.0,0,0,3530,0,1992,510000.0
3.0,2.0,1220,1.0,0,0,1220,0,1970,315000.0
3.0,1.0,1320,1.0,0,0,1320,0,1967,206000.0
4.0,3.0,2170,1.0,0,0,1370,800,1968,592500.0
3.0,2.5,2020,2.0,0,0,2020,0,1981,744000.0
3.0,2.5,1990,2.0,0,0,1990,0,1989,334500.0
4.0,2.0,2660,1.5,0,0,1480,1180,1923,886000.0
4.0,2.5,2360,1.0,0,0,1780,580,1973,600000.0
3.0,2.0,2740,1.0,0,2,2740,0,1999,850000.0
3.0,1.75,1360,1.0,0,0,1000,360,1938,550000.0
2.0,1.0,1230,1.0,0,0,1230,0,1911,184900.0
3.0,1.5,1260,1.0,0,0,1260,0,1955,245000.0
2.0,1.0,1040,1.0,0,0,1040,0,1946,370000.0
4.0,2.5,2700,1.0,0,0,1670,1030,1978,480000.0
3.0,1.75,1800,2.0,0,0,1800,0,1906,579000.0
3.0,1.5,1590,1.0,0,0,1080,510,1964,339275.0
3.0,2.75,1360,1.0,0,2,1140,220,1955,425000.0
3.0,1.75,1370,1.0,0,0,1370,0,1959,170000.0
4.0,2.5,3320,2.0,0,0,3320,0,1995,950000.0
4.0,2.5,2980,1.0,0,0,1690,1290,1977,623000.0
3.0,2.5,1350,3.0,0,0,1350,0,2005,477000.0
3.0,1.0,1160,1.0,0,0,1160,0,1967,330000.0
3.0,2.25,1480,2.0,0,0,1480,0,1914,600000.0
3.0,2.0,1640,1.0,0,3,820,820,1924,570000.0
4.0,2.5,2680,2.0,0,0,2680,0,2004,515000.0
4.0,2.25,2440,1.0,0,0,1540,900,1952,805000.0
4.0,2.5,2920,2.0,0,0,2920,0,1997,555000.0
3.0,2.25,1780,2.0,0,0,1780,0,1985,245000.0
4.0,2.5,2170,1.0,0,0,1820,350,1978,638150.0
4.0,4.5,5550,2.0,0,0,3880,1670,2003,1650000.0
4.0,2.5,2060,1.0,0,0,1260,800,1968,269950.0
3.0,1.5,1050,1.0,0,0,1050,0,1969,195000.0
2.0,1.0,790,1.0,0,0,790,0,1944,159100.0
3.0,1.0,1010,1.0,0,0,1010,0,1942,550000.0
2.0,1.0,1040,1.0,0,0,1040,0,1950,299000.0
4.0,3.5,3130,2.0,0,0,2060,1070,2014,1375000.0
2.0,1.0,900,1.0,0,0,900,0,1951,249500.0
4.0,1.0,1470,1.5,0,0,1470,0,1918,700000.0
4.0,1.0,1080,1.5,0,0,1080,0,1900,275000.0
3.0,2.25,2440,1.0,0,0,1480,960,1962,565000.0
4.0,1.75,2520,1.0,0,0,1320,1200,1956,425000.0
4.0,1.75,1760,1.0,0,0,880,880,1946,620047.0
3.0,2.25,1820,1.0,0,0,1220,600,1977,480000.0
3.0,2.25,1820,1.0,0,0,1220,600,1977,515000.0
4.0,2.5,3040,2.0,0,0,3040,0,1999,420000.0
5.0,3.25,3490,1.0,0,0,1890,1600,1957,610000.0
4.0,1.5,2440,1.0,0,0,1440,1000,1950,849000.0
3.0,1.75,2280,2.0,0,0,2280,0,1949,718000.0
3.0,2.25,1980,1.0,0,0,1560,420,1974,295000.0
5.0,1.75,2360,1.0,0,0,1180,1180,1940,871000.0
3.0,3.75,3890,1.0,0,2,2390,1500,1943,430000.0
4.0,2.5,2300,1.0,0,0,1190,1110,1961,440000.0
2.0,1.0,910,1.0,0,0,910,0,1942,405000.0
3.0,2.0,1140,1.0,0,0,1140,0,1994,340000.0
4.0,2.5,2390,2.0,0,0,2390,0,2006,675000.0
3.0,1.0,1150,1.0,0,2,1150,0,1943,480000.0
5.0,2.0,2330,1.0,0,0,1270,1060,1961,362500.0
3.0,2.5,2420,2.0,0,0,2420,0,1987,752888.0
4.0,1.75,960,1.0,0,0,580,380,1949,255000.0
1.0,1.75,1010,1.0,0,0,1010,0,1968,283700.0
4.0,2.5,2370,2.0,0,0,2370,0,2001,335000.0
3.0,1.75,2880,1.0,0,0,1580,1300,1958,285000.0
4.0,2.25,2400,1.5,0,0,2400,0,1964,278000.0
5.0,2.5,3670,1.5,0,0,3670,0,1973,731000.0
3.0,1.5,1140,1.0,0,0,840,300,1985,335000.0
3.0,1.75,1410,1.0,0,0,1410,0,1980,334200.0
6.0,1.0,1530,1.5,0,0,1530,0,1921,642000.0
4.0,1.75,1720,1.5,0,0,1460,260,1925,540000.0
3.0,2.5,1620,1.0,0,2,1620,0,1960,299000.0
3.0,1.75,1570,1.0,0,0,970,600,1940,560000.0
5.0,2.75,1990,1.5,0,0,1990,0,1913,852000.0
2.0,1.0,930,1.0,0,2,930,0,1941,306000.0
3.0,1.75,1550,1.0,0,0,1210,340,1981,440000.0
4.0,1.0,1650,1.0,0,0,1650,0,1966,517000.0
2.0,1.0,800,1.0,0,2,800,0,1940,379000.0
2.0,1.0,930,1.0,0,0,930,0,1919,360000.0
4.0,1.5,2550,1.5,0,0,1760,790,1926,645000.0
2.0,1.0,720,1.0,0,0,720,0,1942,217000.0
2.0,1.0,620,1.0,0,0,620,0,1941,255000.0
3.0,2.5,2360,2.0,0,0,2360,0,1987,625000.0
3.0,1.75,1760,1.0,0,0,1460,300,1960,680000.0
3.0,1.75,2100,1.0,0,0,1080,1020,1957,440000.0
5.0,2.25,2480,2.0,0,0,2480,0,1978,615000.0
3.0,1.0,1040,2.0,0,0,1040,0,1942,239000.0
3.0,2.5,1656,1.0,0,0,1656,0,1985,462500.0
4.0,2.0,2090,1.5,0,0,1790,300,1927,619400.0
6.0,2.75,2520,2.0,1,4,2520,0,1954,975000.0
2.0,1.0,700,1.0,0,0,700,0,1943,330000.0
4.0,3.25,4030,2.0,0,0,4030,0,1988,985000.0
2.0,1.0,760,1.0,0,0,760,0,1946,430000.0
4.0,5.25,6500,2.0,0,0,5180,1320,2001,2458000.0
3.0,2.0,1840,2.0,0,0,1720,120,1946,778000.0
3.0,2.0,1090,1.0,0,0,1090,0,1990,219000.0
4.0,2.5,2980,1.5,1,4,1800,1180,1928,1595000.0
4.0,2.25,1900,1.0,0,0,1460,440,1966,715000.0
4.0,2.5,2790,2.0,0,0,2790,0,1964,950000.0
2.0,1.0,1280,1.0,0,2,1020,260,1951,425000.0
3.0,1.0,1510,1.0,0,0,1510,0,1962,239000.0
1.0,1.0,920,1.5,0,0,920,0,1944,310000.0
2.0,1.0,700,1.0,0,0,700,0,1927,400000.0
2.0,1.75,1980,2.0,0,1,1280,700,1977,428000.0
3.0,1.0,1440,1.5,0,0,1440,0,1929,600000.0
4.0,4.0,2740,2.0,0,0,2740,0,1990,415000.0
2.0,1.0,1400,1.0,0,0,1400,0,1949,401000.0
3.0,1.75,2270,1.0,0,0,1370,900,1948,292000.0
3.0,2.25,1310,1.0,0,0,1310,0,1950,291750.0
3.0,1.75,1680,1.0,0,0,1680,0,1968,227000.0
3.0,2.25,2260,1.0,0,0,2260,0,1977,675000.0
3.0,2.25,1350,2.0,0,0,1050,300,2007,397500.0
2.0,1.5,1820,2.0,0,0,1820,0,1921,206000.0
3.0,3.5,3380,3.0,0,0,2800,580,2008,1190000.0
4.0,1.75,2140,1.0,0,0,2140,0,1959,360000.0
4.0,2.5,2430,2.0,0,0,2430,0,2010,427500.0
2.0,1.0,940,1.0,0,0,940,0,1943,115000.0
3.0,1.5,2070,1.0,0,0,1140,930,1948,559000.0
4.0,1.0,1510,1.5,0,0,1510,0,1906,420000.0
4.0,1.75,2550,1.0,0,0,1890,660,1982,550000.0
2.0,1.0,700,1.0,0,0,700,0,1948,282150.0
3.0,1.0,1150,1.0,0,0,1150,0,1910,260000.0
3.0,2.5,2340,2.0,0,0,2340,0,2004,428000.0
3.0,3.25,1510,3.0,0,0,1510,0,2007,319950.0
3.0,2.0,2070,1.0,0,1,1590,480,1946,1350000.0
2.0,1.0,1150,1.0,0,0,1050,100,1924,552000.0
4.0,2.75,2190,1.5,0,0,1470,720,1929,637000.0
4.0,1.75,1980,1.0,0,0,1480,500,1978,213000.0
3.0,1.0,960,1.0,0,0,960,0,1958,215000.0
3.0,1.75,2180,1.0,0,2,1380,800,1949,590000.0
4.0,2.5,2560,2.0,0,0,2560,0,1989,390000.0
4.0,2.25,2270,1.0,0,2,1540,730,1959,287000.0
5.0,2.75,3550,2.0,0,0,3550,0,1960,580000.0
3.0,2.0,1330,1.0,0,0,1330,0,1988,424000.0
4.0,2.5,2110,2.0,0,0,2110,0,1988,610000.0
4.0,3.25,3470,1.0,0,3,2270,1200,1989,1320000.0
4.0,3.0,1550,1.0,0,0,860,690,1918,623500.0
2.0,1.0,570,1.0,0,1,570,0,1936,260000.0
3.0,2.5,2030,3.0,0,0,2030,0,2013,906000.0
3.0,2.0,1500,1.0,0,0,1500,0,1987,330000.0
2.0,1.0,920,1.0,0,0,920,0,1955,275000.0
3.0,1.0,1470,1.0,0,0,1040,430,1953,290000.0
2.0,1.0,1150,1.0,0,0,1150,0,1917,599950.0
4.0,3.0,4180,2.0,0,0,4180,0,1986,550000.0
3.0,1.75,1690,1.0,0,0,1690,0,1987,289000.0
4.0,2.75,2150,1.0,0,0,1240,910,1976,411000.0
3.0,3.25,2330,1.0,0,2,1730,600,1964,826000.0
4.0,2.0,2680,2.0,0,2,2350,330,1943,400000.0
3.0,2.5,1740,2.0,0,0,1320,420,2008,342000.0
2.0,1.75,1320,1.0,0,1,1080,240,1955,475000.0
4.0,3.5,3150,2.0,0,0,3150,0,2014,1205000.0
4.0,3.0,2480,1.0,0,0,2050,430,1913,455000.0
4.0,3.0,3330,1.0,0,0,1790,1540,1958,850000.0
3.0,1.0,1010,1.0,0,0,1010,0,1971,185000.0
6.0,3.25,4920,1.0,0,3,2730,2190,1960,850000.0
4.0,1.75,1570,1.0,0,0,1200,370,1960,239900.0
5.0,3.75,3580,2.0,0,0,3190,390,1999,765000.0
3.0,1.75,2220,1.0,0,0,2220,0,1967,437000.0
3.0,1.5,1010,1.0,0,0,1010,0,1969,240000.0
2.0,1.0,1440,1.0,0,0,860,580,1949,395000.0
3.0,1.0,1230,1.0,0,0,1230,0,1955,320000.0
3.0,1.75,1710,1.0,0,0,1280,430,1981,525000.0
3.0,3.0,2390,2.0,0,0,1680,710,1988,260000.0
3.0,2.75,2840,1.0,0,0,2200,640,1988,450000.0
4.0,2.5,2300,2.0,0,0,2300,0,1990,560000.0
5.0,3.0,2270,1.0,0,0,1360,910,1989,310000.0
3.0,2.5,2290,2.0,0,0,2290,0,1997,440000.0
4.0,1.0,1330,1.0,0,0,970,360,1957,458450.0
3.0,1.0,1200,1.5,0,0,1200,0,1918,200000.0
3.0,2.25,2160,2.0,0,0,1580,580,1987,430000.0
3.0,1.0,1120,1.0,0,0,1120,0,1966,360000.0
4.0,2.5,2090,1.0,0,0,1200,890,1962,311000.0
3.0,3.25,1470,3.0,0,0,1470,0,2003,615000.0
3.0,1.75,2270,2.0,0,0,2270,0,1979,575000.0
4.0,3.75,4100,1.5,0,3,2540,1560,1934,2027000.0
3.0,1.75,1440,1.0,0,0,720,720,1917,430000.0
3.0,1.5,1200,1.0,0,0,1200,0,1962,400000.0
3.0,1.75,1720,1.0,0,0,860,860,1957,340000.0
1.0,0.75,930,1.0,0,0,930,0,1924,351000.0
4.0,2.5,2400,2.0,0,0,2400,0,2002,440000.0
4.0,2.5,1960,2.0,0,0,1960,0,1999,298000.0
4.0,1.75,1890,1.0,0,0,1260,630,1964,300000.0
3.0,2.25,1590,2.0,0,0,1590,0,2001,310000.0
4.0,2.5,2590,2.0,0,0,2590,0,1993,500000.0
3.0,1.0,860,1.5,0,0,860,0,1927,399900.0
3.0,2.5,1270,2.0,0,0,1270,0,2004,343000.0
2.0,2.25,1130,2.0,0,0,1130,0,2010,415000.0
3.0,2.5,1860,2.0,0,0,1860,0,1997,410000.0
2.0,1.0,1802,1.0,0,0,1802,0,1961,320000.0
5.0,3.0,4480,2.5,0,0,3420,1060,1902,1990000.0
2.0,1.0,1310,1.0,0,0,940,370,1980,253000.0
3.0,2.5,2320,2.0,0,0,2320,0,1992,630000.0
2.0,1.0,1130,1.0,0,0,1130,0,1953,216000.0
3.0,2.5,2180,1.0,0,0,1230,950,1983,540000.0
3.0,1.5,1830,1.5,0,0,1830,0,1930,212000.0
3.0,2.75,2340,1.0,0,2,1470,870,1978,300000.0
3.0,2.5,2830,3.0,0,0,2830,0,2014,969950.0
3.0,1.0,1610,1.0,0,0,900,710,1956,715000.0
5.0,2.75,2410,2.0,0,2,2290,120,1968,1321620.0
4.0,2.75,2660,1.0,0,1,1930,730,1968,1444000.0
3.0,1.0,1030,1.0,0,0,1030,0,1924,305000.0
3.0,4.0,1390,2.0,0,0,1150,240,2006,458000.0
3.0,1.75,1580,1.0,0,0,1220,360,1942,275000.0
3.0,2.75,2330,2.0,0,3,1730,600,1930,550000.0
3.0,3.25,1540,3.0,0,0,1540,0,2011,742000.0
3.0,1.0,1570,2.0,0,0,1570,0,1908,700000.0
4.0,3.0,2940,1.0,0,0,1640,1300,1955,640000.0
3.0,0.75,1240,1.0,0,0,1240,0,1947,352000.0
3.0,1.0,1410,1.0,0,0,1050,360,1969,301500.0
4.0,2.5,2190,1.0,0,0,1410,780,1979,630000.0
3.0,2.5,3040,2.0,0,0,3040,0,1999,340000.0
4.0,1.75,1860,1.0,0,0,1080,780,1953,477500.0
3.0,2.5,1690,1.0,0,0,870,820,1997,285000.0
3.0,2.75,1900,1.0,0,0,1900,0,1958,255000.0
3.0,2.5,1600,2.0,0,0,1600,0,1993,315000.0
6.0,3.0,2530,1.0,0,0,2530,0,1978,830000.0
3.0,2.25,1860,3.0,0,0,1860,0,2014,539950.0
3.0,2.25,2390,2.0,0,0,2090,300,1941,980000.0
4.0,2.5,3100,2.0,0,0,3100,0,1990,735000.0
5.0,2.25,2650,1.0,0,1,1350,1300,1965,536000.0
3.0,2.0,1520,1.5,0,0,1140,380,1945,575000.0
2.0,1.0,1510,1.0,0,0,930,580,1924,500000.0
4.0,1.75,1960,1.0,0,0,1960,0,1967,285500.0
4.0,2.75,2270,1.0,0,0,1290,980,1973,498000.0
2.0,1.0,910,1.0,0,0,910,0,1939,412000.0
4.0,2.5,2100,1.0,0,0,1300,800,1975,607000.0
3.0,1.0,1000,1.0,0,0,1000,0,1991,199000.0
4.0,2.75,2760,1.0,0,0,1630,1130,1978,492500.0
4.0,2.5,2840,2.0,0,0,2840,0,2001,585000.0
3.0,2.5,1860,2.0,0,0,1860,0,2000,326995.0
4.0,2.25,1920,1.0,0,0,1920,0,1968,372500.0
2.0,0.75,840,1.0,1,4,840,0,1937,528000.0
3.0,1.5,2390,1.0,0,0,2390,0,1975,400000.0
4.0,2.5,2100,2.0,0,0,2100,0,1993,344000.0
4.0,3.0,2430,2.0,0,0,2430,0,2003,409950.0
3.0,2.0,1880,1.0,0,2,1280,600,1950,625000.0
3.0,1.75,1350,1.0,0,0,1350,0,1987,304950.0
2.0,2.0,2160,1.0,0,0,2160,0,1985,381500.0
3.0,1.75,1430,1.0,0,0,900,530,1946,215000.0
5.0,1.75,2840,2.0,0,2,2840,0,1925,345000.0
3.0,0.75,2510,2.0,0,0,2510,0,1961,363000.0
3.0,1.0,1690,1.5,0,0,1690,0,1913,240000.0
2.0,2.0,1930,1.0,0,0,1930,0,2005,548050.0
2.0,1.0,720,1.0,0,0,720,0,1941,314000.0
4.0,2.5,2990,2.0,0,0,2990,0,1990,800000.0
5.0,1.75,2300,2.0,0,0,2300,0,1905,400000.0
1.0,1.0,460,1.0,0,0,460,0,1937,247000.0
2.0,1.75,1240,1.0,0,0,890,350,1906,540000.0
4.0,2.5,1900,2.0,0,0,1900,0,1995,410000.0
3.0,1.75,2120,1.0,0,0,1260,860,1981,525000.0
4.0,2.5,2440,2.0,0,0,1700,740,1929,820000.0
4.0,2.25,3300,1.5,0,3,2820,480,1933,1250000.0
2.0,1.0,1180,1.0,0,0,1180,0,1955,244000.0
1.0,1.0,520,1.0,0,0,520,0,1930,275000.0
2.0,1.75,2070,1.0,0,0,1260,810,1946,577000.0
5.0,2.5,2250,1.0,0,0,1360,890,1977,446950.0
3.0,2.5,2050,2.0,0,2,2050,0,2004,457000.0
4.0,1.5,1310,1.5,0,0,1310,0,1926,320000.0
3.0,1.5,1250,1.0,0,0,1250,0,1969,210000.0
4.0,2.5,2130,1.0,0,0,1290,840,1978,220000.0
3.0,2.0,2250,1.0,0,0,1250,1000,1925,589000.0
4.0,2.0,1880,1.0,0,0,970,910,1904,435000.0
3.0,1.0,1520,1.0,0,0,1520,0,1953,375000.0
4.0,3.5,4010,2.0,0,0,4010,0,2007,1735000.0
2.0,1.75,1660,1.0,0,0,1660,0,2005,545000.0
3.0,2.25,3400,2.0,0,0,3400,0,1983,970000.0
2.0,1.75,2320,1.0,0,0,1380,940,1946,705000.0
5.0,3.25,3740,2.0,0,0,2540,1200,1984,915557.0
4.0,1.5,1810,1.5,0,0,1810,0,1960,259000.0
2.0,2.25,3170,2.0,0,2,1990,1180,1900,1695000.0
3.0,1.75,1680,1.0,0,0,1290,390,1969,427000.0
2.0,1.0,930,1.0,0,0,930,0,1911,390000.0
3.0,2.5,2390,2.0,0,0,2390,0,1995,363000.0
4.0,2.5,2680,1.5,0,3,1680,1000,1928,612000.0
4.0,1.75,1790,1.0,0,0,1790,0,1965,380000.0
4.0,3.0,1680,1.0,0,0,1150,530,1997,230000.0
3.0,1.75,1570,1.5,0,0,1570,0,1931,580000.0
3.0,1.0,2230,2.0,0,2,1630,600,1918,770000.0
4.0,2.0,1260,1.0,0,0,1260,0,1991,207200.0
3.0,2.0,1790,1.0,0,0,1190,600,1985,525000.0
3.0,2.5,2440,1.0,0,0,1520,920,1961,925000.0
4.0,2.25,2410,2.0,0,0,1650,760,1910,883000.0
4.0,2.5,1780,2.0,0,0,1780,0,2003,455000.0
3.0,2.5,1900,2.0,0,0,1900,0,2004,343500.0
2.0,1.0,960,1.0,0,0,960,0,1950,244000.0
3.0,1.75,1640,1.0,0,0,1640,0,1967,397000.0
2.0,1.0,850,1.0,0,0,850,0,1976,180500.0
3.0,2.75,2150,1.0,0,0,1900,250,1926,310000.0
4.0,2.5,2780,2.0,0,0,2780,0,2005,315000.0
3.0,1.0,1030,1.0,0,0,1030,0,1952,718000.0
3.0,1.75,1930,1.0,0,0,1330,600,1977,279950.0
3.0,2.5,2080,1.0,0,3,1700,380,1940,689000.0
4.0,2.5,3520,2.0,0,0,3520,0,1998,828000.0
2.0,1.0,890,1.0,0,0,890,0,1942,150000.0
3.0,1.75,1640,1.0,0,0,930,710,1926,505400.0
5.0,3.25,4860,2.0,0,2,3820,1040,1989,1680000.0
3.0,1.0,1040,1.0,0,0,1040,0,1959,217450.0
4.0,2.5,2820,2.0,0,0,2820,0,2004,677000.0
2.0,2.5,1320,1.0,0,0,1320,0,2004,361000.0
3.0,2.5,2590,2.0,0,0,2590,0,2004,620000.0
3.0,2.25,1540,1.0,0,0,1180,360,1989,176000.0
3.0,1.0,960,1.0,0,0,960,0,1969,330000.0
3.0,2.5,1190,1.0,0,0,1190,0,1986,290000.0
4.0,2.5,2770,2.0,0,0,2770,0,1988,711000.0
3.0,1.75,1060,2.0,0,0,1060,0,1983,295000.0
5.0,3.25,4010,2.0,0,0,4010,0,2003,1096500.0
3.0,2.0,1140,1.0,0,0,1140,0,1991,257500.0
4.0,1.0,1910,1.5,0,0,1910,0,1934,240000.0
4.0,2.5,2340,2.0,0,0,2340,0,1990,645000.0
2.0,1.75,1170,1.0,0,0,740,430,1903,499000.0
3.0,1.0,1290,1.5,0,0,1290,0,1961,321000.0
3.0,2.5,1810,3.0,0,0,1810,0,1998,449000.0
3.0,2.5,1820,1.0,0,0,910,910,1949,515000.0
4.0,1.5,2220,1.0,0,0,1270,950,1978,456000.0
3.0,3.75,3830,2.0,0,0,3830,0,1977,865000.0
4.0,2.5,2920,2.0,0,0,2920,0,2003,515500.0
4.0,2.5,2630,2.0,0,0,2630,0,2004,576925.0
3.0,1.75,1320,1.0,0,0,1320,0,1996,243000.0
3.0,2.0,1400,1.0,0,0,1400,0,1968,253400.0
3.0,2.5,1600,2.0,0,0,1600,0,2000,292000.0
3.0,2.5,1490,1.0,0,0,1090,400,1976,271500.0
2.0,2.5,2170,1.0,0,0,2170,0,2012,765000.0
3.0,3.25,1280,2.0,0,0,1090,190,2005,375000.0
3.0,2.0,1620,1.0,0,0,1620,0,1968,382880.0
3.0,2.5,2630,1.0,0,0,1580,1050,1967,852500.0
3.0,1.5,1240,1.0,0,0,1240,0,1959,475000.0
3.0,1.75,1300,1.0,0,0,820,480,1919,462000.0
3.0,1.75,2430,1.0,0,1,1230,1200,1949,762400.0
4.0,1.5,1890,1.0,0,0,1890,0,1967,330000.0
3.0,2.25,1890,1.0,0,0,1890,0,1978,473000.0
3.0,1.5,2440,1.0,0,0,2440,0,1949,550000.0
3.0,2.25,1780,1.0,0,2,1340,440,1972,449500.0
4.0,2.75,2830,2.0,0,0,2830,0,1998,744000.0
4.0,2.0,2490,1.0,0,0,1690,800,1952,700000.0
4.0,2.5,1560,1.5,0,0,1560,0,1965,511100.0
3.0,2.5,1980,2.0,0,0,1980,0,2012,317950.0
3.0,2.5,2070,2.0,0,0,2070,0,1988,542950.0
3.0,1.75,1490,1.0,0,0,1490,0,1975,490000.0
4.0,3.5,3090,2.0,0,0,2420,670,1992,760000.0
3.0,2.25,1580,1.0,0,0,1220,360,1961,475000.0
5.0,4.5,5190,2.0,0,2,3390,1800,1987,1702500.0
3.0,2.75,2692,2.0,0,0,2692,0,2007,435000.0
3.0,2.5,1740,2.0,0,0,1740,0,2000,399000.0
3.0,2.0,1940,1.0,0,0,1050,890,1927,627000.0
4.0,2.5,2150,1.5,0,0,1290,860,1991,346500.0
3.0,1.5,1320,1.0,0,0,1320,0,1957,412000.0
4.0,2.5,3360,2.0,0,0,3360,0,1994,845000.0
3.0,1.75,1850,1.0,0,0,1100,750,1959,373000.0
4.0,2.25,2880,2.0,0,0,2480,400,1965,725000.0
6.0,2.5,2420,1.0,0,2,1420,1000,1965,376000.0
3.0,1.0,2020,1.5,0,0,1520,500,1929,552500.0
5.0,2.0,2280,1.5,0,0,2280,0,1924,365000.0
4.0,2.5,3010,2.0,0,0,3010,0,1996,700000.0
4.0,2.25,2550,1.0,0,0,2550,0,1967,315000.0
4.0,2.0,1540,1.0,0,0,1540,0,1957,262500.0
3.0,2.25,2280,2.0,0,2,2280,0,1984,660000.0
4.0,2.5,2450,2.0,0,0,2450,0,2006,340000.0
5.0,2.5,2950,1.5,0,0,1720,1230,1918,660500.0
1.0,1.0,690,1.0,0,0,690,0,1928,280000.0
1.0,1.0,800,1.0,0,0,800,0,1919,267000.0
2.0,1.0,1470,1.5,0,0,1470,0,1932,230000.0
3.0,2.25,1840,2.0,0,0,1840,0,1993,417000.0
3.0,1.0,1170,1.0,0,0,1170,0,1968,252000.0
5.0,1.75,2344,1.5,0,0,1544,800,1921,791000.0
1.0,1.0,1230,1.0,0,0,830,400,1924,415000.0
3.0,1.75,1150,1.0,0,0,1150,0,1966,339000.0
3.0,1.0,1140,1.0,0,0,1140,0,1942,158000.0
3.0,1.0,1660,1.0,0,0,1260,400,1957,535000.0
3.0,1.0,1080,1.0,0,0,980,100,1919,818900.0
4.0,2.0,1720,1.0,0,0,1420,300,1950,550000.0
2.0,1.0,590,1.0,0,0,590,0,1953,240000.0
3.0,3.25,1290,2.0,0,2,1090,200,2008,590000.0
3.0,1.5,1480,1.0,0,0,1480,0,1967,369300.0
4.0,2.5,2600,1.0,0,0,1400,1200,1981,510000.0
3.0,2.5,2040,2.0,0,0,2040,0,1987,542500.0
3.0,1.0,970,1.0,0,0,970,0,1980,262500.0
6.0,3.0,2620,1.0,0,0,1760,860,1957,900000.0
4.0,3.5,4560,2.0,0,0,4170,390,1995,1100000.0
3.0,1.75,1750,1.0,0,0,1750,0,1951,368000.0
4.0,3.5,3620,2.5,0,0,3620,0,2003,825000.0
3.0,2.0,1660,1.0,0,0,1660,0,2002,343500.0
4.0,1.0,1360,1.0,0,0,1020,340,1944,273500.0
3.0,2.5,2044,2.0,0,0,2044,0,1996,1000000.0
5.0,3.0,2370,1.5,0,2,1340,1030,1926,770000.0
3.0,2.0,1170,1.5,0,0,1170,0,1925,400000.0
3.0,1.0,1660,1.0,0,0,1100,560,1963,225000.0
4.0,1.0,2020,1.0,0,0,2020,0,1955,345000.0
3.0,2.5,2530,2.0,0,0,2530,0,2001,450000.0
2.0,1.0,870,1.0,0,0,870,0,1948,334850.0
5.0,3.0,3670,1.0,0,1,1980,1690,1955,605000.0
5.0,3.5,3180,2.0,0,0,3180,0,1997,760000.0
2.0,1.5,1870,1.5,0,0,1350,520,1926,390000.0
3.0,2.5,1940,2.0,0,0,1940,0,2001,488000.0
3.0,3.25,4220,1.0,1,4,2460,1760,1958,3300000.0
5.0,4.5,4820,2.0,0,0,3950,870,1990,1063000.0
3.0,2.0,2400,2.0,0,0,1590,810,1975,608000.0
3.0,2.25,2930,2.0,0,2,1920,1010,2000,1385000.0
2.0,1.0,800,1.0,0,0,800,0,1904,299950.0
3.0,3.25,2200,2.0,0,2,1910,290,1943,818000.0
3.0,2.5,2400,1.0,0,0,2400,0,1990,355000.0
5.0,3.25,5570,2.0,0,0,3860,1710,1952,1855000.0
3.0,3.25,1980,3.0,0,0,1980,0,1987,660000.0
3.0,2.25,3530,1.0,1,3,1840,1690,1930,2367000.0
4.0,2.5,3430,2.0,0,0,3430,0,1984,1211000.0
3.0,2.5,1720,2.0,0,0,1720,0,1992,255950.0
3.0,1.5,1930,1.0,0,0,1500,430,1983,475000.0
4.0,1.75,2140,1.0,0,0,1140,1000,1960,362950.0
3.0,1.75,1110,1.0,0,0,1110,0,1966,452000.0
3.0,1.75,1970,1.0,0,0,1270,700,1964,315000.0
3.0,2.5,1630,2.0,0,0,1630,0,2003,330950.0
5.0,2.25,2520,2.0,0,0,2520,0,1978,535000.0
4.0,2.25,2270,1.5,0,0,1520,750,1940,479000.0
3.0,2.5,1212,3.0,0,0,1212,0,2004,340000.0
4.0,2.0,1890,1.0,0,0,1890,0,1966,312000.0
3.0,2.25,1370,2.0,0,0,1370,0,1993,305000.0
3.0,2.5,1770,2.0,0,0,1770,0,1996,270000.0
3.0,2.5,1710,2.0,0,0,1300,410,2003,529999.0
2.0,1.0,1190,1.0,0,0,1190,0,1946,587100.0
3.0,2.0,1690,1.0,0,0,1690,0,1984,459800.0
4.0,1.75,1680,1.0,0,0,1330,350,1966,451000.0
3.0,3.25,4340,2.0,0,3,3060,1280,1993,2475000.0
3.0,2.25,2040,2.0,0,2,2040,0,1983,525000.0
2.0,1.0,1110,1.0,0,0,1110,0,1951,250000.0
5.0,2.0,2040,2.0,0,0,2040,0,1908,475000.0
4.0,1.5,1920,1.0,0,0,1920,0,1962,235000.0
3.0,1.5,1330,1.0,0,0,1330,0,1967,230000.0
4.0,1.0,1630,1.5,0,0,1630,0,1921,581000.0
3.0,1.0,1520,1.0,0,0,1520,0,1956,415000.0
3.0,1.0,1520,1.0,0,0,1520,0,1956,522500.0
3.0,1.5,1340,1.0,0,0,1340,0,1967,383000.0
3.0,1.75,2500,1.0,0,0,1250,1250,1958,315000.0
3.0,2.0,1460,2.0,0,0,1460,0,1902,591000.0
4.0,2.25,3140,2.0,0,0,3140,0,1979,750000.0
3.0,1.75,2150,1.0,0,0,1200,950,1956,430000.0
4.0,2.5,3140,1.5,0,0,3140,0,1995,712000.0
3.0,2.5,2310,1.0,0,0,1340,970,1981,510000.0
2.0,1.0,710,1.0,0,0,710,0,1950,480000.0
3.0,1.0,1460,1.0,0,0,1260,200,1906,538000.0
2.0,2.75,730,1.0,0,0,730,0,1929,464000.0
3.0,2.5,1440,2.0,0,0,1440,0,2001,476000.0
3.0,2.0,1130,1.0,0,0,1130,0,1947,349500.0
3.0,2.25,1810,2.0,0,0,1810,0,1981,270000.0
3.0,2.5,2710,2.0,0,2,2000,710,1978,740000.0
4.0,2.5,2740,2.0,0,0,2740,0,1990,395000.0
3.0,2.5,1690,2.0,0,0,1690,0,2004,498000.0
3.0,2.5,1470,2.0,0,0,1470,0,1999,339900.0
3.0,2.5,2830,2.0,0,0,2830,0,2006,539000.0
3.0,1.0,1410,1.0,0,0,1140,270,1983,400000.0
3.0,2.5,2170,1.0,0,0,1410,760,1967,225000.0
3.0,2.25,1340,1.5,0,0,1170,170,1907,330000.0
3.0,3.0,2480,2.0,0,3,1730,750,1950,1387800.0
3.0,2.75,1990,1.0,0,0,1990,0,1986,490000.0
4.0,2.75,2240,1.0,0,0,1140,1100,1967,260000.0
4.0,2.5,2990,2.0,0,0,2990,0,1991,469900.0
6.0,1.75,2120,1.5,0,0,1220,900,1925,493000.0
4.0,2.25,2920,2.0,0,0,2920,0,1998,740000.0
4.0,1.75,1700,1.0,0,0,1700,0,1967,148900.0
2.0,2.5,1620,2.0,0,0,1620,0,1981,475000.0
2.0,1.0,760,1.0,0,0,760,0,1944,415000.0
3.0,1.0,1230,1.0,0,0,1230,0,1967,229500.0
5.0,3.75,4960,2.0,0,2,3760,1200,2001,1355000.0
4.0,2.5,2030,1.0,0,0,1330,700,1969,385000.0
3.0,2.25,1830,1.0,0,0,1250,580,1965,230000.0
2.0,1.0,970,1.0,0,0,770,200,1926,425000.0
2.0,1.0,1000,1.0,0,0,1000,0,1914,189900.0
2.0,1.0,750,1.0,0,0,750,0,1943,238000.0
4.0,2.5,2620,1.0,0,2,1570,1050,1950,968060.0
4.0,1.5,2220,1.0,0,0,1490,730,1954,921000.0
5.0,1.75,3000,1.0,0,0,1500,1500,1958,380000.0
1.0,1.0,1060,1.0,1,4,1060,0,1935,285000.0
4.0,2.5,1980,2.0,0,0,1980,0,1998,449000.0
4.0,1.0,1600,1.5,0,0,1600,0,1946,625000.0
4.0,2.25,2000,1.0,0,0,2000,0,1978,318989.0
3.0,1.5,1310,2.0,0,0,1120,190,2002,445000.0
3.0,1.0,1120,1.0,0,0,1120,0,1952,750000.0
3.0,2.5,3320,1.0,0,0,3320,0,1979,959000.0
3.0,2.5,2370,2.0,0,0,2370,0,1990,330000.0
2.0,1.5,830,2.0,0,0,830,0,2005,425000.0
3.0,1.0,940,1.0,0,0,940,0,1948,280000.0
4.0,2.5,2250,2.0,0,0,2250,0,1998,476500.0
3.0,2.25,2020,2.0,0,0,2020,0,1998,556000.0
4.0,5.25,5240,2.0,0,2,5240,0,2006,1862000.0
4.0,3.5,4083,2.0,0,0,4083,0,2005,637000.0
3.0,2.0,1450,1.0,0,0,1450,0,1969,405000.0
5.0,1.0,1170,1.0,0,0,800,370,1944,397000.0
4.0,2.75,3555,2.0,0,0,3555,0,2014,895990.0
3.0,2.0,1610,2.0,0,0,1610,0,1933,259000.0
2.0,1.0,960,1.0,0,0,960,0,1955,420000.0
3.0,2.5,1680,2.0,0,0,1380,300,2008,518000.0
3.0,1.75,1380,1.0,0,0,1380,0,1942,425000.0
2.0,1.0,1040,1.0,0,0,1040,0,1973,182500.0
3.0,1.5,1380,1.5,0,0,1380,0,1929,549900.0
3.0,1.75,1850,1.0,0,0,1280,570,1980,445000.0
2.0,1.75,1740,1.0,0,0,990,750,1946,452000.0
5.0,1.75,1920,1.0,0,0,1260,660,1951,715000.0
3.0,2.5,2010,2.0,0,0,2010,0,1989,559000.0
5.0,6.25,8020,2.0,0,0,8020,0,2001,3300000.0
4.0,1.75,1860,1.0,0,0,1090,770,1977,250000.0
5.0,4.0,4390,2.0,0,0,2930,1460,2008,1230000.0
4.0,2.25,2380,1.0,0,0,2380,0,1960,276500.0
4.0,2.5,2880,2.0,0,0,2880,0,1987,440000.0
6.0,2.25,2820,1.5,0,2,1970,850,1940,543200.0
1.0,1.0,750,1.0,0,0,750,0,1918,250000.0
4.0,2.5,1750,1.0,0,0,1410,340,1977,625000.0
3.0,1.0,1540,1.5,0,0,1200,340,1926,530100.0
2.0,1.75,1140,2.0,0,0,940,200,2014,549900.0
4.0,1.5,1560,1.0,0,0,1560,0,1962,430000.0
3.0,2.5,2960,2.0,0,0,2960,0,2009,835000.0
4.0,2.75,2140,1.0,0,0,1320,820,1968,409500.0
4.0,2.5,1600,1.0,0,0,830,770,1947,329000.0
4.0,2.75,2080,1.5,0,0,2080,0,1912,940000.0
3.0,2.0,1560,1.5,0,0,1560,0,1910,539950.0
4.0,2.5,2880,1.0,0,0,2140,740,1984,579950.0
5.0,3.0,2510,1.5,0,3,1590,920,1925,881000.0
3.0,1.0,960,1.5,0,0,960,0,1916,362500.0
2.0,1.0,1120,1.0,0,0,1120,0,1961,243950.0
4.0,2.75,3310,2.0,0,0,3310,0,2008,658000.0
3.0,1.5,1080,1.0,0,0,1080,0,1968,218250.0
4.0,2.5,2860,2.0,0,0,2860,0,1999,655000.0
3.0,2.0,1490,1.0,0,0,1490,0,1990,255000.0
3.0,1.0,1210,1.0,0,0,1210,0,1918,215000.0
3.0,1.75,2240,1.5,0,2,1910,330,1941,1265000.0
4.0,4.75,4575,2.5,0,2,3905,670,1926,2920000.0
3.0,2.5,1600,2.0,0,2,1600,0,1910,424305.0
4.0,1.75,2090,1.5,0,0,1250,840,1925,494000.0
4.0,2.5,2260,2.0,0,0,2260,0,2003,560000.0
3.0,1.0,1200,2.0,0,0,1200,0,1908,130000.0
4.0,2.5,2480,1.5,0,3,2480,0,1927,468000.0
5.0,3.0,2240,1.0,0,1,1390,850,1952,480000.0
3.0,1.75,1550,1.5,0,0,1550,0,1926,475000.0
4.0,1.75,2130,1.0,0,0,1330,800,1967,285000.0
5.0,3.0,2870,1.0,0,0,1950,920,1964,765000.0
2.0,1.0,1160,1.0,0,0,1160,0,1924,208000.0
3.0,2.5,2430,2.0,0,0,2430,0,2001,372000.0
2.0,1.0,900,1.0,0,0,900,0,1947,470000.0
5.0,2.75,2830,1.5,0,0,2830,0,1967,451000.0
4.0,1.75,1620,1.0,0,0,1620,0,1974,442200.0
4.0,2.5,2510,2.0,0,0,2510,0,1991,330000.0
3.0,1.75,1790,1.0,0,0,940,850,1949,335000.0
3.0,2.0,1640,1.0,0,0,1640,0,1995,280000.0
3.0,1.75,2240,1.0,0,0,1250,990,1950,625000.0
3.0,2.5,1870,2.0,0,0,1870,0,2003,345000.0
4.0,1.0,1500,1.0,0,0,1500,0,1964,255950.0
4.0,1.0,1490,1.5,0,0,1490,0,1918,570000.0
3.0,1.5,2230,2.0,0,0,2230,0,1960,685000.0
3.0,1.75,1710,1.0,0,0,1240,470,1974,273148.0
3.0,2.5,1620,2.0,0,0,1620,0,1989,246500.0
5.0,2.5,2250,1.0,0,0,1310,940,1983,349950.0
4.0,2.0,1700,1.0,0,0,850,850,1926,545000.0
3.0,2.5,1502,3.0,0,0,1502,0,2005,403000.0
4.0,2.5,1900,2.0,0,0,1900,0,2003,299950.0
3.0,2.5,3320,1.0,0,0,2600,720,1990,792000.0
5.0,2.5,1980,1.0,0,0,1080,900,1929,418000.0
4.0,1.0,1670,1.5,0,0,1670,0,1944,332500.0
3.0,2.5,2235,1.0,0,0,990,1245,1975,337000.0
2.0,1.0,1070,1.0,0,0,1070,0,1949,212000.0
2.0,2.25,1800,2.0,0,2,1800,0,1979,542000.0
4.0,2.5,2980,2.0,0,0,2980,0,2000,622500.0
3.0,1.75,1670,1.0,0,0,1340,330,1985,260000.0
3.0,1.75,2620,1.0,0,0,1320,1300,1977,525000.0
5.0,3.5,5470,2.0,0,0,4590,880,1976,975000.0
4.0,1.75,3080,1.0,0,0,1700,1380,1941,1140000.0
3.0,1.0,940,1.0,0,0,940,0,1964,500000.0
5.0,2.25,1870,1.0,0,0,1170,700,1961,554000.0
4.0,2.5,2070,2.0,0,0,2070,0,2004,343000.0
2.0,1.75,950,1.0,0,0,950,0,2009,515000.0
2.0,1.0,1290,1.0,0,0,890,400,1922,492000.0
4.0,3.0,2570,1.0,0,0,1370,1200,1984,655000.0
3.0,2.5,1600,2.0,0,0,1600,0,2000,290000.0
4.0,1.5,2550,2.0,0,0,2550,0,1910,952500.0
2.0,1.0,1010,1.0,0,0,1010,0,1941,235000.0
3.0,1.5,1720,1.0,0,0,1720,0,1955,323000.0
3.0,2.5,2200,2.0,0,0,1610,590,2008,1050000.0
,0.75,384,1.0,0,0,384,0,2003,265000.0
2.0,1.0,1400,1.5,0,0,1400,0,1941,200000.0
3.0,2.25,1830,1.0,0,0,1330,500,1968,419995.0
3.0,3.0,3110,1.0,0,4,1590,1520,1980,1500000.0
3.0,2.5,1600,2.0,0,0,1600,0,1987,455000.0
3.0,3.5,3600,2.0,0,0,3600,0,1996,660000.0
3.0,1.0,1390,1.0,0,0,1390,0,1968,319000.0
3.0,1.75,2092,1.0,0,0,2092,0,1981,390000.0
3.0,1.5,1200,1.0,0,0,1030,170,1952,718500.0
2.0,1.0,1090,1.0,0,0,840,250,1926,474000.0
4.0,2.0,2140,2.0,0,0,1840,300,1945,615750.0
3.0,2.5,2010,2.0,0,0,2010,0,1994,551000.0
3.0,2.25,1500,1.0,0,0,1150,350,1984,230000.0
4.0,2.5,3500,2.0,0,0,3500,0,2004,790000.0
3.0,2.5,2660,3.0,0,3,1870,790,2007,1230000.0
3.0,2.25,1440,2.0,0,0,1440,0,1995,325000.0
4.0,2.75,2780,2.0,0,0,2780,0,2001,705000.0
4.0,1.75,1580,2.0,0,0,1580,0,1979,259000.0
3.0,1.5,1250,1.0,0,0,1250,0,1959,306000.0
3.0,1.0,970,1.0,0,0,970,0,1928,315000.0
3.0,1.0,1100,1.0,0,0,1100,0,1952,392500.0
4.0,2.25,3240,2.0,0,0,2730,510,1968,1065000.0
2.0,2.5,1290,3.0,0,0,1290,0,1999,350500.0
4.0,3.5,3810,2.0,0,0,3810,0,1938,825000.0
4.0,1.0,1500,1.5,0,0,1500,0,1944,235000.0
3.0,2.0,2660,1.0,0,2,1530,1130,1976,650000.0
4.0,3.0,2400,1.0,0,0,1200,1200,1964,675000.0
4.0,1.0,1860,1.0,0,0,1860,0,1955,265000.0
2.0,1.0,1450,1.0,0,4,1450,0,1924,822500.0
3.0,2.75,2260,2.0,0,0,1540,720,1956,705000.0
6.0,4.75,5540,2.5,0,2,3950,1590,1909,2630000.0
2.0,1.5,1300,1.0,0,2,1300,0,1943,685000.0
4.0,2.0,1610,2.0,0,0,1610,0,1946,630000.0
4.0,3.25,3820,2.0,0,1,3310,510,1990,1250000.0
4.0,2.5,1820,1.0,0,0,1390,430,1976,359000.0
4.0,5.0,5820,2.0,0,0,3750,2070,1993,784500.0
3.0,2.0,2470,2.0,0,0,2470,0,1961,850000.0
3.0,2.5,3040,2.0,0,0,3040,0,2005,410000.0
4.0,1.75,1120,1.0,0,0,1120,0,1966,252000.0
5.0,1.75,1880,1.0,0,0,1880,0,1955,618000.0
3.0,1.0,1070,1.0,0,0,970,100,1947,265000.0
3.0,2.0,1560,1.0,0,0,790,770,1969,465000.0
2.0,1.0,870,1.0,0,0,870,0,1947,240000.0
3.0,1.0,1000,1.0,0,0,1000,0,1959,217000.0
4.0,2.25,2520,1.5,0,0,1510,1010,1909,415000.0
2.0,2.0,1700,1.0,0,0,950,750,1980,274000.0
5.0,3.0,2150,1.0,0,0,1370,780,2003,420000.0
4.0,2.75,1590,1.5,0,0,1590,0,1925,1062500.0
4.0,5.25,4670,2.0,0,0,4670,0,1989,1415000.0
3.0,2.0,1800,1.0,0,0,1080,720,1942,618500.0
3.0,1.5,1670,1.0,0,0,1670,0,1956,295000.0
3.0,2.0,1010,1.0,0,0,1010,0,1980,400000.0
3.0,2.5,2550,2.0,0,0,2550,0,2002,595000.0
4.0,3.0,3700,1.0,0,0,1850,1850,1976,1728000.0
3.0,1.75,1350,1.0,0,0,1350,0,1987,261000.0
5.0,2.5,1660,1.5,0,0,1660,0,1929,780000.0
3.0,1.5,1390,1.0,0,0,1090,300,1947,589000.0
3.0,1.75,1720,1.0,0,0,1140,580,1981,230000.0
4.0,3.5,2980,2.5,0,0,2490,490,2006,690000.0
4.0,2.25,2190,2.0,0,0,2190,0,1981,524000.0
2.0,2.5,1230,2.0,0,0,1060,170,2011,380000.0
3.0,1.0,1000,1.0,0,0,740,260,1945,357500.0
3.0,2.0,2500,1.0,0,0,2500,0,1994,330000.0
5.0,1.75,2240,1.0,0,0,1120,1120,1920,635000.0
9.0,3.0,2820,2.0,0,0,1880,940,1918,934000.0
2.0,1.75,1400,2.0,0,0,1110,290,2005,358500.0
3.0,1.5,1470,1.0,0,0,1470,0,1955,401000.0
3.0,2.0,1820,1.0,0,0,1820,0,1992,270000.0
4.0,2.0,2060,1.0,0,1,1370,690,1954,705000.0
3.0,2.0,1670,1.0,0,0,1100,570,1988,325000.0
3.0,1.0,1540,1.0,0,0,1540,0,1909,384950.0
3.0,1.0,1210,1.0,0,0,1210,0,1953,310000.0
4.0,2.5,3430,2.0,0,0,3430,0,1992,829950.0
3.0,2.5,2550,2.0,0,0,2550,0,2002,353000.0
2.0,1.0,1060,1.0,0,0,820,240,1981,170500.0
4.0,2.5,3670,2.0,0,0,3670,0,1999,885250.0
4.0,3.25,4420,2.0,1,4,3150,1270,2001,2700000.0
3.0,1.5,1550,1.0,0,0,1550,0,1957,245000.0
3.0,2.5,1190,3.0,0,0,1190,0,2008,469000.0
3.0,1.0,1300,1.5,0,0,1300,0,1927,455000.0
4.0,2.5,2430,2.0,0,0,2430,0,2002,305000.0
7.0,4.5,4290,1.5,0,0,4290,0,1982,840000.0
5.0,3.5,3500,2.0,0,0,2570,930,1996,905000.0
3.0,2.0,1680,1.5,0,0,1680,0,1968,219200.0
3.0,1.5,1250,1.0,0,0,1250,0,1965,455000.0
2.0,1.0,1020,1.0,0,0,1020,0,1940,195000.0
3.0,1.0,1510,2.0,0,0,1510,0,1902,799000.0
2.0,1.0,910,1.0,0,0,910,0,1948,285000.0
3.0,1.5,1320,1.0,0,0,1320,0,1979,300000.0
2.0,1.0,900,1.0,0,0,900,0,1918,83000.0
2.0,1.0,890,1.0,0,0,890,0,1928,220000.0
2.0,2.5,1240,2.0,0,0,1240,0,1986,174500.0
4.0,2.5,2960,2.0,0,0,2960,0,1987,695000.0
3.0,1.5,1020,1.0,0,0,1020,0,1959,255000.0
5.0,2.25,2590,1.0,0,0,1510,1080,1973,539000.0
2.0,1.0,1100,1.0,0,0,1100,0,1925,552700.0
3.0,1.0,1300,1.0,0,0,1300,0,1952,571500.0
3.0,1.0,1200,1.0,0,0,1200,0,1950,263700.0
8.0,4.0,7710,3.5,0,0,6090,1620,1904,3300000.0
2.0,2.0,1390,2.0,0,0,1390,0,1986,186950.0
3.0,1.75,1430,2.0,0,0,1430,0,1985,520000.0
3.0,1.5,1250,1.0,0,0,1250,0,1969,358000.0
2.0,0.75,840,1.0,0,0,840,0,1948,210000.0
5.0,3.75,5020,2.0,0,1,3970,1050,2007,3650000.0
4.0,2.25,2060,2.0,0,0,2060,0,1983,543000.0
4.0,2.25,2000,1.0,0,0,1350,650,1960,330000.0
3.0,2.0,1530,1.0,0,0,990,540,1907,529000.0
1.0,1.0,700,1.0,0,0,700,0,1907,295000.0
3.0,1.0,950,1.0,0,0,950,0,1962,365000.0
3.0,3.0,1380,3.0,0,0,1380,0,2005,473000.0
3.0,1.0,1830,1.0,0,0,1200,630,1960,403500.0
3.0,1.5,1790,1.5,0,1,1790,0,1910,544000.0
3.0,1.0,1340,1.5,0,0,1340,0,1927,621000.0
3.0,2.25,1520,2.0,0,0,1400,120,1908,672600.0
2.0,1.75,1370,1.0,0,0,1090,280,1950,689800.0
3.0,1.5,1470,1.0,0,0,1130,340,1918,613000.0
4.0,2.25,2500,2.0,0,0,2500,0,1987,808000.0
3.0,1.0,1060,1.0,0,0,1060,0,1956,301000.0
3.0,1.75,1210,1.0,0,0,1210,0,1987,340000.0
3.0,1.0,920,1.0,0,0,920,0,1963,206000.0
3.0,1.5,1340,1.0,0,0,1340,0,1960,550000.0
2.0,1.0,960,1.5,0,0,960,0,1912,325000.0
3.0,2.5,1630,2.0,0,0,1630,0,1986,475000.0
3.0,1.75,1840,1.0,0,0,1310,530,1976,432100.0
3.0,2.0,3085,1.0,0,0,1560,1525,1959,359000.0
3.0,1.0,920,1.0,0,0,780,140,1926,490000.0
4.0,1.75,2260,1.0,0,1,1130,1130,1947,648360.0
3.0,1.75,1730,1.0,0,3,1730,0,1918,340000.0
3.0,2.0,1610,1.0,0,0,1090,520,1955,545000.0
2.0,0.75,550,1.0,0,0,550,0,1952,115000.0
3.0,2.25,2400,1.0,0,0,1420,980,1968,705640.0
3.0,2.25,1960,2.0,0,0,1750,210,2003,300000.0
4.0,2.75,3190,1.0,0,3,1940,1250,1949,1650000.0
4.0,3.5,3160,2.0,0,4,2180,980,1999,1137500.0
3.0,1.75,1550,1.5,0,0,1550,0,1944,280000.0
4.0,1.75,1930,1.0,0,0,1280,650,1981,245000.0
4.0,1.0,1170,1.5,0,0,1170,0,1925,564000.0
3.0,1.75,2520,1.0,0,0,1460,1060,1954,849000.0
3.0,1.75,1220,1.0,0,0,1220,0,1964,698000.0
3.0,1.0,960,1.0,0,0,960,0,1971,319000.0
3.0,3.5,4110,1.0,0,1,2230,1880,2000,1450000.0
4.0,3.5,3310,2.0,0,0,2400,910,1992,695000.0
4.0,2.75,2220,1.0,0,0,1170,1050,1951,680000.0
4.0,2.25,2250,2.0,0,0,2250,0,1985,287500.0
3.0,3.25,1510,2.0,0,2,1230,280,2001,465000.0
3.0,1.0,1350,1.0,0,0,1350,0,1981,335000.0
4.0,1.75,2420,1.0,0,0,1880,540,1981,602000.0
3.0,2.5,2950,2.0,0,0,2950,0,2003,482000.0
5.0,1.0,1260,1.5,0,0,1260,0,1918,220000.0
4.0,2.0,1700,1.0,0,0,1700,0,1978,206000.0
4.0,3.0,3320,2.0,0,0,2120,1200,1954,1100000.0
3.0,2.5,1470,2.0,0,0,1470,0,2003,491150.0
4.0,2.75,2500,1.0,0,1,2120,380,1975,390000.0
4.0,2.5,2641,2.0,0,0,2641,0,1998,393000.0
4.0,2.0,2260,2.0,0,0,2260,0,1992,635000.0
2.0,1.0,1160,1.0,0,0,1160,0,1937,490000.0
4.0,3.5,3680,2.5,0,0,2670,1010,1930,770000.0
2.0,2.0,1615,1.5,0,0,1615,0,1906,665000.0
3.0,1.0,1250,1.0,0,0,1250,0,1965,287000.0
3.0,1.0,1230,1.0,0,0,1090,140,1924,410000.0
3.0,2.0,2510,1.0,0,0,1470,1040,1925,562000.0
2.0,2.0,1540,2.0,0,0,1540,0,1983,475000.0
3.0,3.25,1860,3.0,0,0,1860,0,2001,387500.0
5.0,2.0,2700,1.0,0,0,1540,1160,1962,580000.0
3.0,2.5,3290,2.0,0,0,3290,0,2000,930000.0
3.0,1.75,2700,1.0,0,0,2110,590,1948,625000.0
3.0,2.0,1570,1.0,0,0,1570,0,1999,325000.0
3.0,1.75,1950,1.0,0,0,1950,0,1960,235000.0
2.0,1.0,1380,1.0,0,0,880,500,1931,450000.0
4.0,2.75,2410,1.5,0,0,2070,340,1909,745000.0
4.0,2.0,1200,1.0,0,0,1200,0,1961,223000.0
4.0,1.75,1770,1.0,0,0,1350,420,1937,630000.0
3.0,2.5,1540,3.0,0,0,1470,70,2008,413450.0
5.0,2.75,2860,2.0,0,0,2860,0,2005,720000.0
3.0,1.5,1740,1.0,0,0,1740,0,1973,339000.0
4.0,3.5,2830,1.5,0,0,1840,990,1919,1115500.0
5.0,4.0,4280,2.0,0,0,2710,1570,1996,839000.0
4.0,3.25,3890,2.0,1,3,3030,860,1923,2950000.0
4.0,2.0,2340,1.0,0,0,1170,1170,1966,568000.0
3.0,2.0,1410,1.0,0,0,1410,0,1994,269000.0
2.0,2.0,1350,1.0,0,0,1350,0,1974,382000.0
2.0,2.25,1100,2.0,0,0,900,200,2009,574000.0
3.0,2.5,2070,2.0,0,0,2070,0,2002,405000.0
3.0,2.5,2360,1.0,0,0,1690,670,1987,572000.0
4.0,2.25,2760,2.0,0,0,2760,0,1976,675000.0
4.0,1.0,1220,1.5,0,0,1220,0,1944,165000.0
4.0,1.0,1220,1.5,0,0,1220,0,1944,260000.0
3.0,1.0,1220,1.0,0,0,1220,0,1953,196000.0
3.0,2.5,3020,2.0,0,0,3020,0,2003,515000.0
4.0,3.5,3470,2.0,0,3,2520,950,1979,810000.0
4.0,2.25,2380,2.0,0,0,2380,0,1977,365650.0
3.0,3.0,2260,2.0,0,0,1660,600,2002,651000.0
2.0,1.0,720,1.0,0,0,720,0,1943,240000.0
3.0,2.0,1730,1.0,0,0,1730,0,2004,299000.0
3.0,2.5,2660,2.0,0,0,1830,830,1988,768000.0
2.0,1.0,1030,1.0,0,0,1030,0,1924,397380.0
4.0,3.0,2890,1.0,0,0,1590,1300,1945,476000.0
3.0,1.0,890,1.0,0,0,890,0,1957,315000.0
3.0,2.25,1410,1.0,0,0,940,470,1980,240000.0
2.0,1.0,810,1.0,0,0,810,0,1941,325000.0
3.0,1.75,1370,2.0,0,0,1370,0,1990,160000.0
3.0,2.5,2260,2.0,0,0,2260,0,2007,435000.0
3.0,1.75,1430,1.0,0,0,1430,0,1967,427500.0
5.0,2.5,2510,1.0,0,0,1410,1100,1984,450000.0
3.0,1.5,1760,1.5,0,3,1290,470,1928,688000.0
4.0,1.0,1430,1.0,0,0,980,450,1947,285000.0
3.0,3.25,1510,3.0,0,0,1510,0,2006,530000.0
4.0,1.75,1320,1.0,0,0,1320,0,1928,195000.0
3.0,1.5,1180,1.0,0,0,1180,0,1959,250200.0
3.0,2.25,1560,1.0,0,0,1080,480,1977,1100000.0
3.0,2.5,2470,2.0,0,0,2470,0,1988,732500.0
3.0,2.25,2190,1.0,0,0,1390,800,1987,194250.0
4.0,2.0,1610,1.0,0,0,1190,420,1966,526000.0
4.0,2.75,2700,2.0,0,0,2700,0,1958,520000.0
3.0,1.75,1530,1.0,0,0,1120,410,1958,526000.0
5.0,4.0,7320,2.0,0,0,7320,0,1992,1135250.0
2.0,1.0,920,1.0,0,0,920,0,1950,202000.0
4.0,2.5,2990,2.0,0,0,2990,0,2000,645500.0
1.0,1.0,720,1.0,1,4,720,0,1905,570000.0
3.0,2.0,1750,1.5,0,0,1750,0,1936,325000.0
2.0,1.0,2410,2.0,0,0,1930,480,2007,725000.0
3.0,1.75,1240,1.0,0,0,1240,0,1987,192000.0
2.0,1.0,1010,1.0,0,0,1010,0,1960,560000.0
5.0,2.75,2770,1.0,0,0,1490,1280,1979,283450.0
4.0,1.75,2800,1.0,0,0,1400,1400,1924,863000.0
4.0,2.0,1400,2.0,0,0,1400,0,1986,815000.0
2.0,1.0,1020,1.0,0,0,1020,0,1942,245000.0
4.0,3.0,2860,1.0,0,0,2860,0,1953,1315000.0
4.0,3.5,4270,2.0,0,2,4270,0,1994,1156000.0
3.0,2.5,2270,2.0,0,0,2270,0,1999,480000.0
4.0,2.5,2560,2.0,0,0,2560,0,2001,600000.0
2.0,1.0,900,1.0,0,0,900,0,1956,329950.0
4.0,2.5,2010,2.0,0,0,2010,0,1986,299500.0
3.0,2.5,1690,1.0,0,0,1690,0,1941,460000.0
5.0,3.5,2310,2.0,0,0,1560,750,2000,515000.0
3.0,2.25,1520,3.0,0,0,1520,0,2004,405000.0
4.0,1.5,1220,1.5,0,0,1220,0,1927,483000.0
4.0,2.5,2170,2.0,0,0,2170,0,1992,377000.0
4.0,1.75,2790,1.0,0,2,1450,1340,1956,568000.0
2.0,1.75,1760,1.0,0,0,850,910,1926,355000.0
4.0,1.75,2100,1.5,0,0,1500,600,1911,640000.0
4.0,1.0,1430,1.0,0,0,1070,360,1947,270000.0
5.0,3.5,2450,2.0,0,0,2450,0,2005,559950.0
4.0,3.0,1820,1.0,0,0,1420,400,1969,515000.0
4.0,1.75,1850,1.0,0,0,1850,0,1954,352000.0
3.0,1.75,1870,1.0,0,0,1870,0,1958,595888.0
4.0,2.25,2580,2.0,0,0,2580,0,1977,588000.0
4.0,3.25,3680,1.0,0,3,1840,1840,1959,1050000.0
3.0,1.5,1750,2.0,0,0,1750,0,1983,260000.0
4.0,3.5,3890,2.0,0,0,2860,1030,2005,1600000.0
2.0,1.0,1000,1.0,0,0,1000,0,1952,380000.0
2.0,2.5,2210,1.0,0,0,2210,0,2003,802000.0
4.0,3.25,2850,2.5,0,0,2700,150,1905,1325000.0
4.0,2.75,2460,2.0,0,0,1640,820,1907,710000.0
3.0,2.5,2630,2.0,0,0,2630,0,2004,600000.0
3.0,1.0,1750,2.0,0,0,1750,0,1929,707900.0
2.0,1.0,1100,1.0,0,0,780,320,1982,179950.0
4.0,2.5,2620,2.0,0,0,2620,0,1990,683000.0
3.0,2.0,1200,1.0,0,0,1200,0,1995,222400.0
2.0,1.5,1920,1.0,0,0,960,960,1912,517000.0
3.0,2.75,1690,1.0,0,0,1180,510,1985,410000.0
3.0,1.75,1680,1.0,0,0,840,840,1952,480000.0
3.0,1.75,3440,1.5,0,0,3440,0,1974,430000.0
5.0,1.75,2190,1.0,0,0,1290,900,1979,439950.0
4.0,2.5,3270,2.0,0,0,3270,0,1998,797500.0
4.0,1.5,1280,1.5,0,0,1080,200,1920,379000.0
1.0,1.0,1310,1.5,0,0,1310,0,1918,575000.0
3.0,1.0,1660,1.0,0,0,1110,550,1962,247500.0
4.0,2.75,2700,2.0,0,0,2700,0,1984,385000.0
4.0,1.75,1940,1.0,0,0,970,970,1941,423000.0
3.0,1.75,1520,1.0,0,0,1170,350,1953,550000.0
4.0,1.0,1620,1.5,0,0,1620,0,1927,415000.0
3.0,2.25,2090,1.0,0,2,1280,810,1952,693000.0
2.0,1.0,1070,1.0,0,0,1070,0,1910,543000.0
5.0,1.75,2000,1.0,0,2,1200,800,1953,465000.0
3.0,2.5,1020,2.0,0,0,720,300,2004,280000.0
3.0,1.25,2400,3.0,0,2,2400,0,1992,1388000.0
6.0,3.0,2480,2.0,0,0,2480,0,1972,665000.0
3.0,1.75,1310,1.0,0,0,1310,0,1960,237950.0
4.0,2.75,2420,1.0,0,0,1220,1200,1962,440000.0
2.0,1.0,1890,1.0,0,0,1030,860,1928,618000.0
3.0,2.25,1860,1.5,0,0,1020,840,1920,572000.0
3.0,1.5,2500,1.5,0,2,1450,1050,1940,725000.0
3.0,1.0,1970,1.0,0,0,1970,0,1970,454000.0
4.0,1.0,1660,1.5,0,0,1180,480,1920,535000.0
3.0,2.5,1850,1.0,0,0,1500,350,1979,249000.0
4.0,2.75,1970,1.0,0,0,1970,0,1961,395000.0
3.0,2.0,1890,1.0,0,3,1890,0,1954,690000.0
3.0,1.5,1310,1.0,0,0,1170,140,1928,526500.0
4.0,1.5,1870,2.0,0,0,1870,0,1956,325000.0
3.0,3.0,1520,2.0,0,0,1520,0,1948,495000.0
5.0,3.0,3070,2.0,0,0,3070,0,2011,825000.0
3.0,1.5,1400,1.5,0,0,1400,0,1910,383000.0
3.0,1.75,1960,1.0,0,0,980,980,1954,320000.0
3.0,2.5,2680,1.0,0,0,1340,1340,1989,475000.0
3.0,2.5,2030,2.0,0,0,2030,0,1993,275000.0
2.0,2.25,2320,1.5,0,4,1920,400,1937,1150000.0
3.0,1.75,1760,1.0,0,0,1760,0,1959,455000.0
5.0,1.0,1870,1.0,0,0,1580,290,1962,262000.0
4.0,1.0,1280,1.0,0,0,940,340,1950,390000.0
3.0,2.25,1730,1.0,0,0,1730,0,1985,300000.0
3.0,1.75,2060,1.0,0,2,1140,920,1964,746300.0
3.0,1.5,1030,1.0,0,0,1030,0,1952,267000.0
3.0,2.5,1720,1.5,0,0,1720,0,1972,525000.0
3.0,1.75,1210,1.0,0,0,1210,0,1977,570000.0
4.0,2.25,2620,1.0,0,0,1550,1070,1964,360000.0
3.0,1.0,1860,1.0,0,0,1860,0,1947,1052000.0
3.0,2.5,2510,2.0,0,0,2510,0,2003,699950.0
4.0,2.5,2040,1.5,0,0,2040,0,1973,375000.0
4.0,1.75,2410,1.0,0,0,1220,1190,1924,625000.0
2.0,1.0,780,1.0,0,0,780,0,1928,464050.0
5.0,2.5,2210,1.0,0,0,1460,750,1976,470000.0
4.0,2.0,1590,1.0,0,0,1040,550,1967,330000.0
4.0,1.75,2230,1.0,0,0,2230,0,1967,537000.0
3.0,2.0,1560,1.0,0,0,910,650,1976,250000.0
4.0,2.5,2950,2.0,0,0,2950,0,1986,835000.0
4.0,1.0,1480,1.5,0,0,1480,0,1912,770000.0
4.0,2.0,2850,1.5,0,1,1730,1120,1910,650000.0
3.0,1.75,2390,1.0,0,0,1560,830,1953,335000.0
3.0,1.75,1740,1.0,0,0,1740,0,1965,350000.0
5.0,2.75,2060,1.0,0,0,1220,840,1978,415000.0
4.0,2.5,2680,2.0,0,0,2680,0,1977,788000.0
4.0,2.75,3150,1.5,0,0,2430,720,1915,640000.0
4.0,2.5,2440,2.0,0,0,2440,0,1993,388000.0
6.0,1.75,2230,1.0,0,0,1390,840,1969,360000.0
6.0,1.75,2230,1.0,0,0,1390,840,1969,692500.0
4.0,1.5,1600,1.5,0,0,1600,0,1946,425000.0
4.0,1.5,1600,1.5,0,0,1600,0,1946,645000.0
3.0,1.0,1580,1.5,0,0,1580,0,1948,340000.0
4.0,3.25,2840,1.0,0,0,2840,0,1984,713000.0
3.0,2.75,2550,2.0,0,0,2550,0,1994,430000.0
3.0,2.25,1700,1.0,0,0,1250,450,1974,280000.0
3.0,2.0,1470,1.5,0,0,1470,0,1986,215000.0
3.0,2.5,1680,2.0,0,0,1680,0,1984,306000.0
3.0,1.0,1110,1.0,0,0,1110,0,1979,299900.0
5.0,1.75,2120,1.0,0,0,1200,920,1959,534000.0
3.0,2.75,2380,2.0,0,4,1930,450,1939,1160000.0
3.0,2.5,2670,2.0,0,3,2000,670,1942,1165000.0
2.0,1.0,890,1.0,0,0,890,0,1935,199990.0
4.0,3.0,3140,1.0,0,0,2140,1000,1989,946000.0
4.0,1.0,1260,1.5,0,0,1260,0,1947,295000.0
2.0,1.0,920,1.0,0,0,920,0,1909,475000.0
5.0,3.5,2990,2.0,0,0,2450,540,1994,750000.0
4.0,2.5,3120,2.0,1,4,2590,530,1974,1225000.0
3.0,1.0,1010,1.0,0,0,1010,0,1975,183500.0
2.0,1.0,1010,1.0,0,2,1010,0,1924,450000.0
3.0,1.0,1020,1.5,0,0,1020,0,1961,180000.0
5.0,4.5,3540,2.0,0,0,2940,600,1926,707000.0
2.0,0.75,900,1.0,0,0,900,0,1939,230000.0
3.0,1.0,1100,1.0,0,0,1100,0,1966,192500.0
3.0,2.5,1990,2.0,0,0,1990,0,2005,309000.0
3.0,1.5,1980,1.0,0,0,1520,460,1949,759000.0
4.0,3.75,4040,2.0,0,0,4040,0,2002,1115000.0
5.0,1.75,1250,1.0,0,0,1250,0,1966,462000.0
4.0,1.5,1820,1.5,0,0,1820,0,1920,229000.0
2.0,2.25,1140,2.0,0,0,1010,130,1999,399950.0
5.0,2.0,1730,1.0,0,0,1730,0,1943,325000.0
2.0,2.25,1170,3.0,0,0,1170,0,2007,512000.0
5.0,2.75,2910,2.0,0,0,2910,0,2006,410000.0
2.0,1.0,970,1.0,0,0,970,0,1956,210000.0
4.0,2.25,2130,1.0,0,0,1600,530,1975,325000.0
3.0,2.5,2520,1.0,0,0,1630,890,1979,685000.0
2.0,2.0,1360,1.0,0,0,780,580,1944,488000.0
3.0,2.25,1620,1.0,0,0,1280,340,1998,247500.0
4.0,2.0,2120,1.0,0,0,1060,1060,1940,489000.0
4.0,1.75,2700,1.0,0,0,1450,1250,1953,725000.0
3.0,1.5,1370,1.5,0,0,1370,0,1958,199950.0
5.0,3.0,2520,2.0,0,1,2010,510,1973,670000.0
3.0,2.0,1540,1.0,0,0,1540,0,1967,275000.0
3.0,1.75,2610,2.0,0,2,2130,480,1924,1000000.0
3.0,2.0,1490,1.5,0,0,1490,0,1984,255000.0
3.0,1.75,2760,1.0,0,0,1380,1380,1960,465000.0
3.0,1.75,1260,1.0,0,0,1260,0,2012,259000.0
3.0,3.5,2630,2.0,0,2,2030,600,2008,695000.0
3.0,1.75,1800,1.0,0,0,1370,430,1976,505000.0
2.0,1.0,1130,1.0,0,0,1130,0,1927,631500.0
3.0,1.0,1180,1.5,0,0,1180,0,1926,630500.0
4.0,2.75,2800,2.0,0,0,2800,0,1992,999000.0
3.0,1.5,1830,1.0,0,0,1350,480,1910,740000.0
3.0,2.5,2220,1.5,0,0,1660,560,1931,650000.0
2.0,2.0,1870,1.0,0,0,1870,0,2004,554000.0
3.0,2.5,2580,1.5,0,0,2580,0,1946,400000.0
3.0,2.0,1660,1.0,0,0,1010,650,1961,529941.0
3.0,1.0,1330,1.5,0,0,1330,0,1903,310000.0
3.0,1.0,1330,1.5,0,0,1330,0,1903,389000.0
3.0,3.0,2630,2.0,0,0,2630,0,2006,731781.0
2.0,1.0,1100,1.0,0,0,1100,0,1946,502501.0
3.0,1.75,1810,1.0,0,0,1810,0,1968,443000.0
3.0,2.0,2060,1.0,0,0,1060,1000,1921,607000.0
3.0,3.5,4660,2.0,0,4,3040,1620,1909,2147500.0
4.0,2.5,2370,1.0,0,0,1660,710,1975,585000.0
3.0,2.5,2430,2.0,0,1,2430,0,1989,1027000.0
3.0,2.5,1880,2.0,0,0,1880,0,1993,315000.0
2.0,1.0,1150,1.0,0,0,1150,0,1958,180000.0
3.0,2.0,1350,1.0,0,0,1350,0,1989,322500.0
3.0,2.75,2180,1.0,0,0,1310,870,1981,568500.0
4.0,2.75,3370,1.0,0,3,1920,1450,1948,813000.0
5.0,2.25,3650,1.0,0,0,1850,1800,1976,1085000.0
4.0,2.0,2100,2.0,0,0,2100,0,1965,424000.0
2.0,1.0,670,1.0,0,0,670,0,1903,235000.0
3.0,3.5,2420,2.0,0,0,1820,600,1907,740000.0
1.0,1.0,760,1.0,0,0,760,0,1900,415000.0
3.0,2.75,2200,1.0,0,0,1100,1100,1982,432000.0
5.0,3.25,4410,2.0,0,2,3880,530,1990,1268890.0
3.0,1.75,1300,1.0,0,3,880,420,1961,676500.0
2.0,1.0,720,1.0,0,0,720,0,1943,419000.0
3.0,2.5,2180,2.0,0,0,2180,0,1998,650000.0
2.0,1.0,1130,1.0,0,0,1130,0,1954,239000.0
4.0,2.5,2230,2.0,0,0,1540,690,1935,900000.0
5.0,1.75,2100,1.0,0,0,1070,1030,1981,330000.0
3.0,1.75,2060,1.0,0,4,1100,960,1982,510000.0
4.0,2.5,3060,2.0,0,0,3060,0,2012,465000.0
3.0,2.75,2810,2.0,1,4,2810,0,1974,1700000.0
3.0,2.25,2550,1.0,0,4,2550,0,1989,490000.0
5.0,3.0,4290,2.0,0,0,4290,0,1985,2680000.0
3.0,2.25,3040,1.0,0,0,3040,0,2005,1000000.0
4.0,2.75,2530,2.0,0,0,2530,0,1997,469950.0
3.0,1.75,1300,1.5,0,0,1300,0,1925,536000.0
4.0,2.5,1790,1.0,0,0,1790,0,1966,244950.0
3.0,1.0,1530,1.0,0,0,890,640,1928,575000.0
5.0,2.75,2380,1.0,0,0,1300,1080,1984,361000.0
5.0,2.25,2400,1.0,0,0,1200,1200,1957,650000.0
2.0,1.0,1030,1.0,0,0,830,200,1951,230005.0
4.0,2.5,3250,1.0,0,2,3250,0,1973,293000.0
3.0,3.0,1970,1.0,0,0,1970,0,2010,445000.0
4.0,1.5,1940,1.0,0,0,1140,800,1954,280000.0
3.0,2.25,1850,1.0,0,0,1370,480,1985,520000.0
4.0,3.25,3900,2.0,0,0,3900,0,1991,780000.0
3.0,1.75,3160,1.0,0,0,2160,1000,1978,625000.0
3.0,1.75,1440,1.0,0,0,1440,0,1986,239950.0
3.0,1.5,2040,1.0,0,0,1340,700,1957,335000.0
3.0,2.5,2120,2.0,0,0,2120,0,1989,612000.0
2.0,1.0,830,1.0,0,0,830,0,1954,200000.0
3.0,1.75,3140,1.0,0,0,1670,1470,1985,345000.0
4.0,2.5,2410,1.0,0,0,1550,860,1974,520000.0
4.0,2.25,2190,2.0,0,0,1800,390,1918,855000.0
4.0,1.75,2190,1.0,0,0,1190,1000,1950,567500.0
3.0,1.5,1210,1.0,0,0,1210,0,1967,208000.0
3.0,1.75,1880,1.0,0,0,880,1000,1922,452000.0
3.0,3.0,2410,2.0,0,0,2410,0,1988,555000.0
5.0,2.75,2620,1.0,0,0,1350,1270,1979,519000.0
3.0,2.25,1850,2.0,0,0,1850,0,2013,474950.0
3.0,2.25,1760,1.0,0,0,1190,570,1990,419000.0
2.0,1.0,860,1.0,0,0,860,0,1909,390000.0
7.0,2.25,2620,2.0,0,0,2620,0,1961,539000.0
4.0,1.75,2400,1.0,0,0,1590,810,1956,569000.0
3.0,1.0,1850,1.5,0,0,1850,0,1922,611000.0
3.0,2.5,4040,2.0,0,0,4040,0,2004,760000.0
3.0,2.0,1940,1.0,0,0,1940,0,1954,732000.0
3.0,2.5,3490,2.0,1,4,2150,1340,1939,1675000.0
5.0,2.75,3170,2.0,0,0,3170,0,2014,919950.0
4.0,2.5,2530,1.0,0,0,1440,1090,1978,400000.0
4.0,2.5,3230,2.0,0,0,3230,0,1993,785000.0
3.0,2.25,2120,2.0,0,0,2120,0,1964,835000.0
2.0,1.75,1640,1.0,0,0,1340,300,1939,640500.0
4.0,2.5,2130,2.0,0,0,2130,0,1988,310000.0
4.0,1.0,1440,1.5,0,0,1440,0,1969,355000.0
3.0,1.75,1940,1.0,0,1,1440,500,1960,685000.0
3.0,1.0,1120,1.0,0,0,1120,0,1943,202500.0
3.0,2.5,2400,2.0,0,0,2400,0,1998,540000.0
4.0,2.5,1810,2.0,0,0,1810,0,1999,295000.0
3.0,1.0,1270,1.5,0,3,1270,0,1927,518000.0
2.0,1.75,1350,1.0,0,0,1350,0,2005,250000.0
2.0,2.0,1550,1.5,0,0,1550,0,1972,330000.0
2.0,1.0,1620,1.0,0,0,920,700,1924,481000.0
3.0,2.25,2650,1.0,0,3,1770,880,1977,898000.0
5.0,1.75,2510,1.5,0,0,2510,0,1969,570000.0
4.0,2.5,2040,2.0,0,0,2040,0,1997,475000.0
3.0,2.5,1660,2.0,0,0,1660,0,1988,265000.0
3.0,2.5,1980,2.0,1,4,1580,400,1984,380000.0
4.0,2.5,2690,2.0,0,0,2690,0,1987,790000.0
2.0,2.25,2910,2.0,0,2,2910,0,1985,620000.0
4.0,3.5,2720,2.0,0,0,2670,50,1997,709050.0
3.0,1.0,1280,1.0,0,0,1280,0,1948,296500.0
3.0,2.5,2160,2.0,0,0,2160,0,1982,475000.0
3.0,2.25,1760,1.0,0,0,1290,470,1976,440000.0
2.0,1.0,800,1.0,0,0,800,0,1942,405000.0
2.0,1.0,930,1.0,0,0,730,200,1943,269500.0
5.0,1.75,2040,1.0,0,0,1020,1020,1961,520000.0
1.0,1.0,1180,1.0,0,2,1180,0,1948,229500.0
4.0,1.75,2000,1.0,0,0,1390,610,1961,335000.0
4.0,2.75,3310,2.0,0,0,3310,0,1998,680000.0
4.0,3.5,3130,2.0,0,0,2550,580,2008,1389000.0
4.0,2.5,2300,1.0,0,2,1600,700,1961,740000.0
3.0,2.25,2140,1.0,0,0,2140,0,1962,270000.0
4.0,2.0,2210,1.5,0,3,1760,450,1911,510000.0
2.0,1.0,970,1.0,0,0,970,0,1949,300000.0
5.0,2.25,2690,1.0,0,3,2020,670,1956,1298890.0
4.0,2.0,1890,1.5,0,0,1670,220,1940,675000.0
6.0,3.25,3140,2.0,0,0,3140,0,1991,925850.0
2.0,1.0,1440,1.0,0,0,1150,290,1965,255500.0
3.0,2.5,2910,2.0,0,0,2910,0,1989,450000.0
3.0,1.0,1310,1.0,0,0,1310,0,1968,280000.0
4.0,2.25,2140,2.0,0,0,2140,0,1963,245000.0
3.0,1.0,1090,1.0,0,0,1090,0,1972,344950.0
3.0,1.75,1330,1.0,0,0,1330,0,1969,381000.0
4.0,4.0,4690,2.0,0,0,3480,1210,2001,1945000.0
3.0,1.5,1910,1.0,0,0,1910,0,1955,1500000.0
3.0,1.75,1750,2.0,0,0,1750,0,1976,232603.0
5.0,2.5,1760,1.5,0,0,1760,0,1925,220000.0
4.0,1.75,1810,1.0,0,0,1390,420,1977,600000.0
3.0,2.5,1360,2.0,0,0,1360,0,1994,239000.0
3.0,1.75,1730,1.0,0,0,1730,0,1961,400000.0
6.0,2.75,4710,2.0,0,3,3690,1020,1931,2180000.0
3.0,1.0,1010,1.0,0,0,1010,0,1953,350000.0
3.0,2.5,2400,2.0,0,0,2400,0,1983,562000.0
3.0,1.5,1540,1.0,0,0,1540,0,1968,380000.0
4.0,1.75,1480,1.0,0,0,740,740,1927,511200.0
4.0,2.5,2520,2.0,0,0,2520,0,2004,680000.0
3.0,3.25,1210,2.0,0,0,1000,210,2002,350000.0
5.0,2.5,2670,1.0,0,0,1410,1260,1980,410000.0
4.0,2.5,3030,1.5,0,0,3030,0,1988,1050000.0
3.0,2.0,1440,1.0,0,0,1440,0,2002,391265.0
4.0,2.25,3250,2.0,0,0,3250,0,1979,1410000.0
3.0,2.0,1750,1.0,0,2,870,880,1956,575000.0
4.0,1.5,2120,2.0,0,0,2120,0,1974,316000.0
3.0,1.0,1050,1.5,0,0,1050,0,1919,165000.0
3.0,2.25,1950,1.5,0,0,1430,520,1911,850000.0
3.0,1.0,1020,1.0,0,0,1020,0,1900,210000.0
4.0,2.5,1820,1.0,0,0,1220,600,1975,325000.0
4.0,2.5,2390,2.0,0,0,2390,0,1989,682000.0
3.0,2.5,1400,2.0,0,0,1400,0,1987,430000.0
3.0,1.5,1540,1.0,0,0,1190,350,1959,325500.0
3.0,1.75,2370,1.0,0,3,1280,1090,1954,385000.0
1.0,1.0,670,1.0,0,0,670,0,1905,435000.0
4.0,1.0,2420,2.0,0,0,2420,0,1945,550000.0
3.0,1.0,1000,1.0,0,0,860,140,1930,400000.0
4.0,2.75,2100,1.0,0,0,1240,860,1978,503000.0
4.0,2.5,2800,2.0,0,0,2800,0,2003,676000.0
3.0,1.0,940,1.5,0,0,940,0,1959,180000.0
3.0,2.0,1640,1.5,0,0,1640,0,1910,234000.0
4.0,2.5,2760,1.5,0,0,1680,1080,1928,734200.0
3.0,3.25,3660,2.0,0,0,3660,0,2003,920000.0
4.0,2.5,3070,1.0,0,3,2070,1000,1950,1920000.0
3.0,1.75,1100,1.0,0,0,1100,0,1969,224000.0
3.0,2.75,3130,1.0,1,4,1690,1440,1947,1400000.0
3.0,1.0,1320,1.0,0,0,1320,0,1961,185000.0
3.0,1.75,1470,1.5,0,0,1470,0,1900,554600.0
3.0,1.75,1480,1.0,0,0,980,500,1980,268000.0
4.0,2.25,2260,1.0,0,0,1530,730,1976,675000.0
4.0,2.25,2210,1.0,0,0,1710,500,1967,620000.0
3.0,1.75,1540,1.0,0,0,1540,0,1967,396450.0
5.0,1.75,1910,1.0,0,0,1390,520,1955,565000.0
3.0,1.75,1760,1.0,0,0,1160,600,1966,410000.0
4.0,3.0,2240,1.5,0,0,1270,970,1914,1190000.0
3.0,2.25,2110,1.0,0,0,2110,0,1984,716125.0
2.0,1.0,1396,1.0,0,0,1396,0,1940,225000.0
4.0,2.75,3040,2.0,0,3,2320,720,1986,640000.0
2.0,1.0,1140,1.0,0,1,980,160,1920,374000.0
4.0,2.0,1780,1.0,0,0,1160,620,1950,415000.0
4.0,2.5,3370,1.0,0,0,1770,1600,1993,592500.0
3.0,2.5,1484,3.0,0,0,1484,0,2003,365000.0
4.0,2.5,2230,1.0,0,0,1180,1050,1981,600000.0
4.0,2.5,2820,2.0,0,0,2820,0,1989,465000.0
3.0,1.0,1580,1.0,0,0,1000,580,1976,254999.0
4.0,2.5,2040,2.0,0,0,2040,0,1994,279000.0
3.0,2.5,2720,2.0,0,0,2720,0,2001,460000.0
4.0,2.25,1490,2.0,0,0,1020,470,2005,507000.0
3.0,1.75,1560,1.0,0,0,1560,0,1964,291000.0
2.0,1.5,830,2.0,0,0,830,0,2006,350000.0
3.0,1.0,980,2.0,0,0,980,0,1969,90000.0
3.0,1.75,1980,1.0,0,0,1360,620,1977,329000.0
4.0,2.5,3680,2.0,0,0,3680,0,1986,909000.0
2.0,1.0,860,1.0,0,0,860,0,1953,187000.0
3.0,1.75,1850,1.0,0,0,1020,830,1909,580000.0
3.0,2.5,1620,2.0,0,0,1620,0,2001,345000.0
4.0,2.5,2240,2.0,0,0,2240,0,1995,497000.0
3.0,1.0,1010,1.5,0,0,1010,0,1904,345000.0
3.0,1.75,1610,1.0,0,0,1610,0,1974,313500.0
3.0,2.5,2720,2.0,0,0,2720,0,1990,910000.0
3.0,1.5,2080,1.0,0,0,1190,890,1959,399950.0
4.0,2.0,1930,1.0,0,0,1030,900,1967,268000.0
4.0,1.75,2250,1.0,0,0,1450,800,1954,559000.0
3.0,2.25,1980,1.0,0,0,1300,680,1963,309000.0
3.0,2.5,1960,2.0,0,0,1960,0,2006,410000.0
3.0,1.0,1320,1.0,0,0,1320,0,1957,259000.0
5.0,2.0,2940,2.0,0,0,2340,600,1909,950000.0
4.0,1.0,1460,1.5,0,0,1460,0,1955,320000.0
4.0,2.5,2330,1.0,0,1,1490,840,1951,1150000.0
3.0,2.0,2620,1.0,0,3,2620,0,1982,394250.0
1.0,1.0,700,1.0,0,0,700,0,1910,315000.0
2.0,2.0,1140,1.0,0,0,1140,0,1943,480000.0
3.0,2.5,2750,2.0,0,0,2750,0,1994,556000.0
3.0,2.5,2480,2.0,0,0,2480,0,2002,450000.0
3.0,1.5,1130,1.0,0,0,940,190,1946,420000.0
6.0,3.75,2770,1.0,0,0,1870,900,1969,890000.0
4.0,2.0,1710,1.0,0,0,1030,680,1975,295000.0
4.0,2.25,2150,2.0,0,0,2150,0,1976,410000.0
3.0,2.5,2250,2.0,0,0,2250,0,1994,308900.0
4.0,2.5,2960,1.0,0,3,1480,1480,1949,1161000.0
2.0,2.5,2300,1.0,0,0,2300,0,2006,665000.0
3.0,1.75,1740,1.0,0,0,970,770,1953,577000.0
3.0,2.5,2830,3.0,0,0,2830,0,2014,959000.0
2.0,1.75,1240,1.0,0,0,1240,0,1924,471000.0
3.0,2.5,2180,2.0,0,0,2180,0,1990,560000.0
5.0,2.25,2510,2.0,0,0,2510,0,1972,955000.0
7.0,5.5,6630,2.0,0,0,4930,1700,2004,1240000.0
3.0,2.5,2300,1.0,0,0,1800,500,1961,579000.0
4.0,2.25,3220,2.0,0,0,3220,0,1978,335000.0
3.0,2.5,2270,2.0,0,2,2270,0,2004,485000.0
3.0,2.5,1840,1.0,0,0,1840,0,1978,552000.0
4.0,3.25,3820,2.0,0,0,3820,0,2003,950000.0
3.0,2.0,1660,1.0,0,0,1130,530,1983,203700.0
4.0,3.5,3360,2.0,0,0,2450,910,1990,412000.0
3.0,2.0,1350,1.0,0,0,1350,0,1986,237500.0
4.0,3.5,2970,2.0,0,2,2200,770,2001,866800.0
3.0,1.0,1000,1.0,0,0,860,140,1946,425000.0
3.0,2.0,1190,1.0,0,0,1190,0,1995,200000.0
3.0,1.75,1670,1.0,0,0,990,680,1957,280000.0
3.0,1.5,1200,2.0,0,0,1200,0,1966,140000.0
5.0,2.5,2250,1.0,0,0,1280,970,1973,370000.0
2.0,0.75,1040,1.0,0,0,930,110,1909,550000.0
2.0,2.5,3180,2.0,0,4,2610,570,1985,1411600.0
2.0,2.5,3180,2.0,0,4,2610,570,1985,1505000.0
4.0,1.5,2040,1.0,0,0,1020,1020,1961,510000.0
3.0,1.0,1160,1.0,0,0,1160,0,1960,351000.0
3.0,1.0,880,1.0,0,0,880,0,1942,210000.0
4.0,1.75,2290,1.5,0,2,1690,600,1938,449999.0
3.0,1.0,950,1.0,0,0,950,0,1954,137000.0
3.0,1.0,1010,1.0,0,0,1010,0,1974,270000.0
3.0,2.5,3100,1.0,0,0,1820,1280,1981,540000.0
5.0,3.0,2560,1.0,0,0,1590,970,2012,565000.0
4.0,1.5,2430,2.5,0,0,2430,0,1980,940000.0
2.0,1.0,830,1.0,1,3,830,0,1928,385000.0
3.0,3.0,2090,1.0,0,0,1450,640,2001,400000.0
3.0,2.0,2030,1.0,0,0,2030,0,1998,365000.0
2.0,1.0,1060,2.0,0,0,1060,0,1979,353250.0
2.0,1.5,1090,1.0,0,0,950,140,1942,455000.0
4.0,3.5,3400,2.0,0,0,2500,900,1991,475000.0
4.0,1.75,1920,1.0,0,0,960,960,1939,571500.0
2.0,1.0,1150,1.0,0,0,780,370,1915,441000.0
6.0,2.75,3970,1.0,0,0,2180,1790,1970,810000.0
3.0,2.25,1880,2.0,0,0,1880,0,1987,550000.0
2.0,1.0,1500,1.0,0,0,1100,400,1933,736000.0
3.0,1.75,2190,1.0,0,0,2190,0,1989,375000.0
3.0,2.5,2530,2.0,0,0,2530,0,1995,717500.0
2.0,1.75,1930,1.0,0,2,1430,500,1951,581000.0
3.0,2.0,1510,2.0,0,0,1510,0,1909,629000.0
3.0,4.25,5510,2.0,0,4,4910,600,1997,3800000.0
3.0,2.0,1100,1.0,0,0,1100,0,1969,225000.0
3.0,2.5,1730,2.0,0,0,1730,0,1993,315000.0
3.0,2.5,1480,3.0,0,0,1480,0,2005,425000.0
3.0,1.0,1150,1.0,0,0,1150,0,1932,346500.0
3.0,2.25,1950,1.0,0,0,1570,380,1965,550000.0
3.0,1.75,2380,1.0,0,0,1400,980,1977,565000.0
4.0,2.0,3100,1.5,0,0,2040,1060,1939,1001000.0
2.0,2.0,2010,1.5,0,0,1450,560,1922,400000.0
4.0,2.0,2270,2.0,0,0,2270,0,1909,724950.0
3.0,1.75,2050,1.0,0,0,2050,0,1973,623000.0
2.0,1.0,650,1.0,0,0,650,0,1950,295000.0
4.0,3.25,2780,2.0,0,0,2780,0,2006,700000.0
2.0,1.5,1300,2.0,0,0,1160,140,2000,482000.0
3.0,2.5,2730,2.0,0,0,2730,0,1995,770000.0
4.0,2.5,3140,1.0,0,0,1820,1320,1960,310000.0
4.0,2.25,2410,2.0,0,0,2410,0,1965,720000.0
3.0,1.0,1180,1.5,0,0,1180,0,1928,355000.0
4.0,2.5,2600,2.0,0,0,2600,0,2005,512000.0
2.0,1.5,1400,3.0,0,0,1400,0,1999,303000.0
5.0,2.5,2220,1.0,0,0,1110,1110,1968,299000.0
3.0,2.5,1660,2.0,0,0,1660,0,2003,285000.0
3.0,1.75,2330,1.0,0,0,1590,740,1968,680000.0
4.0,1.75,1440,1.0,0,0,720,720,1954,285000.0
4.0,2.25,2920,1.0,0,0,1690,1230,1977,707000.0
3.0,2.0,1760,1.0,0,0,980,780,1942,690000.0
4.0,2.25,2860,2.0,0,0,2860,0,1983,872000.0
4.0,1.75,2090,1.0,0,0,1360,730,1967,290000.0
4.0,1.75,1910,1.0,0,0,1110,800,1981,425000.0
3.0,2.75,3280,1.0,0,2,2040,1240,1979,925000.0
3.0,1.0,1770,1.0,0,0,1770,0,1957,340500.0
2.0,1.0,920,1.0,0,0,920,0,1910,365000.0
3.0,1.75,1690,1.0,0,0,1690,0,1959,725000.0
3.0,3.0,2470,2.0,0,0,1860,610,1977,811000.0
3.0,1.0,1040,1.0,0,0,1040,0,1969,299000.0
4.0,2.0,1220,1.0,0,0,1220,0,1953,287500.0
4.0,2.25,3500,1.0,0,4,1830,1670,1938,879950.0
2.0,1.0,760,1.0,0,0,760,0,1950,135900.0
4.0,2.25,3070,1.0,0,3,1870,1200,1976,1225000.0
4.0,1.75,2100,1.0,0,0,1300,800,1947,522500.0
4.0,1.5,1660,1.0,0,0,1660,0,1947,399500.0
3.0,1.0,1430,1.5,0,0,1430,0,1917,450000.0
4.0,1.0,1620,1.0,0,0,1620,0,1962,218000.0
3.0,2.0,1490,1.0,0,0,1490,0,1995,289999.0
2.0,1.0,1170,1.0,0,0,1170,0,1903,540000.0
3.0,1.0,1240,1.0,0,0,1240,0,1976,324950.0
3.0,2.0,2910,2.0,0,0,1920,990,1900,718500.0
3.0,2.0,2660,1.0,0,0,2660,0,1964,495000.0
6.0,2.0,2220,1.0,0,0,2220,0,1977,260000.0
4.0,1.5,1920,1.0,0,0,1070,850,1954,430000.0
3.0,3.25,2780,2.0,0,0,2780,0,2009,402500.0
4.0,3.0,3110,2.5,0,3,2510,600,1931,1415000.0
3.0,2.25,1820,1.0,0,0,1450,370,1987,275000.0
3.0,2.25,1765,2.0,0,0,1765,0,1996,250000.0
3.0,2.75,1800,1.0,0,0,1320,480,1966,665000.0
3.0,2.5,2650,1.0,0,0,2650,0,1967,425000.0
2.0,1.0,1410,1.5,0,0,1310,100,1925,760000.0
3.0,2.5,1650,2.0,0,0,1650,0,2003,447000.0
3.0,1.0,1180,1.0,0,0,1180,0,1967,205000.0
3.0,1.5,800,1.0,0,0,800,0,1959,191000.0
2.0,1.75,1430,1.0,0,0,1430,0,1983,350000.0
5.0,3.5,3300,2.0,0,0,2410,890,2001,789888.0
2.0,1.0,1220,1.0,0,0,980,240,1948,443000.0
4.0,3.5,3530,2.0,0,0,2660,870,2000,695000.0
4.0,2.0,1380,1.5,0,0,1380,0,1906,560000.0
3.0,1.75,1410,1.0,0,0,810,600,1923,550000.0
2.0,2.5,3360,2.0,0,0,3360,0,2004,850000.0
4.0,2.75,2270,1.0,0,0,1360,910,1977,352750.0
4.0,2.5,2890,2.0,0,0,2890,0,2001,550000.0
5.0,1.0,1750,1.5,0,0,1750,0,1903,774900.0
3.0,1.0,1010,1.0,0,0,1010,0,1944,250000.0
4.0,2.5,3780,2.0,0,0,3780,0,1997,962800.0
3.0,1.75,1880,1.0,0,0,1880,0,1968,299500.0
2.0,1.0,800,1.0,0,0,800,0,1943,250000.0
5.0,4.0,4720,2.0,0,0,3960,760,1975,745000.0
2.0,1.0,1060,1.5,0,0,1060,0,1968,279475.0
3.0,2.25,2530,2.0,0,0,2530,0,1987,450000.0
5.0,2.25,1980,1.0,0,0,1260,720,1962,307700.0
3.0,1.0,1650,1.0,0,0,1300,350,1953,665000.0
3.0,2.75,1890,2.0,0,0,1890,0,1999,375000.0
4.0,2.5,3360,2.0,0,0,3360,0,1990,420000.0
2.0,1.0,630,1.0,0,0,630,0,1930,148000.0
3.0,1.5,1980,2.0,0,0,1980,0,1919,707000.0
3.0,1.0,990,1.0,0,0,840,150,1924,399000.0
4.0,2.5,3420,2.0,0,0,3420,0,1989,570000.0
4.0,2.25,3440,2.0,0,0,3440,0,1988,853000.0
3.0,1.0,1300,1.0,0,0,1300,0,1943,400000.0
2.0,1.75,2040,1.5,1,3,2040,0,1919,615000.0
3.0,1.0,1250,1.0,0,0,1250,0,1955,463000.0
4.0,2.5,1960,1.0,0,1,1290,670,1958,600000.0
5.0,2.5,2720,1.0,0,0,1360,1360,1970,429000.0
4.0,4.25,3250,2.0,0,0,2360,890,1944,980000.0
6.0,3.75,3190,2.0,0,0,3190,0,2003,359500.0
4.0,2.5,2570,2.0,0,0,2570,0,1998,715000.0
3.0,1.75,1420,1.0,0,0,980,440,1980,240000.0
4.0,2.0,2120,1.0,0,0,1060,1060,1968,455000.0
3.0,2.5,2080,1.0,0,0,2080,0,2000,610000.0
3.0,2.75,2740,2.0,0,0,2740,0,2004,675000.0
3.0,1.75,1250,1.0,0,0,1250,0,1985,283500.0
2.0,1.0,2150,1.5,0,0,1260,890,1917,235000.0
4.0,2.5,3230,1.0,0,0,1870,1360,1977,827000.0
2.0,1.0,860,1.0,0,0,860,0,1949,353000.0
4.0,2.5,2810,2.0,0,0,2810,0,1993,747500.0
2.0,1.0,1040,1.0,0,0,1040,0,1914,341000.0
3.0,1.0,1160,1.0,0,0,1160,0,1950,182000.0
3.0,2.0,1470,2.0,0,0,1470,0,2003,250000.0
4.0,3.5,2350,2.0,0,3,1670,680,1994,655000.0
3.0,2.25,1660,1.0,0,0,1660,0,1961,405000.0
4.0,1.75,2020,1.0,0,0,1100,920,1975,390000.0
2.0,1.0,890,1.0,0,0,890,0,1947,275400.0
3.0,2.25,2430,2.0,0,0,1810,620,1989,791000.0
3.0,1.75,1460,1.0,0,0,1460,0,1979,424500.0
3.0,1.0,980,1.0,0,0,980,0,1950,430000.0
4.0,2.5,2580,2.0,0,2,2580,0,1992,865000.0
2.0,2.0,1250,1.0,0,0,1250,0,1962,163000.0
4.0,2.75,3140,1.0,0,2,1570,1570,1961,920000.0
5.0,3.25,2680,2.0,0,0,1870,810,1910,1028950.0
3.0,1.75,1810,1.0,0,0,1290,520,1983,325000.0
5.0,2.5,2090,2.0,0,0,2090,0,1998,315000.0
4.0,1.0,1120,1.0,0,0,1120,0,1971,227000.0
4.0,1.75,1790,1.5,0,0,1410,380,1900,179000.0
2.0,1.0,870,1.0,0,0,820,50,2004,276000.0
4.0,1.5,3160,1.5,0,0,1840,1320,1968,335000.0
3.0,2.0,2350,1.0,0,0,1600,750,1981,430000.0
3.0,2.5,1810,2.0,0,0,1810,0,2004,266490.0
4.0,2.75,3160,1.0,0,0,1580,1580,1962,655000.0
3.0,2.0,1660,1.0,0,0,1000,660,1939,635500.0
5.0,2.5,2500,1.0,0,0,1300,1200,1979,235000.0
3.0,2.5,2880,2.0,0,0,2880,0,1986,885000.0
3.0,1.0,1470,1.0,0,0,1470,0,1953,352500.0
3.0,2.5,1460,2.0,0,0,1460,0,1983,450000.0
5.0,6.0,5490,2.0,0,0,5490,0,2005,3635000.0
3.0,2.25,2480,1.0,0,4,1330,1150,1967,1050000.0
2.0,2.25,1140,3.0,0,0,1140,0,1999,476000.0
3.0,2.5,1830,2.0,0,0,1830,0,1990,375000.0
4.0,3.5,3110,2.0,0,0,3110,0,2014,600600.0
4.0,1.75,2630,1.0,0,2,1430,1200,1948,567000.0
4.0,1.75,2390,1.0,0,0,1470,920,1979,650000.0
5.0,2.0,1750,1.0,0,0,1750,0,1943,190000.0
4.0,3.5,4370,1.0,0,2,2580,1790,1978,858000.0
1.0,1.75,1020,1.0,0,0,770,250,1937,435500.0
3.0,2.0,2500,1.0,0,0,1770,730,1979,685000.0
3.0,2.0,1540,2.0,0,0,1540,0,1984,252000.0
4.0,2.25,2200,2.0,0,0,2200,0,1975,512500.0
3.0,2.5,1940,2.0,0,0,1940,0,1965,423800.0
3.0,2.25,1453,2.0,0,0,1453,0,1986,460000.0
3.0,2.75,1830,2.0,0,0,1830,0,1991,434000.0
3.0,1.0,2000,1.0,0,0,1000,1000,1948,244000.0
3.0,1.0,1400,1.5,0,0,1400,0,1953,348125.0
4.0,3.25,2400,2.0,0,0,2400,0,1982,585000.0
3.0,1.0,1390,1.0,0,0,1390,0,1960,230000.0
3.0,2.0,1680,1.0,0,0,1680,0,1967,450000.0
5.0,2.0,1820,1.0,0,0,910,910,1970,393000.0
2.0,1.0,1140,1.0,0,0,1140,0,1925,517000.0
3.0,1.0,1060,1.0,0,0,1060,0,1969,400000.0
2.0,1.75,3050,2.0,0,0,3050,0,1991,890000.0
3.0,1.0,970,1.0,0,0,970,0,1970,205950.0
3.0,1.0,1320,1.5,0,0,1320,0,1912,209000.0
4.0,1.75,1890,1.0,0,0,1110,780,1947,430000.0
4.0,1.75,2040,1.5,0,0,1260,780,1926,534000.0
4.0,3.0,2370,1.5,0,0,1650,720,1916,735000.0
3.0,2.25,2720,2.0,0,0,2720,0,1997,873000.0
4.0,2.25,1970,1.0,0,0,1390,580,1983,475000.0
3.0,1.75,2180,1.0,0,0,1090,1090,1961,325000.0
3.0,2.25,2990,2.0,0,0,2990,0,1994,500000.0
4.0,2.75,2180,1.0,0,0,1330,850,1987,279000.0
3.0,2.0,1440,1.0,0,0,1440,0,1988,350000.0
4.0,2.25,3180,2.0,0,0,3180,0,1978,660000.0
2.0,1.5,1643,1.0,0,1,1643,0,1954,324950.0
4.0,2.0,1530,1.0,0,0,1530,0,1955,500000.0
2.0,1.0,1310,1.0,0,0,850,460,1950,187300.0
5.0,3.5,2800,2.5,0,0,2800,0,1903,345600.0
3.0,1.5,1510,1.0,0,0,1510,0,1959,400000.0
5.0,3.0,2700,2.0,0,0,2700,0,2009,935000.0
4.0,1.75,2220,1.0,0,0,1140,1080,1963,374000.0
3.0,1.75,1440,2.0,0,0,1440,0,1977,328000.0
3.0,2.0,1300,1.0,0,0,1300,0,1981,257500.0
4.0,2.5,2230,2.0,0,0,1630,600,1906,1003000.0
2.0,1.75,1390,1.0,0,0,1390,0,1980,216500.0
3.0,2.25,2760,2.0,0,0,2760,0,1978,1185000.0
4.0,2.5,3200,2.0,0,0,3200,0,2007,360000.0
3.0,0.75,1240,1.0,0,0,1240,0,1968,699999.0
3.0,2.5,1960,2.0,0,0,1960,0,1978,535000.0
3.0,2.0,2190,1.0,0,0,2190,0,1994,464950.0
4.0,2.5,3540,2.0,0,0,3540,0,1996,925000.0
3.0,3.25,2640,2.0,0,0,1840,800,1912,930000.0
3.0,2.0,2660,1.5,0,3,1940,720,1910,727500.0
4.0,1.75,1670,1.0,0,0,1670,0,1976,325000.0
3.0,3.25,3080,2.0,0,0,2080,1000,1984,695000.0
4.0,2.75,2890,1.0,0,0,1560,1330,1973,585000.0
3.0,2.25,1800,1.0,0,2,1200,600,1963,319000.0
6.0,2.5,2000,1.5,0,0,1790,210,1960,265000.0
5.0,1.75,1940,1.5,0,0,1940,0,1953,359000.0
5.0,1.75,1940,1.5,0,0,1940,0,1953,390000.0
3.0,1.0,960,1.0,0,0,960,0,1969,374500.0
2.0,1.5,1750,2.0,0,0,1750,0,1964,661000.0
3.0,2.5,2320,2.0,0,0,1620,700,1907,900000.0
5.0,2.5,2380,1.0,0,0,1540,840,1957,600000.0
5.0,4.25,6490,2.0,0,3,3940,2550,1991,2000000.0
4.0,1.75,1620,1.5,0,0,1620,0,1916,512500.0
3.0,1.75,1770,1.0,0,0,1770,0,1968,229500.0
3.0,2.5,2320,2.0,0,0,2320,0,2003,589000.0
3.0,2.5,1330,3.0,0,0,1330,0,2014,539950.0
4.0,2.5,3420,2.0,0,0,3420,0,2002,640000.0
3.0,1.0,1270,1.0,0,0,970,300,1967,218250.0
4.0,3.5,2550,2.0,0,2,1880,670,1997,675000.0
5.0,2.0,1860,2.0,0,0,1860,0,1980,338000.0
3.0,1.0,1020,1.0,0,0,1020,0,1981,231750.0
1.0,1.0,720,1.0,0,0,720,0,1930,199900.0
4.0,3.5,4460,2.0,0,2,4460,0,2001,1059000.0
4.0,2.75,1830,1.0,0,0,1250,580,1979,263000.0
3.0,1.5,1520,1.0,0,0,1160,360,1990,279950.0
3.0,1.5,1080,1.5,0,0,1080,0,1920,395000.0
3.0,2.0,1900,1.0,0,0,1900,0,1991,252500.0
4.0,3.75,5300,2.0,0,0,5300,0,1989,1150000.0
3.0,1.0,1370,1.0,0,0,1370,0,1969,205000.0
5.0,2.5,2960,1.0,0,0,1640,1320,1965,654000.0
3.0,1.0,960,1.0,0,0,960,0,1933,200000.0
3.0,2.5,2190,2.0,0,0,2190,0,2004,700000.0
4.0,3.25,3990,2.0,0,0,3990,0,1989,2720000.0
2.0,1.75,1200,1.0,0,0,800,400,1956,306000.0
3.0,2.5,1780,2.0,0,0,1780,0,2010,270000.0
3.0,2.25,2630,2.0,0,0,2630,0,1988,340000.0
4.0,2.5,2300,1.0,0,0,2300,0,1955,450000.0
4.0,2.75,3210,1.0,0,0,1810,1400,1975,580000.0
4.0,1.75,2290,1.0,0,3,1290,1000,1959,435000.0
4.0,2.5,2780,2.0,0,0,2780,0,2003,690000.0
4.0,2.5,2650,2.0,0,0,2110,540,1988,720000.0
3.0,2.25,1840,1.0,0,0,1390,450,1980,403000.0
3.0,2.75,1560,1.0,0,0,1030,530,1972,440000.0
3.0,1.0,1200,1.0,0,0,1200,0,1961,178500.0
4.0,2.5,1900,1.0,0,0,1900,0,1968,270000.0
2.0,1.0,710,1.0,0,0,710,0,1943,129888.0
3.0,1.75,1360,1.0,0,0,1360,0,1987,260000.0
5.0,2.5,2990,2.0,0,0,2990,0,1990,339950.0
3.0,1.0,1640,2.0,0,0,1640,0,1975,250000.0
3.0,3.5,3650,1.0,0,0,2050,1600,2011,680000.0
10.0,3.0,2920,2.0,0,0,1860,1060,1913,660000.0
3.0,3.5,3680,2.0,0,2,3680,0,1999,1225000.0
3.0,2.0,1830,1.0,0,0,1830,0,1959,550000.0
5.0,2.75,2570,2.0,0,0,2570,0,1987,675000.0
3.0,3.25,2730,2.0,0,1,1900,830,1984,981000.0
3.0,1.0,1150,1.5,0,0,1150,0,1913,168000.0
4.0,3.0,4260,2.0,0,0,4260,0,1996,1000000.0
3.0,1.0,1260,1.0,0,0,1260,0,1970,320000.0
6.0,3.25,4440,1.0,0,1,2220,2220,1959,959000.0
4.0,1.0,2300,1.0,0,0,1270,1030,1959,372000.0
3.0,2.5,1920,2.0,0,0,1920,0,1993,391500.0
2.0,1.0,1080,1.5,0,0,1080,0,1944,390000.0
2.0,1.0,890,1.0,0,0,890,0,1947,302000.0
3.0,3.5,1650,2.0,0,0,1100,550,2012,495000.0
3.0,2.5,1820,3.0,0,2,1640,180,1998,504500.0
4.0,1.75,2320,1.5,0,0,2170,150,1918,555000.0
4.0,3.5,3260,2.0,0,0,2630,630,1937,1550000.0
3.0,1.5,1730,1.0,0,0,1250,480,1947,550000.0
4.0,2.5,3320,2.5,0,0,3320,0,1905,1800000.0
1.0,1.0,1660,1.0,0,0,830,830,1908,655000.0
3.0,2.5,3290,2.0,0,0,3290,0,1992,685000.0
4.0,2.0,2280,1.0,0,0,1220,1060,1954,721000.0
4.0,4.25,3650,1.5,0,0,2330,1320,1907,1518630.0
4.0,2.5,1620,2.0,0,0,1620,0,1980,365000.0
3.0,2.0,2020,1.0,0,0,1220,800,1957,458000.0
2.0,1.0,1150,1.0,0,0,1150,0,1959,280000.0
4.0,1.75,1940,1.0,0,0,1000,940,1911,628000.0
4.0,2.5,3440,2.0,0,0,3440,0,2001,781500.0
3.0,1.75,2000,1.0,0,0,1300,700,1968,295000.0
2.0,1.0,750,1.0,0,0,750,0,1947,435000.0
3.0,1.75,1420,1.0,0,0,1000,420,1979,300000.0
2.0,1.0,880,1.0,0,0,880,0,1906,208500.0
2.0,2.5,2680,1.0,0,0,2680,0,2006,930000.0
2.0,2.0,860,1.0,0,0,860,0,1906,316000.0
3.0,2.0,1310,1.0,0,0,1310,0,1990,249900.0
3.0,2.25,1780,2.0,0,0,1540,240,1989,675000.0
3.0,2.25,1440,2.0,0,0,1440,0,1985,447000.0
3.0,2.0,1510,1.5,0,0,1510,0,1905,675000.0
4.0,2.5,2100,3.0,0,0,1580,520,2008,546000.0
3.0,2.0,1310,3.0,0,0,1310,0,2003,310000.0
3.0,1.0,1280,1.0,0,0,880,400,1961,190000.0
3.0,1.5,1320,1.0,0,0,1320,0,1951,650000.0
3.0,2.5,1740,2.0,0,0,1130,610,1995,585000.0
4.0,2.5,2910,2.0,0,0,2910,0,2003,1430800.0
4.0,2.5,2500,1.0,0,0,2500,0,1983,565000.0
3.0,1.0,1100,1.5,0,0,1100,0,1926,174900.0
3.0,2.25,1381,3.0,0,0,1381,0,2007,360000.0
3.0,1.0,960,1.0,0,0,960,0,1953,234000.0
8.0,3.0,3840,1.0,0,0,2530,1310,1961,575000.0
3.0,2.5,2200,2.0,0,0,2200,0,2004,315000.0
3.0,1.0,1250,1.0,0,0,1250,0,1967,225000.0
3.0,1.5,2380,1.0,0,0,1850,530,1961,370000.0
3.0,1.0,1500,1.0,0,0,1000,500,1947,606000.0
3.0,2.0,1410,1.0,0,0,1410,0,1983,272500.0
3.0,1.75,1680,1.0,0,0,960,720,1992,475000.0
3.0,1.0,1500,1.0,0,0,1500,0,1968,270000.0
4.0,1.75,2710,1.0,0,0,1440,1270,1961,624000.0
3.0,1.75,1730,1.5,0,0,1730,0,1954,355000.0
3.0,1.0,960,1.0,0,0,960,0,1972,345000.0
4.0,2.5,2380,2.0,0,0,2380,0,1993,342000.0
3.0,1.75,1120,1.5,0,2,1120,0,1917,316000.0
4.0,2.5,2960,2.0,0,0,2960,0,1990,539950.0
3.0,2.0,1580,1.0,0,0,790,790,1944,221347.0
3.0,2.5,1870,2.0,0,0,1870,0,2000,330000.0
4.0,2.5,1810,1.0,0,0,1470,340,1977,279000.0
4.0,3.0,2550,1.5,0,0,1750,800,1900,850000.0
3.0,1.75,1910,1.0,0,0,1100,810,1952,746000.0
2.0,2.0,1200,1.0,0,0,600,600,1924,478000.0
4.0,2.75,2420,1.5,0,0,2420,0,1905,820000.0
3.0,3.5,3080,2.0,0,3,2530,550,1996,2160000.0
3.0,3.0,3850,2.0,0,1,3850,0,2000,820000.0
3.0,2.0,3000,2.0,0,2,2470,530,1942,887000.0
3.0,1.0,1360,1.0,0,0,1360,0,1953,159000.0
7.0,4.25,3670,2.0,0,1,2800,870,1964,824000.0
4.0,2.5,2270,2.0,0,0,2270,0,2014,812000.0
4.0,2.5,1750,2.0,0,0,1750,0,1975,242000.0
4.0,2.5,3550,2.0,0,0,3550,0,2007,625000.0
4.0,1.0,2370,1.5,0,0,1570,800,1948,399888.0
3.0,2.25,1670,2.0,0,0,1670,0,1990,289000.0
3.0,2.0,1860,1.0,0,0,1860,0,2002,400000.0
3.0,2.5,4460,2.0,0,0,4460,0,1992,1550000.0
2.0,1.0,1080,1.0,0,0,1080,0,1940,345000.0
2.0,1.0,1080,1.0,0,0,1080,0,1940,874950.0
3.0,2.75,2280,1.0,0,0,1280,1000,1917,875000.0
4.0,2.5,2540,2.0,0,0,2540,0,1996,628990.0
2.0,3.5,2560,1.0,0,0,1280,1280,1944,535000.0
4.0,2.75,2390,1.0,0,0,1430,960,1979,770126.0
4.0,2.5,2870,1.0,0,0,1870,1000,1968,710000.0
3.0,1.75,1510,1.0,0,2,860,650,1925,465000.0
3.0,1.75,2200,1.0,0,0,2200,0,1952,359000.0
2.0,0.75,720,1.0,0,0,720,0,1949,151000.0
3.0,2.5,2970,2.0,0,0,2970,0,1994,820000.0
3.0,1.5,960,1.0,0,0,960,0,1970,160000.0
4.0,1.75,1420,1.5,0,0,1420,0,1945,535000.0
3.0,2.25,1800,1.0,0,0,1300,500,1975,365000.0
4.0,2.5,3090,2.0,0,0,3090,0,2005,708000.0
3.0,1.0,1200,1.0,0,0,1200,0,1967,215000.0
4.0,3.5,4065,2.0,0,0,4065,0,1987,1950000.0
4.0,2.5,2570,2.0,0,0,2570,0,1958,390000.0
3.0,2.0,1530,1.0,0,0,1530,0,1937,570000.0
3.0,1.75,1500,1.0,0,0,1500,0,1977,383000.0
4.0,3.0,2490,2.0,0,0,2490,0,2005,370000.0
4.0,2.5,3040,2.0,0,0,3040,0,2000,454000.0
5.0,3.25,4140,1.0,0,4,2190,1950,1973,1400000.0
4.0,1.75,1690,1.0,0,0,1690,0,1977,371000.0
3.0,1.75,1430,1.0,0,0,1430,0,1959,530000.0
4.0,2.75,2490,1.0,0,0,1400,1090,1983,608000.0
3.0,1.75,1350,1.0,0,0,1350,0,1954,450000.0
4.0,2.5,3140,2.0,0,0,3140,0,1994,780000.0
4.0,2.5,2340,2.0,0,0,2340,0,1978,290000.0
3.0,1.75,1610,1.0,0,0,1100,510,1978,225000.0
4.0,2.5,3320,2.0,0,0,3320,0,1991,805000.0
3.0,2.5,2390,2.0,0,0,2390,0,1991,660000.0
3.0,1.75,1180,1.0,0,0,1180,0,1962,299000.0
2.0,2.25,1260,3.0,0,0,1260,0,2007,530000.0
3.0,2.5,1800,1.0,0,0,1350,450,1970,680000.0
4.0,1.75,1790,1.0,0,0,1790,0,1944,199900.0
3.0,1.75,1760,1.0,0,0,1060,700,1963,224000.0
3.0,1.75,1540,1.0,0,0,1440,100,1980,244000.0
4.0,1.75,1260,1.0,0,0,860,400,1918,485000.0
4.0,2.5,2240,2.0,0,0,2240,0,1994,330000.0
4.0,2.0,1630,1.5,0,0,1030,600,1915,509000.0
4.0,2.5,2350,2.0,0,0,2350,0,1989,440000.0
3.0,2.0,1350,1.0,0,0,1350,0,1998,244000.0
4.0,1.75,1320,1.0,0,0,870,450,1930,399700.0
4.0,2.5,1950,1.5,0,0,1250,700,1910,519000.0
4.0,1.0,2100,1.0,0,0,1050,1050,1959,211000.0
3.0,2.5,3480,1.0,0,0,1750,1730,1941,950000.0
3.0,2.5,1830,2.0,0,0,1830,0,1999,410000.0
4.0,2.0,2640,2.0,0,0,2040,600,1949,750000.0
3.0,1.0,900,1.0,0,0,900,0,1978,133400.0
3.0,2.0,1553,1.0,0,0,1553,0,1900,240000.0
3.0,2.5,1710,2.0,0,0,1570,140,2005,539000.0
4.0,3.0,3400,2.0,0,0,3400,0,1998,688000.0
3.0,1.5,1270,1.0,0,0,1270,0,1950,465000.0
3.0,1.75,2960,1.0,0,2,1480,1480,1952,936000.0
4.0,2.5,3040,2.0,0,0,3040,0,2003,620000.0
3.0,1.75,1430,1.0,0,0,1430,0,1962,429950.0
3.0,2.5,1520,2.0,0,0,1520,0,2004,296475.0
4.0,2.0,1820,1.0,0,0,1100,720,1962,330000.0
3.0,2.25,1800,1.0,0,0,1270,530,1979,445000.0
4.0,3.25,2720,2.0,0,1,2070,650,2014,846000.0
4.0,1.75,1980,1.0,0,1,1380,600,1960,725000.0
4.0,2.5,2550,2.0,0,0,2550,0,1989,369000.0
3.0,1.75,2210,1.0,0,0,1390,820,1958,625000.0
3.0,2.0,2120,2.0,0,0,2120,0,2003,535000.0
4.0,1.5,1570,1.0,0,0,1570,0,1911,229950.0
3.0,1.75,1310,1.0,0,0,1310,0,1974,229999.0
5.0,3.5,3150,2.0,0,0,2460,690,1911,850000.0
4.0,4.5,3870,2.0,0,0,2530,1340,2001,589900.0
2.0,1.0,1840,1.0,0,0,1160,680,1914,513000.0
3.0,1.0,1120,1.0,0,0,1120,0,1941,401000.0
3.0,2.5,1440,2.0,0,0,1440,0,2006,260000.0
4.0,2.75,2300,1.0,0,0,2300,0,1950,525000.0
3.0,3.5,2070,1.0,0,0,1370,700,1977,470000.0
4.0,1.5,1420,1.0,0,0,940,480,1962,205000.0
3.0,2.25,2010,1.0,0,0,1570,440,1979,620000.0
3.0,1.5,1200,1.0,0,0,1200,0,1979,229000.0
2.0,2.0,1150,1.0,0,0,860,290,1940,445000.0
2.0,1.0,1240,1.0,0,0,1240,0,1967,215000.0
2.0,2.5,1900,2.0,0,0,1900,0,2005,504975.0
4.0,2.25,2350,2.0,0,0,2350,0,1980,495000.0
3.0,1.0,1120,1.0,0,0,1120,0,1976,205000.0
1.0,1.0,1020,1.0,0,0,1020,0,1937,152275.0
4.0,2.25,1930,1.0,0,0,1930,0,1968,586000.0
2.0,2.5,2680,1.0,0,0,2680,0,2002,779950.0
4.0,1.75,2660,2.0,0,0,2660,0,1983,557000.0
4.0,2.25,2200,1.0,0,2,1220,980,1958,610000.0
3.0,1.5,1010,1.5,0,0,1010,0,1953,405000.0
4.0,2.25,2310,2.0,0,0,2310,0,1980,320000.0
3.0,1.0,920,1.0,0,0,920,0,1970,356000.0
5.0,3.0,3030,1.5,0,0,1930,1100,1913,794500.0
3.0,1.75,1590,1.0,0,0,1590,0,1988,349000.0
4.0,2.25,2740,2.0,0,0,2740,0,1991,549000.0
3.0,1.0,960,1.0,0,0,960,0,1962,193000.0
3.0,1.5,2240,2.0,0,1,1440,800,1977,700000.0
3.0,2.5,2400,2.0,0,0,2400,0,1998,523000.0
5.0,3.25,2860,1.0,0,0,1800,1060,1965,565000.0
4.0,2.5,2960,2.0,0,0,2960,0,2000,500000.0
4.0,3.25,3770,2.0,0,0,2710,1060,1925,1450000.0
6.0,3.5,3830,2.0,0,0,3830,0,1995,710000.0
4.0,2.0,2750,1.0,0,0,2750,0,2008,333000.0
3.0,1.75,2100,1.0,0,0,1300,800,1943,580000.0
4.0,1.75,1500,1.0,0,0,1200,300,1956,289950.0
2.0,1.0,710,1.0,0,1,710,0,1925,375000.0
2.0,3.0,2770,1.5,0,0,1910,860,1984,505000.0
3.0,1.75,2050,1.0,0,2,1050,1000,1939,324950.0
4.0,2.25,1960,2.0,0,0,1960,0,1965,490000.0
4.0,2.0,1770,2.0,0,0,1770,0,1911,630000.0
3.0,2.75,3290,2.0,0,0,3290,0,1993,595000.0
4.0,2.0,1990,1.0,0,0,1260,730,1956,872500.0
2.0,1.0,1760,1.0,0,2,1000,760,1951,490000.0
4.0,3.25,5080,2.0,0,0,5080,0,2001,1900000.0
2.0,1.0,1020,1.0,0,0,1020,0,1956,310000.0
3.0,1.0,1350,1.0,0,0,1200,150,1946,450000.0
3.0,1.5,1740,2.0,0,0,1740,0,1974,539000.0
3.0,2.5,3540,2.0,0,0,3540,0,1989,888550.0
3.0,2.5,1520,1.0,0,0,1080,440,1981,269950.0
,,290,1.0,0,0,290,0,1963,142000.0
3.0,1.75,1310,1.0,0,0,1310,0,1967,300000.0
2.0,3.25,3000,1.0,0,0,2410,590,1952,780000.0
3.0,2.5,2660,2.0,0,0,2660,0,1992,545000.0
3.0,2.25,2120,2.0,0,0,2120,0,1994,278000.0
3.0,2.25,1200,2.0,0,0,1200,0,1986,342000.0
4.0,1.75,1900,1.0,0,0,1900,0,1967,190000.0
2.0,1.5,1010,3.0,0,0,1010,0,1999,387000.0
3.0,2.25,1850,2.0,0,0,1850,0,1978,279950.0
6.0,4.5,4520,2.0,0,0,3580,940,1953,550000.0
3.0,2.0,2010,2.0,0,0,1510,500,2003,439000.0
3.0,2.25,2420,1.0,0,0,2420,0,1969,774888.0
5.0,2.5,2732,1.0,0,2,1870,862,1975,480000.0
4.0,2.0,1910,1.5,0,0,1910,0,1941,835000.0
5.0,3.5,3520,2.0,0,0,2400,1120,2008,1500000.0
4.0,2.0,2220,1.5,0,0,1370,850,1929,771000.0
4.0,2.25,2020,1.0,0,3,1760,260,1941,1225000.0
4.0,2.5,2090,1.0,0,0,1420,670,1966,600000.0
3.0,1.0,1580,1.0,0,0,1010,570,1962,305000.0
5.0,1.75,2650,1.0,0,0,2650,0,1955,1388000.0
3.0,1.0,1020,1.0,0,0,1020,0,1971,216500.0
3.0,2.5,1070,2.0,0,0,720,350,2004,370000.0
4.0,1.75,2120,1.0,0,0,1640,480,1967,492650.0
5.0,1.75,1360,1.0,0,0,1060,300,1966,431200.0
4.0,2.0,1700,2.0,0,0,1700,0,1990,277500.0
5.0,1.5,1820,1.0,0,0,1090,730,1960,278000.0
4.0,1.0,1430,1.0,0,0,730,700,1969,351000.0
4.0,3.5,4140,2.0,0,0,3160,980,2003,850000.0
2.0,2.0,1313,1.0,0,0,1313,0,1904,885000.0
3.0,2.0,1590,1.0,0,3,1590,0,1998,399950.0
3.0,1.75,1080,1.0,0,0,1080,0,1968,185000.0
5.0,3.0,2730,1.0,0,0,1470,1260,1979,440000.0
4.0,3.25,3800,2.0,0,0,3800,0,1969,2395000.0
3.0,2.25,2540,1.0,0,0,1320,1220,1969,299000.0
3.0,1.75,1810,1.0,0,0,1230,580,1980,299500.0
3.0,1.5,1540,1.0,0,0,1540,0,1961,420000.0
4.0,1.0,1390,1.0,0,0,1390,0,1955,234000.0
2.0,1.75,1460,1.0,0,0,850,610,1950,540000.0
4.0,2.5,2350,2.0,0,0,2350,0,1994,649950.0
3.0,1.0,1160,1.0,0,0,1160,0,1956,330000.0
4.0,3.25,3500,2.0,0,0,3500,0,2010,840000.0
3.0,2.5,1980,2.0,0,0,1980,0,1991,370000.0
3.0,1.5,1250,1.0,0,0,1250,0,1968,410000.0
2.0,1.0,770,1.0,0,0,770,0,1951,257000.0
3.0,1.0,1920,1.0,0,0,1320,600,1959,350000.0
2.0,1.0,1120,1.0,0,1,1120,0,1947,380000.0
3.0,1.0,1150,1.0,0,0,1150,0,1969,344000.0
3.0,2.5,1590,3.0,0,0,1590,0,1985,488000.0
3.0,1.0,910,1.0,0,0,780,130,1942,465000.0
2.0,1.75,1870,1.0,0,0,960,910,1948,229500.0
5.0,3.0,2420,2.0,0,0,2420,0,2013,445000.0
4.0,1.5,2120,1.5,0,0,2120,0,1919,246000.0
5.0,2.5,2730,1.0,0,0,1660,1070,1958,545000.0
4.0,2.5,2560,2.0,0,1,2560,0,2005,518000.0
4.0,2.5,2620,2.0,0,0,2620,0,1996,565000.0
4.0,2.5,2760,2.0,0,0,2760,0,2001,445000.0
5.0,2.5,2900,1.0,0,0,1450,1450,1959,968000.0
3.0,2.0,1820,1.0,0,0,910,910,1945,725000.0
3.0,1.75,1870,1.0,0,0,990,880,1977,315500.0
4.0,1.75,2010,1.0,0,0,1470,540,1977,487585.0
2.0,1.0,940,1.0,0,0,940,0,1954,246500.0
3.0,1.75,1850,1.5,0,0,1650,200,1913,819000.0
5.0,2.5,2530,2.0,0,0,2530,0,2004,349900.0
3.0,1.0,940,1.0,0,0,940,0,1942,267000.0
3.0,2.25,1820,1.0,0,0,1480,340,1978,480000.0
2.0,1.0,1510,1.0,0,0,880,630,1924,525000.0
4.0,2.5,2070,2.0,0,0,2070,0,1996,578000.0
3.0,2.5,1380,3.0,0,0,1380,0,2000,345000.0
3.0,1.0,1270,1.0,0,0,910,360,1955,499000.0
3.0,1.5,1390,1.0,0,0,1390,0,1956,425000.0
4.0,3.0,1840,2.0,0,0,1840,0,1988,268000.0
3.0,1.0,1600,1.0,0,0,1600,0,1971,240000.0
3.0,1.5,1480,1.0,0,0,1100,380,1964,147000.0
4.0,2.0,2120,1.0,0,0,1770,350,1949,500000.0
4.0,2.75,2940,1.5,0,2,1940,1000,1910,1010000.0
4.0,3.0,3820,2.0,0,2,3820,0,1995,991500.0
5.0,2.0,2740,1.0,0,0,1370,1370,1959,510000.0
4.0,4.0,4360,2.0,0,0,4360,0,2007,1980000.0
4.0,2.5,1540,2.0,0,0,1540,0,2014,484998.0
4.0,3.5,4660,2.0,0,2,4660,0,2003,1280000.0
3.0,1.75,1590,2.0,0,0,1590,0,1986,210000.0
2.0,1.0,1180,1.0,0,0,1180,0,1955,450000.0
4.0,1.75,2360,1.0,0,0,1320,1040,1952,875000.0
4.0,2.75,1860,1.0,0,0,1220,640,1967,529950.0
3.0,1.75,1470,1.0,0,0,1070,400,1979,415000.0
4.0,2.0,2990,1.5,0,2,1960,1030,1948,590000.0
3.0,1.5,1690,1.0,0,0,1140,550,1956,379950.0
1.0,1.0,660,1.0,0,0,660,0,1906,385000.0
3.0,1.75,2310,2.0,0,0,2310,0,1942,588000.0
2.0,1.0,770,1.0,0,0,770,0,1937,252500.0
3.0,3.5,2320,2.0,0,0,2060,260,1997,530000.0
2.0,1.5,1370,1.0,0,0,1370,0,1960,385000.0
3.0,2.25,1700,1.0,0,0,1340,360,1975,419000.0
2.0,1.0,960,1.0,0,0,770,190,1951,175000.0
2.0,1.0,1150,1.0,0,0,870,280,1948,515000.0
4.0,2.5,2910,1.5,0,0,1850,1060,1937,945000.0
5.0,2.25,2290,1.0,0,0,1290,1000,1973,359900.0
4.0,2.5,2260,2.0,0,0,2260,0,1996,419950.0
3.0,1.75,1300,1.0,0,0,900,400,1953,460000.0
3.0,2.25,1850,2.0,0,0,1850,0,1989,255000.0
4.0,1.75,1920,1.0,0,0,1470,450,1966,481000.0
4.0,1.75,1920,1.0,0,0,1470,450,1966,719521.0
3.0,3.0,4910,2.0,0,0,4000,910,1989,1080000.0
4.0,2.5,2210,1.0,0,2,1410,800,1965,334000.0
4.0,2.75,2280,1.5,0,0,1520,760,1931,675000.0
3.0,1.75,1640,1.0,0,0,1090,550,1948,556000.0
4.0,2.0,1980,2.0,0,3,1700,280,1910,900000.0
3.0,1.0,900,1.5,0,0,900,0,1910,400000.0
4.0,1.75,1960,1.0,0,0,980,980,1912,724950.0
4.0,2.25,1800,2.0,0,0,1800,0,2004,321000.0
4.0,3.5,4270,2.0,0,3,3170,1100,1937,1356920.0
4.0,2.0,1520,1.0,0,0,1020,500,1920,171000.0
4.0,3.0,5430,2.0,0,0,5430,0,1987,1360000.0
3.0,1.75,1950,1.0,0,0,1950,0,1989,323000.0
4.0,1.75,2190,1.0,0,2,2190,0,1968,491500.0
4.0,1.5,1200,1.0,0,0,1200,0,1972,226000.0
6.0,1.75,2180,1.5,0,0,1380,800,1926,580000.0
4.0,2.5,2320,2.0,0,0,2320,0,1982,640000.0
3.0,1.75,1040,1.0,0,0,800,240,1944,619790.0
4.0,2.5,2700,2.0,0,0,2700,0,2001,383962.0
3.0,2.0,1400,1.0,0,0,840,560,2002,373000.0
3.0,2.5,2060,2.0,0,0,1010,1050,1977,541338.0
2.0,1.0,780,1.0,0,0,780,0,1953,254922.0
3.0,2.25,2400,1.5,0,0,1440,960,1926,575000.0
4.0,3.0,2900,1.0,0,2,1870,1030,1961,650000.0
3.0,1.5,1740,1.0,0,0,1740,0,1962,269950.0
2.0,1.0,780,1.0,0,0,780,0,1942,270950.0
3.0,2.75,2430,1.0,0,0,1530,900,1988,495000.0
4.0,2.0,2210,1.0,0,1,1210,1000,1954,794154.0
3.0,1.5,1510,1.0,0,0,1510,0,1960,340768.0
2.0,1.0,900,1.0,0,0,900,0,1947,375000.0
4.0,2.5,3670,2.0,0,0,3670,0,2005,820000.0
2.0,2.25,1160,2.0,0,0,960,200,2014,555000.0
2.0,1.5,1070,2.0,0,0,1070,0,1999,312500.0
2.0,1.0,950,1.5,0,0,950,0,1925,450000.0
3.0,2.75,2950,2.0,0,0,2950,0,2003,739000.0
3.0,2.0,1420,2.0,0,0,1050,370,2003,320000.0
3.0,1.0,1590,1.5,0,0,1590,0,1944,235000.0
4.0,1.0,1290,1.5,0,0,1290,0,1957,275500.0
2.0,2.0,1690,1.0,0,0,1690,0,2004,564000.0
4.0,1.75,1340,1.5,0,0,1340,0,1958,263000.0
3.0,1.75,1397,1.0,0,0,1397,0,1965,257000.0
4.0,2.5,3750,2.0,0,0,3750,0,1991,725000.0
3.0,2.25,2000,1.0,0,0,1400,600,1979,300000.0
3.0,2.0,2250,1.5,0,0,2250,0,1998,328000.0
3.0,1.0,840,1.0,0,0,840,0,1959,187500.0
3.0,1.0,1100,2.0,0,0,1100,0,1900,400000.0
3.0,1.5,1660,1.0,0,0,1210,450,1954,515000.0
2.0,2.0,2180,1.0,1,4,1580,600,1952,1410000.0
3.0,1.0,1460,1.0,0,0,1460,0,1958,235000.0
4.0,2.5,2470,2.0,0,0,2470,0,2012,669000.0
3.0,1.0,1250,1.5,0,0,1250,0,1931,282000.0
3.0,2.0,1480,1.0,0,0,860,620,1928,663000.0
3.0,3.25,2240,2.0,0,0,1540,700,1989,279900.0
3.0,2.0,1570,1.0,0,0,1570,0,1952,335000.0
4.0,2.75,3250,2.0,0,0,3250,0,2014,689000.0
3.0,2.25,1790,1.0,0,0,1250,540,1980,413100.0
3.0,2.5,2080,2.0,0,0,2080,0,2000,506950.0
3.0,2.5,1480,3.0,0,0,1480,0,2006,500000.0
5.0,3.0,3610,2.0,0,0,3610,0,2003,540000.0
3.0,2.5,2040,2.0,0,0,2040,0,1998,812000.0
4.0,3.25,3850,2.0,0,3,3180,670,1989,1200000.0
3.0,2.25,3230,2.0,0,0,3230,0,1987,370000.0
3.0,2.0,2440,1.0,0,0,1640,800,1933,338000.0
4.0,1.0,1490,1.0,0,0,1490,0,1969,185000.0
3.0,1.0,1150,1.0,0,0,1010,140,1950,450000.0
2.0,1.0,900,1.0,0,0,900,0,1944,451000.0
4.0,2.5,3210,1.5,0,0,3210,0,1984,785000.0
5.0,3.0,3900,1.5,0,1,2620,1280,1931,850000.0
3.0,1.0,1240,1.0,0,0,1240,0,1943,235000.0
3.0,1.75,1760,2.0,1,4,1760,0,1940,1150000.0
3.0,2.25,1410,2.0,0,0,1290,120,2005,377500.0
3.0,2.5,2780,2.0,0,0,2780,0,2009,825500.0
5.0,3.25,3230,2.0,0,0,2480,750,2014,1059500.0
5.0,3.5,4600,2.0,0,0,3180,1420,2007,880000.0
3.0,2.0,1440,1.0,0,0,1440,0,2007,413800.0
2.0,1.5,1200,3.0,0,0,1200,0,2008,504200.0
4.0,3.0,2793,2.0,0,0,2793,0,2009,421500.0
4.0,2.5,2970,2.0,0,0,2970,0,2014,855169.0
3.0,2.0,1440,1.0,0,0,850,590,2008,380000.0
3.0,2.25,1480,3.0,0,0,1480,0,2014,580000.0
3.0,2.5,1870,2.0,0,0,1870,0,2012,377000.0
4.0,2.75,2475,2.0,0,0,2475,0,2014,329900.0
4.0,2.5,2950,2.0,0,0,2950,0,2012,921800.0
3.0,2.25,1410,3.0,0,0,1410,0,2014,529500.0
4.0,2.5,2240,2.0,0,0,2240,0,2014,363990.0
5.0,2.75,3230,2.0,0,0,3230,0,2014,834950.0
3.0,2.0,2100,1.0,0,0,2100,0,2010,399000.0
3.0,2.25,1936,1.0,0,0,1936,0,2013,338900.0
3.0,2.5,3120,2.0,0,0,3120,0,2007,419950.0
4.0,2.5,2070,2.0,0,0,2070,0,2010,493000.0
4.0,2.5,3700,2.0,0,0,3700,0,2007,650000.0
3.0,2.5,2130,2.0,0,0,2130,0,2013,456000.0
3.0,2.25,1620,2.5,0,0,1540,80,2010,425000.0
3.0,2.5,1490,3.0,0,0,1490,0,2009,348000.0
5.0,4.0,4180,2.0,0,0,4180,0,2014,1040890.0
2.0,2.5,1400,2.0,0,0,1160,240,2008,299000.0
4.0,3.75,3490,2.0,0,0,3490,0,2012,1264000.0
3.0,1.0,1300,1.0,0,0,1300,0,2013,155000.0
4.0,2.5,2730,2.0,0,0,2730,0,2006,319500.0
3.0,2.5,1830,2.0,0,0,1830,0,2005,274000.0
5.0,2.5,2340,2.0,0,0,2340,0,2009,429000.0
3.0,1.75,1410,2.0,0,0,1410,0,2014,267800.0
3.0,2.5,1930,2.0,0,0,1930,0,2014,369950.0
6.0,5.0,3028,2.0,0,0,3028,0,2005,480000.0
4.0,3.5,3180,2.0,0,0,2390,790,2007,440000.0
4.0,3.25,2950,2.0,0,0,2210,740,2014,839704.0
3.0,3.25,1430,3.0,0,0,1430,0,2007,535000.0
2.0,1.5,1020,3.0,0,0,1020,0,2008,290000.0
3.0,2.5,1650,3.0,0,0,1650,0,2007,370000.0
3.0,2.0,1060,3.0,0,0,1060,0,2007,405000.0
4.0,2.75,2620,2.0,0,0,2620,0,2013,499431.0
4.0,2.5,1830,2.0,0,0,1830,0,2007,275000.0
3.0,2.25,998,2.0,0,0,798,200,2007,320000.0
4.0,2.5,2070,2.0,0,0,2070,0,2007,425000.0
4.0,3.5,2860,3.0,0,0,2860,0,2013,1450000.0
3.0,2.0,1920,1.0,0,3,1920,0,2007,340000.0
3.0,2.5,1210,2.0,0,0,920,290,2008,299900.0
5.0,3.5,4890,2.0,0,0,3590,1300,2014,865950.0
4.0,2.5,3420,2.0,0,0,3420,0,2007,720000.0
4.0,3.5,2870,2.0,0,3,2070,800,2006,460000.0
3.0,2.5,1600,2.0,0,0,1600,0,2005,375000.0
2.0,1.5,960,2.0,0,0,960,0,2005,386180.0
3.0,2.75,1740,1.0,0,3,1740,0,2010,280000.0
4.0,2.5,2575,2.0,0,0,2575,0,2011,359000.0
5.0,3.25,3660,2.0,0,2,3660,0,2006,785000.0
3.0,2.25,1420,2.0,0,0,940,480,2009,425000.0
5.0,2.5,3070,2.0,0,0,3070,0,2005,575000.0
3.0,2.5,1920,1.0,0,0,1920,0,2014,465000.0
4.0,3.25,4160,2.0,0,0,4160,0,2014,1850000.0
4.0,3.25,3276,2.0,0,0,3276,0,2008,720000.0
5.0,3.75,2890,1.0,0,0,1310,1580,2006,390000.0
3.0,2.5,3430,2.0,0,0,3430,0,2014,2205000.0
4.0,3.5,3390,2.0,0,0,2610,780,2014,1054690.0
6.0,3.75,2930,2.0,0,3,2930,0,2013,915000.0
2.0,2.25,1300,3.0,0,0,1300,0,2008,562000.0
2.0,1.75,1250,2.0,0,0,1040,210,2007,349000.0
4.0,2.5,2310,2.0,0,0,2310,0,2011,375000.0
2.0,2.25,1360,3.0,0,0,1360,0,2008,479950.0
4.0,2.5,2020,2.0,0,0,2020,0,2010,319000.0
3.0,1.5,1270,3.0,0,0,1270,0,2009,325000.0
4.0,2.75,2790,2.0,0,0,2790,0,2013,505657.0
4.0,2.5,2320,2.0,0,0,2320,0,2010,340000.0
3.0,2.5,1750,2.0,0,0,1750,0,2012,250000.0
4.0,2.5,2030,2.0,0,0,2030,0,2014,349500.0
3.0,2.5,1270,2.0,0,0,1080,190,2008,290750.0
5.0,3.25,2710,2.0,0,0,2230,480,2013,715000.0
4.0,2.75,2520,2.0,0,0,2520,0,2014,689950.0
2.0,2.5,1340,3.0,0,0,1340,0,2008,425000.0
2.0,3.0,1570,3.0,0,0,1570,0,2014,657000.0
4.0,3.5,2690,2.0,0,0,2690,0,2007,359950.0
4.0,2.75,2475,2.0,0,0,2475,0,2014,319900.0
3.0,3.75,2260,2.0,0,0,1170,1090,2010,532000.0
2.0,1.0,840,3.0,0,0,840,0,2008,291000.0
3.0,3.25,1720,2.0,0,0,1030,690,2004,675000.0
3.0,2.25,2940,3.0,0,0,2940,0,2014,885000.0
5.0,3.5,4170,2.0,0,0,4170,0,2008,1450000.0
6.0,4.25,4310,2.0,0,0,2950,1360,2008,780000.0
4.0,2.75,3010,2.0,0,0,3010,0,2014,839950.0
3.0,2.5,2170,2.5,0,0,2170,0,2008,645000.0
3.0,2.5,1584,2.0,0,0,1584,0,2011,263000.0
2.0,2.25,1110,3.0,0,0,1110,0,2006,345000.0
4.0,2.5,2420,2.0,0,0,2420,0,2013,505000.0
2.0,2.25,1430,2.0,0,0,1340,90,2005,522500.0
3.0,2.5,2393,2.0,0,0,2393,0,2012,400000.0
3.0,2.25,1240,3.0,0,0,1240,0,2008,543000.0
4.0,2.5,2980,1.0,0,0,1910,1070,2007,495000.0
4.0,3.5,2970,2.0,0,0,2260,710,2014,549995.0
3.0,2.5,2329,2.0,0,0,2329,0,2010,327555.0
5.0,3.25,3340,2.0,0,0,2600,740,2005,690000.0
4.0,2.25,2580,2.0,0,0,2580,0,2015,673000.0
3.0,2.5,2029,2.0,0,0,2029,0,2014,384435.0
4.0,2.75,3430,2.0,0,0,3050,380,2006,780000.0
5.0,3.75,3330,2.0,0,2,2470,860,2014,1375000.0
5.0,3.5,3220,2.0,0,0,3220,0,2013,950968.0
2.0,2.25,1240,2.0,0,0,1150,90,2008,334950.0
3.0,3.5,1500,2.0,0,0,1240,260,2004,489000.0
3.0,3.0,3530,2.0,0,0,3530,0,2006,600000.0
3.0,2.25,1260,2.0,0,0,1020,240,2007,282000.0
4.0,4.0,4168,2.0,0,0,3222,946,2007,442000.0
2.0,1.5,1030,2.0,0,0,1030,0,1995,220000.0
3.0,2.5,3080,2.0,0,0,3080,0,2006,489000.0
3.0,1.5,1072,2.0,0,0,1072,0,2009,250000.0
4.0,2.75,2790,2.0,0,0,2790,0,2014,484259.0
3.0,2.5,4090,2.0,0,2,3590,500,2007,1680000.0
3.0,2.5,1800,2.0,0,0,1800,0,2013,450000.0
2.0,1.5,830,2.0,0,0,830,0,2005,299000.0
3.0,2.5,2280,2.0,0,0,2280,0,2010,450000.0
4.0,3.0,2110,2.0,0,0,1710,400,2007,585000.0
3.0,2.25,1570,3.0,0,0,1570,0,2014,660000.0
2.0,1.5,830,2.0,0,0,830,0,2005,301500.0
4.0,3.75,4120,2.0,0,0,4120,0,2012,949950.0
4.0,2.5,2540,2.0,0,0,2540,0,2009,759990.0
4.0,2.75,2050,2.0,0,0,2050,0,2014,355000.0
4.0,2.75,3080,2.0,0,0,3080,0,2014,889950.0
3.0,2.5,2390,2.0,0,0,2220,170,2008,629800.0
4.0,2.5,3170,2.0,0,0,3170,0,2012,745000.0
2.0,1.5,1240,2.0,0,0,1050,190,2007,379900.0
3.0,2.5,1090,2.0,0,0,960,130,2009,335000.0
5.0,4.5,4630,2.0,0,0,3210,1420,2006,809000.0
4.0,2.5,3230,2.0,0,0,3230,0,2012,569950.0
4.0,3.5,3510,2.0,0,0,3510,0,2001,723000.0
4.0,2.5,1785,2.0,0,0,1785,0,2009,282000.0
5.0,3.25,2360,2.0,0,0,1990,370,2006,569900.0
4.0,2.0,2340,1.0,0,0,2340,0,2009,385000.0
3.0,2.25,1620,3.0,0,0,1540,80,2009,420000.0
3.0,3.25,3890,2.0,0,0,2890,1000,2006,2250000.0
4.0,3.5,3590,2.0,0,2,3140,450,2006,1205000.0
4.0,3.0,1984,2.0,0,0,1984,0,2012,292000.0
3.0,2.25,1640,3.0,0,0,1640,0,2014,645000.0
4.0,2.0,1350,3.0,0,0,1350,0,2008,304500.0
4.0,3.5,2730,2.0,0,0,2000,730,2011,489500.0
4.0,4.0,5610,3.0,0,0,4750,860,2006,1583000.0
2.0,1.0,962,2.0,0,0,962,0,2012,390000.0
4.0,3.5,3040,2.0,0,0,2350,690,2013,815000.0
3.0,3.5,2540,2.0,0,1,2010,530,2014,719000.0
4.0,2.5,2240,2.0,0,0,2240,0,2014,331210.0
3.0,1.5,1260,2.0,0,0,1040,220,2005,245000.0
5.0,4.0,3210,2.0,0,0,2410,800,2011,465000.0
3.0,2.5,1620,3.0,0,4,1470,150,2008,580000.0
3.0,2.0,1580,2.5,0,2,1180,400,2007,540000.0
3.0,2.5,1430,3.0,0,0,1430,0,2007,399000.0
4.0,2.5,1850,2.0,0,0,1850,0,2009,328000.0
4.0,2.5,3340,2.0,0,0,3340,0,2010,701000.0
3.0,2.75,2670,2.0,0,0,2670,0,2014,408000.0
5.0,4.25,4660,2.0,0,2,4660,0,2005,2641100.0
3.0,2.5,1550,2.0,0,0,1060,490,2006,445000.0
4.0,2.5,3470,2.0,0,0,3470,0,2005,672500.0
3.0,2.5,3010,2.0,0,0,3010,0,2009,538000.0
5.0,3.5,3931,2.0,0,0,2650,1281,2014,450000.0
3.0,2.5,1800,2.0,0,0,1800,0,2011,362500.0
3.0,2.5,1570,3.0,0,0,1570,0,2008,414950.0
3.0,2.5,2230,2.0,0,0,2230,0,2014,679950.0
4.0,2.5,2423,2.0,0,0,2423,0,2005,290000.0
3.0,2.0,1160,2.0,0,0,790,370,2007,230000.0
2.0,2.0,1440,1.0,0,0,1440,0,2010,439950.0
4.0,2.5,2052,2.0,0,0,2052,0,2014,349900.0
5.0,2.5,2780,2.0,0,0,2780,0,2014,550000.0
4.0,4.25,3720,2.0,0,2,2960,760,2006,1050000.0
2.0,2.25,1460,2.0,0,0,1180,280,2014,655000.0
3.0,3.5,1370,2.0,0,0,1100,270,2006,385000.0
6.0,4.5,3600,2.0,0,0,2510,1090,2012,729999.0
3.0,2.25,1420,3.0,0,0,1420,0,2006,523950.0
2.0,2.5,980,2.0,0,0,670,310,2009,369000.0
3.0,2.5,1790,2.0,0,0,1790,0,2010,509900.0
3.0,2.5,2010,2.0,0,0,2010,0,2006,282000.0
3.0,2.5,2370,2.0,0,0,2370,0,2014,387865.0
4.0,2.5,2560,2.0,0,0,2560,0,2007,385000.0
3.0,2.5,1900,2.0,0,0,1900,0,2005,536000.0
2.0,2.25,1350,2.0,0,0,1050,300,2007,395000.0
4.0,2.75,2650,2.0,0,0,2650,0,2014,545000.0
4.0,2.5,3020,2.0,0,4,3020,0,2001,715000.0
3.0,2.5,1500,2.0,0,0,1500,0,2005,348000.0
3.0,1.75,1320,3.0,0,0,1320,0,2015,455000.0
4.0,2.75,3120,2.0,0,0,3120,0,2010,575000.0
3.0,2.25,1540,3.0,0,0,1540,0,2014,449950.0
3.0,2.5,1800,2.0,0,0,1800,0,2011,364000.0
4.0,2.5,3640,2.0,0,0,3640,0,2014,932990.0
3.0,2.5,2440,2.0,0,0,2440,0,2003,710000.0
4.0,4.0,3970,2.0,0,0,3970,0,2014,949990.0
3.0,2.5,2060,2.0,0,0,2060,0,2014,326989.0
3.0,2.5,2538,2.0,0,0,2538,0,2013,335606.0
5.0,4.5,4270,2.0,0,0,3400,870,2007,1532500.0
3.0,2.5,1320,2.0,0,0,1320,0,2005,299950.0
4.0,2.75,3340,2.0,0,0,3340,0,2013,962000.0
2.0,2.5,1590,2.0,0,0,1590,0,2012,395825.0
5.0,2.75,2710,2.0,0,0,2710,0,2014,419354.0
4.0,2.75,3140,2.0,0,1,3140,0,2006,920000.0
3.0,2.25,1445,2.0,0,0,1300,145,2005,366000.0
4.0,2.5,2430,2.0,0,0,2430,0,2009,480000.0
3.0,3.25,1370,2.0,0,0,1100,270,2006,388000.0
4.0,3.5,5050,2.0,0,0,3610,1440,2007,2320000.0
3.0,2.5,1860,2.0,0,0,1240,620,2010,730000.0
5.0,3.75,5330,2.0,0,2,3570,1760,2006,950000.0
3.0,3.25,1710,2.0,0,0,1400,310,2014,358990.0
4.0,2.5,2650,2.0,0,0,2650,0,2014,398651.0
4.0,2.5,2590,2.0,0,0,2590,0,2006,530000.0
4.0,2.5,2610,2.0,0,0,2610,0,2013,610360.0
3.0,2.5,1770,3.0,0,0,1600,170,2007,436110.0
4.0,2.75,3730,2.0,0,0,3730,0,2012,925000.0
4.0,2.5,2420,2.0,0,0,2420,0,2007,449950.0
4.0,2.5,3330,2.0,0,0,3330,0,2009,760000.0
3.0,2.25,1910,2.0,0,0,1910,0,2009,293000.0
2.0,2.5,2170,1.0,0,2,2170,0,2013,695000.0
3.0,2.5,2437,2.0,0,0,2437,0,2011,285000.0
5.0,4.0,4180,2.0,0,0,4180,0,2014,1255780.0
3.0,2.5,1800,2.0,0,0,1800,0,2011,379900.0
5.0,2.5,2570,2.0,0,0,2570,0,2006,472000.0
4.0,2.5,2090,2.0,0,0,2090,0,2007,300000.0
4.0,2.5,2789,2.0,0,0,2789,0,2007,272000.0
4.0,2.5,2906,2.0,0,0,2906,0,2014,418395.0
5.0,2.5,2550,2.0,0,0,2550,0,2008,465000.0
4.0,2.75,3550,2.0,0,0,3550,0,2014,659950.0
3.0,2.25,1590,3.0,0,0,1590,0,2014,484950.0
3.0,2.25,1950,2.0,0,0,1160,790,1979,359000.0
4.0,2.5,3250,2.0,0,0,3250,0,2009,519000.0
5.0,4.5,4590,2.0,0,0,4590,0,2009,1710000.0
4.0,2.75,3070,2.0,0,0,3070,0,2006,535000.0
4.0,3.25,3030,2.0,0,0,2830,200,2006,622950.0
3.0,2.5,2610,2.0,0,0,2610,0,2005,515000.0
4.0,3.5,3150,2.0,0,0,3150,0,2005,330000.0
3.0,1.5,1240,3.0,0,0,1240,0,2009,318000.0
3.0,2.5,1680,2.0,0,0,1680,0,2011,439000.0
3.0,2.5,2220,2.0,0,0,2220,0,2006,540000.0
4.0,3.25,4800,2.0,0,0,4800,0,2011,1079000.0
4.0,2.5,3100,2.0,0,0,3100,0,2010,435000.0
4.0,4.0,7850,2.0,0,0,7850,0,2006,2700000.0
4.0,2.75,3590,2.0,0,0,3590,0,2012,1100000.0
4.0,2.0,1590,3.0,0,0,1590,0,2008,293467.0
3.0,2.5,2242,2.0,0,0,2242,0,2013,328000.0
3.0,3.5,2490,2.0,0,0,1720,770,2005,550000.0
3.0,2.0,1530,3.0,0,0,1530,0,2015,649000.0
4.0,2.5,2150,2.0,0,0,2150,0,2010,435000.0
3.0,2.5,2440,2.0,0,0,2440,0,2014,625000.0
3.0,1.5,1270,3.0,0,0,1270,0,2007,415000.0
3.0,2.25,1450,2.0,0,0,1450,0,2009,400000.0
3.0,2.5,2690,3.0,0,0,2690,0,2014,979000.0
4.0,2.5,2755,2.0,0,0,2755,0,2003,625250.0
4.0,3.5,2650,2.0,0,0,2230,420,2011,665000.0
3.0,3.25,2310,2.0,0,0,1730,580,2005,589500.0
2.0,3.0,1460,2.0,0,0,1140,320,2007,437000.0
3.0,1.0,1400,1.0,0,0,1400,0,1959,320000.0
3.0,2.5,2196,2.0,0,0,2196,0,2006,333500.0
3.0,2.25,2020,2.0,0,0,1680,340,2008,430000.0
5.0,4.5,4280,2.0,0,0,4280,0,2014,995500.0
3.0,3.0,2340,2.0,0,0,2340,0,2013,427874.0
4.0,2.5,2220,2.0,0,0,2220,0,2014,334990.0
4.0,4.0,4420,2.0,0,0,3410,1010,2006,909500.0
3.0,2.0,1580,2.0,0,0,1580,0,2006,210000.0
4.0,2.75,3550,2.0,0,0,3550,0,2013,952990.0
2.0,1.75,1510,3.0,0,0,1420,90,2013,622500.0
3.0,3.5,1360,2.0,0,0,1040,320,2007,515000.0
3.0,2.5,2040,2.0,0,0,2040,0,2009,350000.0
1.0,1.5,1120,3.0,0,0,1120,0,2011,310000.0
4.0,3.5,4490,2.0,0,0,3390,1100,2006,700000.0
4.0,2.5,3560,2.0,0,0,2930,630,2014,907687.0
2.0,2.5,2150,1.0,0,0,2150,0,2010,741500.0
3.0,2.5,2130,2.0,0,0,1840,290,2011,395000.0
5.0,2.75,2990,2.0,0,0,2990,0,2014,559950.0
4.0,2.5,1847,2.0,0,0,1847,0,2008,215000.0
4.0,2.5,2610,2.0,0,0,2610,0,2011,390000.0
3.0,2.25,1670,1.0,0,0,1670,0,2007,425000.0
3.0,2.5,1860,2.0,0,0,1860,0,2006,472000.0
4.0,3.5,3440,2.0,0,0,3440,0,2006,1330000.0
4.0,3.5,3510,2.0,0,0,3510,0,2001,695000.0
3.0,2.5,1740,3.0,0,0,1740,0,2008,545000.0
4.0,2.5,2240,2.0,0,0,2240,0,2013,389950.0
3.0,2.25,1550,3.0,0,0,1550,0,2011,380000.0
4.0,2.0,1390,3.0,0,0,1390,0,2008,288790.0
3.0,3.0,2500,2.0,0,0,2500,0,2012,432500.0
3.0,3.5,2710,2.0,0,0,1650,1060,2005,615000.0
3.0,2.5,1720,2.0,0,0,1720,0,2011,500000.0
3.0,2.25,1760,3.0,0,0,1760,0,2014,615000.0
4.0,2.25,2270,1.0,0,0,1150,1120,1963,500000.0
3.0,3.5,1690,2.0,0,0,1370,320,2006,622000.0
5.0,3.5,4000,2.0,0,0,4000,0,2015,802945.0
4.0,2.5,2880,2.0,0,0,2880,0,2008,1260000.0
3.0,2.5,1480,3.0,0,0,1480,0,2014,598950.0
3.0,2.5,1950,2.0,0,0,1950,0,2009,430000.0
4.0,2.75,2700,2.0,0,0,2700,0,2009,515000.0
2.0,3.0,2210,2.0,0,0,1500,710,2008,1262000.0
4.0,3.5,2370,2.5,0,0,2370,0,2013,400000.0
3.0,2.5,1310,2.0,0,0,850,460,2007,390000.0
3.0,2.5,2410,2.0,0,0,2410,0,2007,450000.0
5.0,1.5,3360,2.0,0,0,3360,0,2014,804995.0
4.0,3.25,3040,2.0,0,0,2350,690,2013,825000.0
4.0,2.25,2140,2.0,0,0,2140,0,2002,435000.0
3.0,2.5,1720,2.0,0,0,1240,480,2004,398000.0
4.0,2.5,2658,2.0,0,0,2658,0,2014,411605.0
3.0,3.25,1480,2.0,0,0,1180,300,2013,315000.0
2.0,2.0,1350,3.0,0,0,1350,0,2013,455000.0
3.0,2.5,1150,2.0,0,0,1020,130,2006,452950.0
3.0,1.75,1690,2.0,0,0,1380,310,2008,380000.0
2.0,1.75,1270,2.0,0,0,1270,0,2012,340000.0
3.0,2.5,2655,2.0,0,0,2655,0,2013,409950.0
2.0,1.0,880,2.0,0,0,880,0,2005,360000.0
4.0,4.25,4645,2.0,0,0,3855,790,2006,1595000.0
3.0,1.5,1270,3.0,0,0,1270,0,2007,440000.0
2.0,1.75,1728,1.0,0,3,1728,0,2012,730000.0
3.0,2.25,1950,1.0,0,0,1950,0,2006,408000.0
4.0,2.5,3170,3.0,0,0,3170,0,2008,820000.0
2.0,2.5,1233,2.0,0,0,963,270,2007,360000.0
3.0,2.5,2570,2.0,0,0,2570,0,2014,339990.0
3.0,2.0,1560,3.0,0,0,1560,0,2014,515000.0
3.0,1.75,1630,2.0,0,0,1020,610,2013,541000.0
4.0,2.5,2510,2.0,0,0,2510,0,2007,375000.0
4.0,2.5,2223,2.0,0,0,2223,0,2010,320000.0
2.0,2.25,1230,2.0,0,0,1160,70,2008,325000.0
5.0,2.75,3050,2.0,0,0,3050,0,2014,740000.0
5.0,2.75,2710,2.0,0,0,2710,0,2014,450000.0
4.0,2.5,2090,2.0,0,0,2090,0,2011,455000.0
3.0,2.5,1440,2.0,0,0,1160,280,2006,292500.0
3.0,2.5,2500,1.0,0,0,1510,990,2013,650000.0
4.0,2.75,2740,2.0,0,0,2740,0,2015,530000.0
5.0,3.25,3360,2.0,0,0,3360,0,2014,829995.0
4.0,2.75,2280,2.0,0,0,2280,0,2009,395000.0
4.0,2.75,3520,2.0,0,0,3520,0,2014,859990.0
2.0,1.5,1320,2.0,0,0,1100,220,2008,342500.0
4.0,2.75,3410,2.0,0,0,3410,0,2012,743000.0
3.0,2.25,2730,1.0,0,0,1390,1340,1975,345000.0
3.0,2.5,1780,2.0,0,0,1530,250,2007,443000.0
3.0,2.5,1427,2.0,0,0,1427,0,2009,260000.0
4.0,2.5,2910,2.0,0,0,2910,0,2005,810000.0
4.0,2.75,3250,2.0,0,0,3250,0,2011,570000.0
5.0,3.5,3630,2.0,0,0,3630,0,2008,1563100.0
2.0,2.5,1680,3.0,0,0,1680,0,2009,840000.0
3.0,2.5,2280,3.0,0,0,1890,390,2013,950000.0
3.0,2.5,3310,2.0,0,0,2380,930,2015,572800.0
3.0,3.0,1290,3.0,0,0,1290,0,2008,305000.0
5.0,4.75,3940,2.0,0,0,3230,710,2008,1695000.0
4.0,2.5,2170,2.0,0,0,1630,540,2008,445000.0
4.0,3.5,3290,2.0,0,0,3290,0,2012,801000.0
3.0,2.5,2550,2.0,0,0,2550,0,2004,711000.0
3.0,2.25,1140,2.0,0,0,850,290,2008,268500.0
4.0,2.5,2300,2.0,0,0,2300,0,2012,320000.0
4.0,3.25,2670,1.0,0,0,1640,1030,2013,500000.0
4.0,2.5,2440,2.0,0,0,2440,0,2014,631625.0
2.0,2.5,1611,2.0,0,2,1611,0,2005,850000.0
3.0,3.5,2710,2.0,0,0,1650,1060,2006,600000.0
3.0,2.75,2015,2.0,1,4,2015,0,2007,988500.0
4.0,3.25,3444,2.0,0,0,2714,730,2014,430236.0
3.0,2.5,3060,2.0,0,0,3060,0,2005,1266520.0
4.0,2.5,2050,2.0,0,0,2050,0,2013,689500.0
3.0,1.5,1390,2.0,0,0,1390,0,2014,175003.0
2.0,2.5,1240,3.0,0,0,1240,0,2006,459000.0
4.0,3.25,3750,2.0,0,0,3750,0,2013,1180000.0
3.0,3.25,1410,3.0,0,0,1360,50,2006,358000.0
4.0,2.5,2448,2.0,0,0,2448,0,2014,447055.0
3.0,2.75,2600,1.5,0,0,2600,0,2009,415000.0
4.0,3.25,3330,2.0,0,0,2870,460,2004,1210000.0
2.0,2.25,1160,2.0,0,0,1000,160,2006,495000.0
2.0,2.25,1330,2.0,0,0,1060,270,2005,479000.0
3.0,2.5,2830,3.0,1,4,2830,0,2006,1898000.0
3.0,2.5,1610,2.0,0,0,1610,0,2005,249900.0
4.0,2.5,2800,2.0,0,0,2800,0,2011,1465000.0
5.0,3.75,4570,2.0,0,0,4570,0,2006,1037000.0
4.0,2.5,2820,2.0,0,0,2820,0,2014,897000.0
4.0,2.5,2570,2.0,0,0,2570,0,2006,1100000.0
3.0,2.25,1710,2.0,0,0,1140,570,2014,685000.0
3.0,1.5,1220,2.0,0,0,1220,0,1982,295000.0
3.0,2.25,1650,3.0,0,0,1650,0,2014,619000.0
2.0,1.5,1130,2.0,0,0,910,220,2008,439108.0
3.0,2.25,1489,2.0,0,0,1489,0,2011,260000.0
5.0,2.5,2690,2.0,0,0,2690,0,2012,279000.0
3.0,2.25,1530,2.0,0,0,1116,414,2007,380000.0
3.0,2.5,1600,2.0,0,0,1600,0,2013,287000.0
2.0,1.5,1000,2.0,0,0,930,70,2006,377000.0
4.0,3.5,2440,3.0,0,1,2440,0,2005,649950.0
3.0,2.5,1260,3.0,0,0,1260,0,2007,445000.0
3.0,2.5,1660,3.0,0,0,1610,50,2005,605000.0
3.0,2.25,1190,2.0,0,0,960,230,1999,475000.0
3.0,3.0,1520,3.0,0,0,1520,0,2009,399000.0
5.0,2.75,3250,2.0,0,0,3250,0,2014,718000.0
4.0,3.25,4700,1.0,0,4,2520,2180,2005,1400000.0
3.0,2.5,1480,2.0,0,0,1180,300,2012,341000.0
2.0,2.5,2380,1.0,0,2,2380,0,2011,818000.0
3.0,2.25,1640,3.0,0,0,1640,0,2014,759000.0
3.0,3.5,1650,3.0,0,0,1650,0,2010,547500.0
5.0,4.75,5305,2.0,0,2,3745,1560,2005,2700000.0
2.0,2.5,1278,2.0,0,0,1002,276,2007,358000.0
3.0,2.5,1200,3.0,0,0,1200,0,2010,412000.0
2.0,1.5,690,2.0,0,0,690,0,2005,245000.0
4.0,2.5,3202,2.0,0,0,3202,0,2014,460940.0
3.0,2.25,1347,3.0,0,0,1347,0,2010,321000.0
4.0,3.5,2960,2.0,0,0,2960,0,2014,633634.0
1.0,0.75,740,1.0,0,0,740,0,1928,290000.0
2.0,2.25,1200,3.0,0,0,1200,0,2007,445000.0
5.0,3.5,4320,2.0,0,0,3500,820,2012,887250.0
3.0,2.5,2310,1.0,0,3,2310,0,2010,739000.0
3.0,2.0,1490,3.0,0,0,1490,0,2014,429900.0
3.0,2.0,1480,2.0,0,0,1000,480,2014,459000.0
3.0,2.25,1481,2.0,0,0,1481,0,2012,240000.0
3.0,3.0,1730,3.0,0,0,1730,0,2014,566950.0
4.0,3.5,3900,2.0,0,0,3900,0,2006,1040000.0
3.0,3.5,1130,3.0,0,0,1130,0,2005,343000.0
4.0,3.25,3230,2.0,0,0,3230,0,2014,572115.0
5.0,3.5,3920,2.0,0,0,2820,1100,2004,918000.0
2.0,1.5,1190,2.0,0,0,1190,0,2007,555000.0
4.0,2.5,2311,2.0,0,0,2311,0,2014,399440.0
3.0,2.5,1810,3.0,0,0,1380,430,2008,450000.0
4.0,2.5,3290,2.0,0,0,3290,0,2008,648000.0
4.0,2.5,3250,2.0,0,0,3250,0,2008,580000.0
4.0,2.5,2544,2.0,0,0,2544,0,2013,415000.0
3.0,2.5,1380,3.0,0,0,1380,0,2008,527500.0
3.0,2.25,1430,2.0,0,0,1140,290,2011,384000.0
3.0,2.5,3490,1.5,0,2,2242,1248,2009,692000.0
2.0,1.5,910,2.0,0,0,820,90,2006,455000.0
4.0,3.25,3080,2.0,0,0,2380,700,2014,1280000.0
3.0,2.5,2280,2.0,0,0,2280,0,2011,415000.0
3.0,2.5,1660,3.0,0,0,1660,0,2008,975000.0
4.0,2.5,3320,2.0,0,0,3320,0,2014,799950.0
5.0,4.0,1680,1.0,0,0,1370,310,2008,545000.0
4.0,3.5,2584,2.0,0,0,2584,0,2014,429900.0
3.0,2.5,2217,2.0,0,0,2217,0,2009,275000.0
3.0,2.5,2480,2.0,0,0,2480,0,2009,498000.0
3.0,2.5,2610,2.0,0,0,2610,0,2014,754950.0
4.0,3.0,3240,2.0,0,0,3240,0,2013,895000.0
4.0,3.25,3569,2.0,0,0,3569,0,2013,580000.0
4.0,2.5,3181,2.0,0,0,3181,0,2014,379900.0
4.0,2.5,1921,2.0,0,0,1921,0,2009,245000.0
3.0,2.5,1570,2.0,0,0,1570,0,2014,417000.0
3.0,2.5,1940,2.0,0,0,1940,0,2009,555000.0
3.0,2.5,1940,2.0,0,0,1940,0,2009,555000.0
4.0,2.5,2210,2.0,0,0,2210,0,2009,353000.0
3.0,2.25,1280,2.0,0,0,1080,200,2008,539000.0
3.0,2.0,1520,2.0,0,0,1520,0,1977,434900.0
2.0,2.25,1230,2.0,0,0,1160,70,2008,325000.0
3.0,2.5,1480,3.0,0,0,1480,0,2007,650000.0
4.0,2.5,2612,2.0,0,0,2612,0,2014,379950.0
3.0,2.5,2350,2.0,0,0,2350,0,2012,700000.0
3.0,2.5,1300,2.0,0,0,1100,200,2014,675000.0
4.0,1.5,2020,1.0,0,0,2020,0,1960,379000.0
3.0,2.5,2140,2.0,0,0,1960,180,2005,571000.0
3.0,2.25,1380,2.0,0,0,1140,240,2007,475000.0
4.0,3.5,2730,2.0,0,0,2400,330,2006,769900.0
4.0,3.5,4220,2.0,0,0,2910,1310,2006,633000.0
3.0,2.5,1570,3.0,0,0,1570,0,2010,635000.0
4.0,3.5,4670,2.0,0,3,3820,850,2007,1238000.0
3.0,2.25,1370,3.0,0,0,1330,40,2009,524000.0
4.0,3.5,3273,2.0,0,0,2671,602,2014,485000.0
3.0,4.0,3880,2.0,0,3,3700,180,2009,1030000.0
3.0,3.5,1494,3.0,0,0,1494,0,2011,650000.0
3.0,2.5,2930,2.0,0,0,2930,0,2013,754842.0
4.0,2.5,2598,2.0,0,0,2598,0,2014,428900.0
3.0,2.5,2242,2.0,0,0,2242,0,2011,329900.0
4.0,2.5,2830,2.0,0,0,2830,0,2014,1035290.0
4.0,2.5,2710,2.0,0,0,2710,0,2009,544999.0
4.0,2.75,2320,2.0,0,0,2320,0,2012,449950.0
4.0,2.5,2720,2.0,0,0,2720,0,2006,635000.0
3.0,1.75,1650,3.0,0,0,1650,0,2014,599000.0
3.0,3.25,1430,2.0,0,0,1160,270,2008,478000.0
4.0,2.5,2090,2.0,0,0,2090,0,2014,388000.0
4.0,3.5,3660,2.0,0,0,2760,900,2014,809950.0
4.0,3.5,4220,3.0,0,0,4220,0,2012,1060000.0
2.0,2.5,1450,2.0,0,0,1110,340,2015,659000.0
4.0,3.75,3460,2.0,0,0,3460,0,2013,971971.0
3.0,2.5,1350,3.0,0,0,1270,80,2006,389000.0
4.0,2.75,3000,2.0,0,0,3000,0,2005,355000.0
4.0,2.5,2950,2.0,0,0,2950,0,2006,551500.0
4.0,2.5,2530,2.0,0,0,2530,0,2014,417838.0
4.0,4.5,4650,2.0,0,0,3640,1010,2008,1750000.0
2.0,1.0,710,2.0,0,0,710,0,1943,399950.0
4.0,2.5,3050,2.0,0,0,3050,0,2007,740000.0
3.0,2.5,1150,2.0,0,0,1150,0,2013,335000.0
5.0,5.25,3410,2.0,0,0,3410,0,2006,2250000.0
3.0,1.75,1370,3.0,0,0,1370,0,2007,667000.0
4.0,2.5,3540,2.0,0,0,3540,0,2007,920000.0
3.0,2.5,1370,2.0,0,0,1010,360,2007,368000.0
4.0,2.5,1714,2.0,0,0,1714,0,2009,307000.0
4.0,2.75,3650,2.0,0,0,2940,710,2014,550000.0
4.0,2.5,2990,2.0,0,0,2990,0,2013,594491.0
4.0,2.5,3284,2.0,0,0,3284,0,2014,460458.0
4.0,2.25,3550,1.0,0,0,1830,1720,2010,859000.0
3.0,3.0,1860,2.0,0,0,1710,150,2009,399950.0
3.0,3.25,1720,2.0,0,0,1360,360,2007,547500.0
3.0,2.5,2540,2.0,0,0,2540,0,2006,310000.0
4.0,2.75,3270,2.0,0,0,3270,0,2014,939000.0
2.0,2.5,980,3.0,0,0,980,0,2008,329900.0
3.0,2.5,1150,2.0,0,0,1020,130,2006,436000.0
3.0,2.5,1820,2.0,0,0,1570,250,2008,320000.0
3.0,2.5,1580,2.0,0,0,1580,0,2011,375000.0
3.0,2.0,1460,2.0,0,0,1460,0,2010,392137.0
4.0,2.5,2900,2.0,0,0,2900,0,2004,520000.0
5.0,2.75,2620,2.0,0,0,2620,0,2007,535000.0
2.0,2.5,1340,2.0,0,0,940,400,2008,407000.0
4.0,3.25,3266,2.0,0,0,3266,0,2014,424950.0
2.0,1.5,1076,3.0,0,0,1076,0,2006,290000.0
3.0,3.25,1680,2.0,0,0,1360,320,2009,399000.0
3.0,2.5,1930,2.0,0,0,1300,630,2005,439990.0
4.0,2.5,2880,2.0,0,0,1940,940,2014,635000.0
4.0,2.25,2240,2.0,0,0,2240,0,2013,635000.0
3.0,2.5,2594,2.0,0,0,2594,0,2012,351000.0
2.0,1.5,1210,3.0,0,0,1210,0,2007,437500.0
4.0,3.5,3760,2.0,0,0,2860,900,2014,919204.0
4.0,2.5,3600,2.0,0,0,3600,0,2014,923990.0
4.0,2.5,2050,2.0,0,0,2050,0,2012,639888.0
3.0,3.25,1510,2.0,0,0,1220,290,2008,675000.0
4.0,2.5,2580,2.0,0,0,2580,0,2013,899900.0
3.0,2.5,1670,2.0,0,0,1670,0,2009,252000.0
4.0,2.5,3190,2.0,0,0,3190,0,2007,925000.0
3.0,2.5,1280,3.0,0,0,1280,0,2009,552000.0
4.0,2.5,2718,2.0,0,0,2718,0,2006,388500.0
2.0,2.0,1370,3.0,0,0,1370,0,2004,548000.0
3.0,2.5,1794,2.0,0,0,1794,0,2005,254950.0
4.0,4.5,5120,2.0,0,0,3290,1830,2008,1237500.0
3.0,2.5,2160,2.0,0,0,1970,190,2014,629000.0
4.0,2.5,2180,2.0,0,0,2180,0,2014,734000.0
3.0,2.25,1490,2.0,0,0,1220,270,2010,309000.0
3.0,2.5,2950,2.0,0,0,2950,0,2006,554950.0
3.0,2.75,2990,2.0,0,0,2990,0,2000,785000.0
4.0,2.5,2700,2.0,0,0,2700,0,2007,550000.0
4.0,3.5,3130,3.0,0,0,3130,0,2014,1010000.0
3.0,2.0,3620,2.0,0,0,3220,400,2007,1575000.0
5.0,2.75,2481,2.0,0,0,2481,0,2014,309000.0
3.0,2.5,1730,2.0,0,0,1730,0,2014,328423.0
3.0,1.5,1420,2.0,0,0,1140,280,2008,345000.0
5.0,3.5,3160,2.0,0,0,3160,0,2014,660000.0
3.0,3.25,1320,2.0,0,0,1040,280,2008,385000.0
2.0,2.25,1010,2.0,0,0,710,300,2006,459000.0
3.0,2.5,1870,2.0,0,0,1870,0,2007,248000.0
4.0,3.5,5220,2.0,0,3,3550,1670,2006,1481000.0
4.0,2.5,2260,2.0,0,0,2260,0,2011,379000.0
5.0,4.5,4340,3.0,0,4,4340,0,2010,2945000.0
2.0,2.25,1620,2.0,0,0,1540,80,2004,395000.0
3.0,2.5,2280,2.0,0,0,1880,400,2006,535000.0
5.0,3.5,3400,2.0,0,0,2550,850,2008,970000.0
2.0,1.5,830,2.0,0,0,830,0,2006,205000.0
4.0,2.5,2310,2.0,0,0,2310,0,2010,310000.0
2.0,1.5,830,2.0,0,0,830,0,2005,334500.0
5.0,3.25,4130,2.0,0,0,4130,0,2012,995000.0
4.0,3.0,2050,2.0,0,0,2050,0,2014,370228.0
4.0,2.5,2050,2.0,0,0,2050,0,2014,383000.0
3.0,2.5,1600,2.0,0,0,1600,0,2005,384500.0
5.0,2.5,3190,2.0,0,0,3190,0,2014,865000.0
4.0,3.75,3860,2.5,0,0,3860,0,2007,1051000.0
4.0,2.5,2040,2.0,0,0,2040,0,2012,502000.0
4.0,3.5,3845,2.0,0,0,3845,0,2013,1750000.0
4.0,2.5,2650,2.0,0,0,2650,0,2014,569995.0
4.0,2.5,3430,2.0,0,0,3430,0,2013,749950.0
3.0,2.5,2430,2.0,0,0,2430,0,2007,550000.0
3.0,3.5,2876,2.0,0,0,2360,516,2007,525000.0
4.0,3.5,2550,2.0,0,0,2550,0,2007,516000.0
4.0,3.75,4100,2.0,0,0,4100,0,2014,1350000.0
4.0,2.5,2730,2.0,0,0,2730,0,2009,440000.0
3.0,2.5,1780,2.0,0,0,1080,700,2008,660000.0
3.0,2.5,1880,2.0,0,0,1880,0,2010,261950.0
5.0,3.75,3090,2.0,0,0,3090,0,2010,551000.0
3.0,3.5,2460,2.0,0,0,1900,560,2014,665000.0
4.0,3.5,2910,2.0,0,0,2910,0,2012,610000.0
4.0,3.5,2910,2.0,0,0,2910,0,2012,645000.0
3.0,1.75,1930,1.0,0,0,1930,0,2013,536751.0
3.0,2.25,1413,2.0,0,0,1413,0,2009,260000.0
3.0,3.25,4030,2.0,0,0,3630,400,2006,1312000.0
4.0,3.25,2880,2.5,0,0,2880,0,2014,429900.0
4.0,2.75,2360,1.0,0,0,2360,0,2014,535000.0
2.0,1.75,1070,3.0,0,0,1070,0,2006,462550.0
3.0,3.25,1460,3.0,0,0,1460,0,2008,602000.0
4.0,2.75,3800,2.0,0,0,3800,0,2008,730000.0
2.0,1.5,1190,3.0,0,0,1190,0,2010,300500.0
5.0,2.5,3200,2.0,0,0,3200,0,2009,675000.0
3.0,2.25,1970,2.0,0,0,1680,290,2008,415000.0
3.0,2.5,2830,2.0,0,0,2830,0,2010,614000.0
4.0,2.5,2630,2.0,0,0,2630,0,2010,385000.0
4.0,2.75,2720,2.0,0,0,2720,0,2005,594000.0
4.0,2.75,3160,2.0,0,0,3160,0,2014,860000.0
4.0,4.0,3770,2.0,0,0,2940,830,2006,1104500.0
4.0,2.75,3500,2.0,0,0,3500,0,2004,775000.0
5.0,2.75,2710,2.0,0,0,2710,0,2014,430760.0
2.0,2.5,2170,1.0,0,2,2170,0,2009,755000.0
2.0,2.25,1540,3.0,0,0,1540,0,2007,640000.0
3.0,3.25,1876,3.0,0,0,1876,0,2009,613500.0
4.0,3.5,3720,1.0,0,2,3720,0,2007,780000.0
4.0,2.5,3148,2.0,0,3,3148,0,2014,550000.0
4.0,3.25,3240,2.0,0,0,3240,0,2010,789500.0
5.0,3.5,3340,2.0,0,0,2580,760,2012,592000.0
4.0,2.5,2413,2.0,0,0,2413,0,2014,454950.0
4.0,2.5,2500,2.0,0,0,2500,0,2010,475000.0
2.0,1.75,1180,2.0,0,0,780,400,2014,659000.0
4.0,2.5,2890,2.0,0,0,2890,0,2005,570000.0
5.0,3.0,2230,1.0,0,0,1330,900,2014,347500.0
4.0,2.5,1767,2.0,0,0,1767,0,2006,205000.0
3.0,3.25,1450,2.0,0,0,1100,350,2009,380000.0
5.0,2.75,2930,2.0,0,0,2930,0,2013,718000.0
5.0,2.75,2710,2.0,0,0,2710,0,2014,515805.0
4.0,3.25,3600,2.0,0,1,3000,600,2013,1029280.0
3.0,2.5,1800,2.0,0,0,1800,0,2014,437718.0
4.0,2.5,2290,2.0,0,0,2290,0,2006,450000.0
3.0,2.5,1510,2.0,0,0,1060,450,2007,515000.0
2.0,2.5,1090,2.0,0,0,1090,0,2007,204000.0
3.0,2.0,1270,3.0,0,0,1270,0,2006,360000.0
3.0,2.25,1540,3.0,0,0,1540,0,2008,550000.0
3.0,2.5,2930,2.0,0,0,2930,0,2008,650880.0
5.0,3.75,4360,2.0,0,4,3530,830,2014,1789950.0
4.0,3.5,3640,2.0,0,3,2790,850,2014,895900.0
4.0,2.5,2430,2.0,0,0,2430,0,2008,585000.0
3.0,2.25,1520,2.0,0,0,1240,280,2010,380000.0
5.0,2.75,2730,2.0,0,0,2730,0,2014,565997.0
3.0,3.0,2440,2.0,0,0,1930,510,2006,459000.0
3.0,3.75,1580,2.0,0,0,1340,240,2010,550000.0
3.0,2.25,1420,3.0,0,0,1420,0,2006,500000.0
5.0,3.25,2820,2.0,0,0,2230,590,2006,461500.0
4.0,5.5,5060,2.0,0,0,5060,0,2008,2150000.0
4.0,2.5,2650,2.0,0,0,2650,0,2007,790000.0
3.0,2.25,1490,2.0,0,0,1040,450,2011,735000.0
4.0,2.5,3060,2.0,0,0,3060,0,2009,588000.0
3.0,3.25,3240,2.0,0,0,2770,470,2011,724500.0
3.0,2.75,2820,2.0,0,0,2820,0,2008,749000.0
5.0,3.5,4140,2.0,0,0,4140,0,2003,720000.0
2.0,1.5,982,2.0,0,0,806,176,2006,250000.0
3.0,2.75,2460,2.0,0,0,2460,0,2007,790000.0
4.0,2.5,2547,2.0,0,0,2547,0,2014,392440.0
4.0,2.25,1834,2.0,0,0,1834,0,2012,280000.0
4.0,4.5,3130,3.0,0,0,2450,680,2014,1333000.0
4.0,2.5,2730,2.0,0,0,2730,0,2008,649000.0
2.0,2.5,1380,2.0,0,0,1050,330,2008,457000.0
4.0,4.25,4700,2.0,0,1,3910,790,2002,2225000.0
3.0,3.0,2330,2.0,0,0,1920,410,2004,453000.0
3.0,2.5,1730,2.0,0,0,1730,0,2014,329780.0
2.0,2.5,2350,3.0,0,2,2000,350,2007,1050000.0
5.0,4.5,4000,2.0,0,0,4000,0,2015,771005.0
3.0,2.5,3350,1.0,0,0,2180,1170,2009,1300000.0
3.0,3.25,1530,3.0,0,0,1530,0,2006,607500.0
2.0,2.25,1610,2.0,0,0,1610,0,1979,278000.0
4.0,2.75,2620,2.0,0,0,2620,0,2013,475000.0
3.0,2.0,1300,2.0,0,0,850,450,2006,270000.0
4.0,3.5,3590,2.0,0,2,3140,450,2006,1302000.0
4.0,2.5,2490,2.0,0,0,2490,0,2014,778983.0
3.0,2.5,1320,2.0,0,0,880,440,2005,221000.0
4.0,2.25,1800,2.0,0,0,1800,0,2014,338800.0
5.0,1.5,3360,2.0,0,0,3360,0,2014,834995.0
4.0,2.5,3220,2.0,0,0,3220,0,2006,550000.0
3.0,3.5,2514,2.0,0,0,2024,490,2007,575000.0
4.0,2.75,3130,2.0,0,0,3130,0,2014,649000.0
4.0,2.5,2720,2.0,0,0,2720,0,2012,545000.0
2.0,2.25,1390,2.0,0,0,1165,225,2007,625000.0
4.0,4.5,4920,2.0,0,3,3820,1100,2006,1042000.0
3.0,2.5,2134,2.5,0,0,2134,0,2008,611000.0
3.0,2.5,1741,2.0,0,0,1741,0,2012,300000.0
3.0,2.5,2560,2.0,0,0,2560,0,2001,577000.0
4.0,2.5,2220,2.0,0,0,2220,0,2014,349990.0
3.0,2.5,1910,2.0,0,0,1910,0,2006,650000.0
2.0,1.5,980,2.0,0,0,820,160,2009,378000.0
3.0,2.5,1950,2.0,0,0,1950,0,2013,313200.0
5.0,4.25,4150,2.0,0,0,4150,0,2014,1206690.0
2.0,1.5,1110,2.0,0,0,950,160,2009,252500.0
3.0,2.5,1250,2.0,0,0,1080,170,2009,308000.0
4.0,2.5,3310,2.0,0,0,3310,0,2004,803100.0
4.0,2.5,2020,2.0,0,0,2020,0,2010,415000.0
4.0,3.5,3310,2.0,0,0,3310,0,2010,785000.0
4.0,2.5,2798,2.0,0,0,2798,0,2012,499950.0
4.0,2.5,1847,2.0,0,0,1847,0,2008,216000.0
4.0,2.5,2420,2.0,0,0,2420,0,2009,380000.0
4.0,2.5,2020,2.0,0,0,2020,0,2012,345000.0
4.0,2.5,2400,2.0,0,0,2400,0,2007,456500.0
3.0,2.5,1760,1.0,0,0,1760,0,2014,382495.0
4.0,2.5,2110,2.0,0,0,2110,0,2013,324950.0
4.0,2.5,2692,2.0,0,0,2692,0,2014,436472.0
3.0,2.25,1490,2.0,0,0,1490,0,2009,365250.0
5.0,3.25,3960,2.0,0,0,3960,0,2014,919990.0
4.0,2.5,1740,2.0,0,0,1740,0,2012,316475.0
4.0,2.5,1940,1.0,0,0,1190,750,2010,425000.0
2.0,1.0,970,2.0,0,0,790,180,2007,302860.0
3.0,2.5,1852,2.0,0,0,1852,0,2014,298000.0
4.0,4.0,4810,2.0,0,3,4810,0,2007,3204000.0
4.0,4.0,5635,2.0,0,3,4360,1275,2011,950000.0
3.0,2.5,1520,2.0,0,0,1520,0,2009,333000.0
3.0,2.5,2099,2.0,0,0,2099,0,2010,289950.0
3.0,2.25,1250,3.0,0,0,1250,0,2014,419950.0
2.0,1.5,1090,3.0,0,0,1090,0,2008,306000.0
4.0,2.5,3216,2.0,0,0,3216,0,2014,498445.0
4.0,2.5,2970,2.0,0,0,2970,0,2014,775950.0
3.0,2.5,2610,2.0,0,0,2610,0,2001,605000.0
2.0,1.75,1340,2.0,0,0,1060,280,2006,520000.0
4.0,2.75,3300,2.0,0,0,3300,0,2014,849990.0
3.0,2.0,1630,1.0,0,0,1630,0,2006,767450.0
3.0,2.25,1590,2.0,0,0,1060,530,2014,665000.0
2.0,2.75,1310,3.5,0,0,1310,0,2007,525000.0
4.0,3.5,3600,2.0,0,0,2940,660,2014,870515.0
4.0,2.5,2154,2.0,0,0,2154,0,2012,390000.0
3.0,1.75,1530,3.0,0,0,1530,0,2015,500000.0
3.0,2.25,1360,2.0,0,0,1094,266,2006,399950.0
3.0,2.5,1320,2.0,0,0,1320,0,2005,305000.0
4.0,2.5,1660,2.0,0,0,1660,0,2009,255000.0
4.0,2.5,2891,2.0,0,0,2891,0,2014,415000.0
3.0,2.5,2340,2.0,0,0,2120,220,2012,716500.0
3.0,2.5,2320,3.0,0,0,2320,0,2009,425000.0
4.0,2.5,2190,2.0,0,0,2190,0,2010,540000.0
3.0,2.5,2060,2.0,0,0,2060,0,2014,324747.0
3.0,2.5,1740,2.0,0,0,1740,0,2010,385000.0
3.0,2.25,1400,2.0,0,0,1400,0,2012,270000.0
5.0,4.0,4410,2.0,0,0,4410,0,2006,1240000.0
3.0,2.5,1780,2.0,0,0,1080,700,2008,672000.0
3.0,2.5,1760,2.0,0,0,1760,0,2010,310000.0
3.0,3.5,4410,2.0,1,4,3430,980,2014,3000000.0
6.0,4.25,5550,2.0,0,2,4270,1280,2014,2350000.0
3.0,2.5,2432,2.0,0,2,2432,0,2005,427000.0
3.0,2.5,2283,2.0,0,0,2283,0,2008,389950.0
3.0,2.5,1860,2.0,0,0,1860,0,2012,309620.0
4.0,2.5,2701,2.0,0,0,2701,0,2014,399895.0
4.0,2.5,2930,2.0,0,0,2930,0,2014,442515.0
3.0,2.25,1540,3.0,0,0,1540,0,2010,375000.0
3.0,2.5,2242,2.0,0,0,2242,0,2014,309780.0
3.0,2.5,1950,2.0,0,0,1950,0,2007,425000.0
2.0,3.0,1160,2.0,0,0,880,280,2007,405000.0
3.0,2.5,2060,2.0,0,0,2060,0,2014,356250.0
3.0,2.25,1230,3.0,0,0,1230,0,2013,550000.0
2.0,1.5,1160,2.0,0,0,1160,0,2001,340000.0
4.0,2.5,2245,2.0,0,0,2245,0,2014,362865.0
4.0,3.5,4120,2.0,0,1,3970,150,2014,1360000.0
4.0,2.5,3400,2.0,0,0,3400,0,2007,830000.0
5.0,3.75,4270,2.0,0,0,3210,1060,2014,1598000.0
4.0,3.5,2890,2.0,0,0,2370,520,2014,855000.0
5.0,3.5,3220,2.0,0,0,2900,320,2008,1205000.0
4.0,3.5,4010,2.0,0,1,4010,0,2006,1385000.0
4.0,3.5,2260,2.0,0,0,2260,0,2013,400200.0
2.0,1.0,1140,1.5,0,0,1010,130,2007,235000.0
3.0,2.0,1640,1.0,0,0,1640,0,2009,349950.0
4.0,2.75,3510,2.0,0,0,3510,0,2014,659950.0
3.0,2.75,3010,2.0,0,0,3010,0,2011,785000.0
2.0,2.25,1060,2.0,0,0,980,80,2006,475000.0
3.0,2.5,1658,2.0,0,0,1658,0,2014,263900.0
3.0,2.5,1960,2.0,0,0,1960,0,2012,342000.0
3.0,2.5,2420,2.0,0,0,2420,0,2014,367899.0
3.0,3.5,3420,1.5,0,0,3420,0,2014,657044.0
2.0,1.5,893,2.0,0,0,893,0,2007,359950.0
4.0,2.75,3020,2.0,0,0,3020,0,2014,879950.0
4.0,2.5,2470,2.0,0,0,2470,0,2013,550000.0
4.0,2.5,2009,2.0,0,0,2009,0,2012,279000.0
3.0,2.5,1530,2.5,0,0,1530,0,2005,255000.0
3.0,1.75,1590,3.0,0,0,1590,0,2014,609500.0
5.0,3.0,2630,2.0,0,0,1670,960,2013,420000.0
4.0,2.5,3230,2.0,0,0,3230,0,2008,570000.0
3.0,2.25,1430,2.0,0,0,1430,0,2012,439000.0
3.0,2.5,2242,2.0,0,0,2242,0,2012,310000.0
4.0,2.5,2500,2.0,0,0,2500,0,2014,635000.0
3.0,2.5,1230,2.0,0,0,1080,150,2009,399950.0
4.0,2.5,3020,2.5,0,0,3020,0,2009,805000.0
4.0,3.5,3480,2.0,0,0,2460,1020,2015,1800000.0
4.0,3.0,3330,1.0,0,0,1830,1500,2008,1205000.0
4.0,2.5,3400,2.0,0,0,3190,210,2006,745000.0
2.0,1.5,830,2.0,0,0,830,0,2005,329445.0
5.0,3.0,3110,2.0,0,0,3110,0,2007,588000.0
3.0,2.5,1910,2.0,0,0,1910,0,2014,494815.0
3.0,2.75,3230,2.0,0,0,2680,550,2014,591975.0
5.0,2.75,3380,2.0,0,0,3380,0,2011,600000.0
3.0,2.75,2830,2.0,0,0,2830,0,2012,673000.0
5.0,3.5,3700,2.0,0,0,3700,0,2014,889950.0
4.0,3.0,2520,2.0,0,0,2520,0,2002,500000.0
3.0,2.25,1530,2.0,0,0,1240,290,2007,500000.0
4.0,4.25,4420,2.0,0,0,3410,1010,2006,890000.0
3.0,3.0,1460,3.0,0,0,1460,0,2006,437000.0
3.0,2.25,1450,2.0,0,0,1160,290,2006,419700.0
3.0,2.0,1160,1.0,0,0,580,580,1930,394000.0
3.0,2.0,1640,1.0,0,0,1640,0,2010,342000.0
3.0,1.75,1444,1.5,0,0,1444,0,2008,420000.0
3.0,2.5,1620,3.0,0,4,1470,150,2008,580000.0
2.0,1.5,1100,2.0,0,0,900,200,2007,343000.0
2.0,1.5,1340,2.0,0,0,1120,220,2008,390000.0
3.0,1.5,1450,2.0,0,0,1450,0,2011,274000.0
4.0,2.5,3040,2.0,0,0,3040,0,2008,700000.0
4.0,2.5,2560,2.0,0,0,2560,0,2006,838000.0
6.0,3.0,2744,2.0,0,0,2744,0,2006,300000.0
3.0,2.25,1420,3.0,0,0,1420,0,2008,467000.0
2.0,1.0,700,1.0,0,0,700,0,1943,395000.0
5.0,4.25,4110,2.0,0,2,2970,1140,2000,734000.0
5.0,2.75,2670,2.0,0,0,2670,0,2013,480000.0
3.0,2.75,2130,2.0,0,0,1080,1050,2010,539000.0
5.0,2.75,3078,2.0,0,0,3078,0,2014,459950.0
2.0,1.0,840,2.0,0,0,840,0,2006,306500.0
3.0,2.5,1800,2.0,0,0,1800,0,2014,408474.0
3.0,2.75,2580,2.0,0,0,2580,0,2008,437000.0
3.0,1.5,1270,2.0,0,0,1270,0,2012,160797.0
4.0,3.5,3065,3.0,0,0,3065,0,2014,729000.0
3.0,2.5,1861,2.0,0,0,1578,283,2007,499000.0
4.0,2.75,2260,2.0,0,0,2260,0,2014,359950.0
5.0,3.25,4150,2.0,0,0,4150,0,2013,929000.0
2.0,2.5,1500,2.0,0,0,1140,360,2014,529950.0
3.0,2.25,1620,2.5,0,0,1540,80,2012,461000.0
2.0,1.5,830,2.0,0,0,830,0,2005,271115.0
4.0,2.5,3120,2.0,0,0,3120,0,2003,653000.0
3.0,2.5,1870,3.0,0,0,1380,490,2007,565000.0
3.0,2.25,1240,3.0,0,0,1240,0,2014,529950.0
4.0,2.5,2820,2.0,0,0,2820,0,2007,585000.0
3.0,1.75,1630,3.0,0,0,1630,0,2014,609000.0
3.0,2.25,1584,2.0,0,0,1584,0,2012,267000.0
4.0,2.5,2840,2.0,0,0,2840,0,2012,557000.0
4.0,3.25,3910,2.0,0,0,3130,780,2006,709950.0
3.0,2.5,1730,3.0,0,0,1730,0,2011,625000.0
3.0,2.75,1840,2.0,0,0,1700,140,2013,599000.0
4.0,3.75,4030,2.0,0,0,4030,0,2008,920000.0
4.0,3.5,3440,3.0,0,0,3440,0,2014,1285000.0
4.0,2.5,2110,2.0,0,0,2110,0,2012,324500.0
3.0,2.5,2430,2.0,0,0,2430,0,2009,471500.0
4.0,3.75,4690,2.0,0,0,4030,660,2007,1015000.0
4.0,3.5,3500,2.0,0,0,2850,650,2014,998000.0
4.0,2.5,2070,2.0,0,0,2070,0,2006,262000.0
4.0,3.5,3350,2.0,0,2,2610,740,2009,844000.0
4.0,2.5,2440,2.0,0,0,2440,0,2013,745641.0
5.0,3.0,3010,2.0,0,0,3010,0,2008,659950.0
3.0,2.5,2060,2.0,0,0,2060,0,2014,339989.0
2.0,2.5,1570,2.0,0,0,1180,390,2009,352500.0
3.0,2.5,1580,2.0,0,0,1010,570,2008,525000.0
5.0,3.5,4280,2.0,0,3,4280,0,2014,1138990.0
5.0,3.5,2815,2.0,0,0,2815,0,2011,491000.0
4.0,2.5,2620,2.0,0,0,2620,0,2011,675000.0
3.0,2.25,1250,3.0,0,0,1250,0,2007,344000.0
4.0,2.5,3250,2.0,0,0,3250,0,2008,530000.0
4.0,3.25,2510,2.0,0,0,2510,0,2003,290500.0
2.0,1.75,1270,2.0,0,0,1270,0,2012,335000.0
5.0,4.0,6670,2.0,0,0,4960,1710,2007,2998000.0
3.0,2.5,1580,2.0,0,0,1580,0,2013,379000.0
3.0,1.5,1360,3.0,0,0,1360,0,2008,385000.0
4.0,2.5,2400,1.0,0,0,1230,1170,1962,500012.0
3.0,3.0,1571,3.0,0,0,1571,0,2008,366750.0
2.0,2.0,1405,2.0,0,0,1140,265,2007,405000.0
3.0,1.5,1010,2.0,0,0,1010,0,1971,356999.0
2.0,2.5,1450,2.0,0,0,1220,230,2006,590000.0
3.0,1.75,1420,2.0,0,0,960,460,2014,294000.0
4.0,2.5,2650,2.0,0,0,2650,0,2013,731500.0
5.0,2.75,3030,2.0,0,0,3030,0,2014,837219.0
4.0,5.5,6530,2.0,0,2,6530,0,2008,1600000.0
3.0,2.75,2670,1.0,0,0,1720,950,2013,798800.0
2.0,2.5,1170,2.0,0,0,1170,0,2007,482500.0
4.0,2.5,3260,2.0,0,0,3260,0,2007,820000.0
3.0,1.5,1480,3.0,0,0,1480,0,2007,319000.0
3.0,2.5,2700,2.0,0,3,2700,0,2013,950000.0
4.0,3.5,4640,2.0,0,0,4640,0,2007,1267500.0
3.0,2.5,1601,3.0,0,0,1536,65,2007,378000.0
5.0,3.75,5350,1.0,0,1,3040,2310,2008,3345000.0
3.0,2.5,2540,2.0,0,0,2540,0,2011,489950.0
2.0,1.75,1030,2.0,0,0,765,265,2006,345000.0
3.0,2.5,2730,2.0,0,0,2730,0,2012,510000.0
4.0,2.5,3172,2.0,0,0,3172,0,2014,432500.0
4.0,2.5,3160,2.0,0,0,3160,0,2006,650000.0
4.0,2.5,2850,2.0,0,0,2850,0,2008,750000.0
4.0,3.5,2780,2.0,0,0,2120,660,2014,870000.0
4.0,3.5,3860,2.0,0,0,3860,0,2014,900000.0
2.0,1.75,1180,2.0,0,0,780,400,2014,664950.0
3.0,2.25,1410,2.0,0,0,1290,120,2004,391000.0
4.0,3.5,6370,2.0,0,0,6370,0,2008,1800000.0
5.0,3.0,3223,2.0,0,0,3223,0,2014,479349.0
4.0,3.25,2600,2.0,0,0,2150,450,2011,661000.0
3.0,3.25,1380,3.0,0,0,1380,0,2006,379000.0
3.0,2.25,1620,2.5,0,0,1540,80,2010,415000.0
3.0,3.25,1370,3.0,0,0,1370,0,2007,375000.0
3.0,2.0,1220,3.0,0,0,1220,0,2007,355000.0
3.0,2.5,1280,3.0,0,0,1280,0,2009,540000.0
2.0,1.5,770,2.0,0,0,770,0,2006,290000.0
3.0,2.5,1210,3.0,0,0,1210,0,2008,500000.0
4.0,2.5,2890,2.0,0,0,2890,0,2011,416000.0
3.0,2.5,1580,2.0,0,0,1580,0,2011,349900.0
3.0,2.25,1530,2.0,0,0,1050,480,2014,465000.0
4.0,2.5,3670,2.5,0,0,3670,0,2007,950000.0
4.0,2.25,1850,2.5,0,0,1850,0,2014,496800.0
4.0,2.5,2440,2.0,0,0,2440,0,2014,680000.0
4.0,3.25,2190,2.0,0,0,1540,650,2015,920000.0
5.0,4.0,4360,2.0,0,0,4360,0,2015,1289990.0
4.0,2.75,3990,2.0,0,0,3990,0,2003,825000.0
3.0,2.5,1270,3.0,0,0,1270,0,2007,292000.0
4.0,2.5,3340,2.0,0,0,3340,0,2009,576000.0
2.0,2.0,1500,3.0,0,3,1500,0,2008,670000.0
4.0,3.5,3120,2.0,0,0,2480,640,2008,953007.0
4.0,2.5,2480,2.0,0,0,2480,0,2012,399000.0
2.0,2.0,1110,3.0,0,0,980,130,2008,399000.0
4.0,2.75,2760,2.0,0,0,2760,0,2014,847093.0
3.0,2.5,1510,3.0,0,0,1510,0,2014,599950.0
3.0,2.5,1460,2.0,0,0,1180,280,2007,499000.0
4.0,2.75,3980,2.0,0,2,3980,0,2006,760000.0
4.0,3.75,3320,2.0,0,0,3320,0,2014,1699990.0
4.0,3.25,3270,2.0,0,0,3110,160,2014,1033890.0
4.0,2.5,2670,2.0,0,0,2670,0,2006,515000.0
3.0,2.25,1410,2.0,0,0,1290,120,2004,355000.0
4.0,2.75,2475,2.0,0,0,2475,0,2014,319900.0
3.0,3.5,1600,2.0,0,0,1240,360,2006,460000.0
2.0,1.0,1290,2.0,0,0,1290,0,2008,305000.0
3.0,2.5,1608,2.0,0,0,1608,0,2012,280000.0
2.0,2.25,1300,2.0,0,0,1010,290,2011,394950.0
4.0,3.5,2530,2.0,0,0,1850,680,2014,382000.0
3.0,2.5,1390,3.0,0,0,1390,0,2008,560000.0
3.0,2.25,1640,3.0,0,0,1640,0,2014,772000.0
4.0,2.5,2229,2.0,0,0,2229,0,2012,324950.0
3.0,2.5,1790,2.0,0,0,1790,0,2010,530000.0
3.0,2.25,990,2.5,0,0,880,110,2009,384000.0
5.0,2.75,3240,2.0,0,0,3240,0,2013,719950.0
2.0,2.5,1280,2.0,0,0,1060,220,2006,319950.0
3.0,2.5,1610,2.0,0,0,1610,0,2006,292000.0
6.0,3.5,3670,2.0,0,0,2410,1260,2008,1500000.0
2.0,2.5,1150,3.0,0,0,1150,0,2008,425000.0
5.0,3.75,3760,2.0,0,0,2780,980,2014,799950.0
2.0,2.5,1320,2.0,0,0,990,330,2014,499000.0
4.0,2.75,2700,2.0,0,0,2700,0,2012,572000.0
2.0,2.0,1480,3.0,0,0,1480,0,2008,459000.0
3.0,2.25,1410,3.0,0,0,1410,0,2014,529500.0
4.0,2.5,3135,2.0,0,0,3135,0,2005,374500.0
3.0,2.5,1480,2.0,0,0,1280,200,2007,584000.0
4.0,4.5,4020,2.0,0,0,4020,0,2007,1898000.0
2.0,2.25,1060,2.0,0,0,940,120,2006,505000.0
2.0,2.5,1950,3.0,0,0,1950,0,2009,565000.0
4.0,2.75,3340,2.0,0,0,3340,0,2011,799000.0
3.0,2.5,1570,2.5,0,0,1240,330,2007,547000.0
3.0,2.5,1930,2.0,0,0,1930,0,2014,550000.0
3.0,2.0,1590,1.0,0,0,1060,530,1996,250000.0
4.0,4.5,3720,2.0,0,0,3720,0,2014,960000.0
4.0,4.25,4470,2.0,0,1,3230,1240,2010,2950000.0
2.0,1.0,1290,2.0,0,0,1030,260,2005,441000.0
3.0,2.25,1489,2.0,0,0,1489,0,2012,265000.0
3.0,2.5,2075,1.0,0,0,2075,0,2012,430000.0
3.0,2.5,1413,2.0,0,0,1413,0,2011,286800.0
3.0,2.5,1300,2.0,0,0,880,420,2008,375000.0
3.0,3.25,1480,2.0,0,0,1180,300,2013,312500.0
4.0,2.75,3320,2.0,0,0,3320,0,2012,850000.0
3.0,2.25,1530,2.0,0,0,1116,414,2007,390500.0
3.0,2.5,1180,3.0,0,0,1180,0,2010,455000.0
2.0,2.0,1190,2.0,0,0,800,390,2009,455000.0
3.0,2.25,1300,3.0,0,0,1300,0,2008,515000.0
3.0,3.5,1710,2.0,0,0,1400,310,2013,362500.0
3.0,2.5,2390,2.0,0,0,2390,0,2007,460000.0
4.0,3.5,3510,2.0,0,0,2750,760,2010,540000.0
3.0,1.75,1140,2.0,0,0,1140,0,2014,230000.0
2.0,2.5,1320,2.0,0,0,1180,140,2007,425000.0
5.0,3.0,2100,1.0,0,0,1200,900,2007,298450.0
4.0,2.5,2400,2.0,0,0,2400,0,2004,344000.0
3.0,2.5,1408,3.0,0,0,1408,0,2005,416286.0
4.0,2.5,2560,2.0,0,0,2560,0,2013,379500.0
2.0,2.5,1260,3.0,0,0,1260,0,2005,350000.0
2.0,1.75,1290,2.0,0,0,1290,0,2014,258800.0
4.0,2.5,2730,2.0,0,0,2730,0,2008,620000.0
2.0,2.5,1630,2.0,0,0,1280,350,2009,295000.0
4.0,2.75,3530,2.0,0,0,3530,0,2014,908990.0
4.0,2.5,2714,2.0,0,0,2714,0,2014,485230.0
3.0,2.25,1630,2.0,0,0,1630,0,2005,475000.0
5.0,3.25,5790,2.0,0,3,4430,1360,2014,1240420.0
3.0,3.0,2230,2.5,0,0,1850,380,2013,635000.0
3.0,2.5,1380,2.0,0,0,1160,220,2012,350000.0
3.0,3.5,1320,3.0,0,0,1320,0,2010,345000.0
2.0,2.0,1490,3.0,0,0,1490,0,2014,700000.0
3.0,2.25,1280,2.0,0,0,1080,200,2008,490000.0
5.0,4.0,3870,2.0,0,0,3870,0,2014,1299890.0
2.0,2.5,1280,2.0,0,0,1080,200,2009,579000.0
3.0,1.5,1300,2.0,0,0,1120,180,2007,552500.0
4.0,2.75,2170,2.0,0,0,2170,0,2012,467000.0
4.0,2.25,1763,2.0,0,0,1763,0,2012,305000.0
2.0,1.5,1020,2.0,0,0,1020,0,2004,212000.0
4.0,2.5,1840,2.0,0,0,1840,0,2010,429000.0
3.0,2.0,1820,3.0,0,0,1820,0,2014,479950.0
3.0,3.5,2670,2.0,0,0,1870,800,2014,825000.0
6.0,6.5,6260,2.0,0,0,4840,1420,2007,1180000.0
3.0,2.25,1400,2.0,0,0,1400,0,2012,250000.0
2.0,1.5,1160,2.0,0,0,1160,0,1982,289000.0
3.0,2.5,1400,2.0,0,0,1400,0,2013,265000.0
3.0,2.5,1232,3.0,0,0,1232,0,2007,344000.0
4.0,2.75,2700,2.0,0,0,2100,600,1910,749000.0
4.0,2.5,2550,2.0,0,0,2550,0,2007,492000.0
4.0,2.5,3260,2.0,0,0,3260,0,2008,552500.0
2.0,2.5,1680,2.0,0,0,1120,560,2014,653500.0
4.0,3.25,2630,2.0,0,0,2030,600,2006,855000.0
3.0,1.5,1260,2.0,0,0,1260,0,1999,333000.0
4.0,2.5,2550,2.0,0,0,2550,0,2009,415000.0
4.0,3.25,3450,2.0,0,0,3450,0,2008,445000.0
3.0,2.5,1550,2.0,0,0,1550,0,2009,273500.0
4.0,2.5,4150,2.0,0,0,4150,0,2014,969990.0
5.0,3.5,3900,2.0,0,0,2650,1250,2014,1200000.0
3.0,3.25,1550,3.0,0,0,1550,0,2006,430000.0
4.0,2.5,2130,2.0,0,0,2130,0,2014,392000.0
4.0,2.5,2890,2.0,0,0,2890,0,2005,795000.0
3.0,2.5,1220,2.0,0,0,1010,210,2008,457000.0
4.0,2.5,2502,2.0,0,0,2502,0,2013,453000.0
3.0,2.0,1340,3.0,0,0,1340,0,2008,376000.0
4.0,2.5,2350,2.0,0,0,2350,0,2014,469995.0
3.0,2.5,1810,2.0,0,0,1810,0,2008,540000.0
4.0,2.5,3310,2.0,0,0,3310,0,2012,555000.0
3.0,2.0,1620,1.0,0,0,590,1030,2006,445000.0
2.0,2.0,1070,2.0,0,0,720,350,2008,256950.0
4.0,2.5,2230,2.0,0,0,2230,0,2011,297000.0
4.0,2.5,1970,2.0,0,0,1970,0,2005,320000.0
5.0,4.5,4600,2.0,0,0,3200,1400,2006,805000.0
4.0,2.75,3110,2.0,0,0,3110,0,2014,799990.0
4.0,2.5,3490,2.0,0,0,2850,640,2007,680000.0
3.0,2.5,1600,2.0,0,0,1600,0,2007,395000.0
3.0,2.5,1960,2.0,0,0,1960,0,2010,732000.0
2.0,2.5,1000,2.0,0,0,990,10,2004,163800.0
2.0,2.5,1000,2.0,0,0,990,10,2004,220000.0
2.0,2.0,1500,3.0,0,0,1500,0,1999,308625.0
3.0,2.5,2424,2.0,0,0,2424,0,2014,375000.0
4.0,2.5,2303,2.0,0,0,2303,0,2006,300000.0
3.0,2.5,1880,2.0,0,0,1880,0,2009,284000.0
2.0,2.0,1210,2.0,0,0,780,430,2014,610000.0
4.0,3.25,3720,2.0,0,0,3720,0,2012,955000.0
4.0,2.75,3610,2.0,0,0,3610,0,2014,982000.0
3.0,1.5,1360,3.0,0,0,1360,0,2008,359000.0
5.0,2.5,2590,2.0,0,0,2590,0,2014,779380.0
5.0,3.25,4390,2.0,0,0,4390,0,2007,1510000.0
3.0,3.0,2290,2.5,0,0,1890,400,2014,635000.0
4.0,3.75,3880,2.5,0,0,3880,0,2007,1060000.0
3.0,2.5,1350,3.0,0,0,1270,80,2006,389500.0
5.0,2.5,2170,2.0,0,0,2170,0,2014,359800.0
3.0,3.0,1296,3.0,0,0,1296,0,2009,399950.0
3.0,3.25,1530,2.0,0,0,1140,390,2013,320000.0
3.0,2.5,1489,2.0,0,0,1489,0,2014,255900.0
4.0,2.5,2130,2.0,0,0,2130,0,2014,380000.0
3.0,2.75,1430,2.0,0,0,1130,300,2009,580000.0
5.0,3.75,2380,1.0,0,0,1430,950,2008,545000.0
3.0,2.5,1420,2.0,0,0,1140,280,2008,451300.0
4.0,3.25,3450,2.0,0,0,3450,0,2014,852880.0
4.0,2.5,1914,2.0,0,0,1914,0,2009,305000.0
2.0,1.5,988,3.0,0,0,988,0,2007,295000.0
3.0,2.25,1584,2.0,0,0,1584,0,2012,261000.0
4.0,2.5,2630,2.0,0,0,2630,0,2001,560000.0
4.0,3.25,3520,2.0,0,0,3520,0,2012,795000.0
4.0,2.5,2380,2.0,0,0,2380,0,2006,384950.0
3.0,1.75,1410,3.0,0,0,1410,0,2012,500000.0
4.0,3.5,3220,2.0,0,0,3220,0,2013,640000.0
4.0,3.25,3266,2.0,0,0,3266,0,2014,418000.0
3.0,2.0,2550,2.0,0,0,2550,0,2007,799000.0
4.0,3.5,3828,2.5,0,0,3828,0,2014,552900.0
3.0,2.25,1670,3.0,0,0,1670,0,2014,539950.0
4.0,2.5,3056,2.0,0,0,3056,0,2014,524225.0
2.0,1.5,1000,3.0,0,0,1000,0,2005,424950.0
3.0,3.25,1530,2.0,0,0,1200,330,2007,560000.0
5.0,3.0,3490,2.0,0,0,3490,0,2009,715000.0
5.0,2.5,2760,2.0,0,0,2760,0,2006,300000.0
3.0,2.5,1440,2.0,0,0,1440,0,2005,405000.0
3.0,3.0,1370,3.0,0,0,1370,0,2009,327000.0
6.0,4.0,3180,2.0,0,0,3180,0,2014,859950.0
4.0,3.0,2720,2.0,0,0,2720,0,2008,560000.0
3.0,2.5,1800,2.0,0,0,1800,0,2011,379900.0
3.0,2.5,3220,2.0,0,0,3220,0,2008,625000.0
3.0,2.5,2370,2.0,0,0,2370,0,2014,398096.0
3.0,2.5,1410,2.0,0,0,1180,230,2007,315000.0
4.0,3.5,3640,2.0,0,0,3640,0,2014,939000.0
3.0,2.5,1920,2.0,0,0,1920,0,2003,674000.0
4.0,2.5,2267,2.0,0,0,2267,0,2014,306000.0
5.0,4.75,5780,2.0,0,0,4260,1520,2006,2321000.0
2.0,1.0,1131,3.0,0,0,1131,0,2011,394950.0
3.0,3.5,2940,2.0,0,0,2940,0,2014,914154.0
3.0,2.5,2180,2.0,0,0,2180,0,2010,496000.0
3.0,2.25,1400,2.0,0,0,940,460,2009,430100.0
4.0,2.5,2680,2.0,0,0,2680,0,2013,449990.0
4.0,2.5,2680,2.0,0,0,2680,0,2013,502000.0
3.0,2.5,1300,2.0,0,0,1300,0,2005,310000.0
4.0,3.5,2796,2.5,0,0,2796,0,2013,349950.0
2.0,1.75,1460,2.0,0,0,1000,460,2008,625000.0
4.0,3.5,4210,2.0,0,3,3260,950,2014,1054710.0
4.0,2.75,2330,2.0,0,0,2330,0,2005,680000.0
4.0,3.5,3930,2.0,0,1,2820,1110,2013,828950.0
3.0,2.5,1608,2.0,0,0,1608,0,2014,274950.0
2.0,2.25,1610,2.0,0,0,1610,0,1979,293000.0
4.0,3.5,3200,2.0,0,0,2670,530,2007,795000.0
4.0,2.5,1710,2.0,0,0,1710,0,2014,282900.0
5.0,3.75,3050,2.0,0,0,3050,0,2014,909950.0
4.0,3.5,3560,2.0,0,0,3560,0,2014,922755.0
4.0,2.5,2650,2.0,0,0,2650,0,2006,424000.0
3.0,2.5,3490,2.0,0,0,2590,900,2009,630000.0
4.0,3.25,4140,2.0,0,0,4140,0,2007,810000.0
3.0,2.0,1670,1.0,0,0,1670,0,2014,256703.0
3.0,2.5,1720,2.0,0,0,1720,0,2010,386380.0
2.0,2.0,1510,1.0,0,0,1510,0,2010,485000.0
3.0,2.25,1450,2.0,0,0,1450,0,2010,275000.0
4.0,2.5,1812,2.0,0,0,1812,0,2011,370000.0
2.0,2.25,1060,2.0,0,0,940,120,2005,499950.0
3.0,2.5,1600,3.0,0,0,1600,0,2009,502000.0
3.0,3.25,1530,2.0,0,0,1280,250,2005,654000.0
4.0,2.25,2070,3.0,0,0,1500,570,2013,575000.0
4.0,2.5,3630,2.0,0,0,3630,0,2008,500000.0
3.0,2.5,2140,2.0,0,0,1960,180,2005,554000.0
4.0,1.75,2010,1.0,0,0,1150,860,1960,360000.0
4.0,2.75,2630,2.0,0,0,2630,0,2015,619990.0
4.0,2.5,2233,2.0,0,0,2233,0,2012,317500.0
4.0,2.75,2990,2.0,0,0,2990,0,2014,564950.0
2.0,1.25,1240,2.0,0,0,1240,0,2014,545000.0
3.0,2.5,2230,2.0,0,0,2230,0,2006,333700.0
3.0,3.25,3700,2.0,0,0,2280,1420,1998,1480000.0
4.0,3.0,2290,2.0,0,0,2290,0,2012,530000.0
2.0,1.5,950,3.0,0,0,950,0,2006,396000.0
2.0,1.75,1120,2.0,0,0,1120,0,2012,305000.0
5.0,3.5,2420,2.0,0,0,2420,0,2013,380000.0
4.0,2.5,1714,2.0,0,0,1714,0,2010,305000.0
4.0,2.5,2230,2.0,0,0,2230,0,2011,440000.0
4.0,3.0,2530,2.0,0,0,2530,0,2013,459000.0
3.0,3.5,1550,2.0,0,0,1160,390,2005,530000.0
4.0,2.75,3110,2.0,0,0,3110,0,2012,600000.0
3.0,3.0,2100,2.0,0,0,1660,440,2008,515000.0
4.0,2.5,2150,2.0,0,0,2150,0,2007,275000.0
3.0,1.75,1630,2.0,0,0,1020,610,2014,540000.0
3.0,2.5,2230,2.0,0,0,2230,0,2005,445000.0
3.0,2.5,1320,3.0,0,0,1320,0,2009,285000.0
3.0,2.5,1590,2.0,0,0,1060,530,2010,480000.0
5.0,3.25,2610,2.0,0,0,2080,530,2005,440000.0
3.0,2.5,1440,2.0,0,0,1440,0,2008,287450.0
4.0,2.5,2630,2.0,0,0,2630,0,2006,507950.0
3.0,3.5,3390,2.0,0,0,3040,350,2012,750000.0
3.0,1.5,1400,3.0,0,0,1400,0,2007,425000.0
3.0,3.5,1900,2.0,0,0,1520,380,2009,420000.0
3.0,2.5,1350,3.0,0,0,1270,80,2006,394950.0
4.0,3.25,3420,2.0,0,2,3030,390,2012,635000.0
3.0,2.5,2150,2.0,0,0,1330,820,1995,513000.0
4.0,2.5,2110,2.0,0,0,2110,0,2012,380000.0
4.0,3.25,3810,1.0,0,1,2680,1130,2007,1130000.0
5.0,3.0,2870,2.0,0,0,2090,780,2007,540000.0
2.0,2.25,1240,2.0,0,0,1150,90,2009,352499.0
4.0,3.5,3610,2.0,0,0,2370,1240,2008,603000.0
4.0,2.5,2310,2.0,0,0,2310,0,2013,685000.0
4.0,3.0,1930,1.0,0,0,1200,730,2006,330675.0
3.0,3.0,1390,2.0,0,0,1140,250,2006,275000.0
3.0,2.5,1578,2.0,0,0,1578,0,2010,259950.0
3.0,2.0,1720,1.0,0,0,1720,0,2011,441000.0
5.0,3.75,4700,2.0,0,0,2930,1770,2006,1135000.0
3.0,3.5,1970,2.0,0,0,1680,290,2007,590000.0
3.0,2.25,1460,2.0,0,0,1050,410,2012,497000.0
3.0,2.5,1930,2.0,0,0,1930,0,2014,345500.0
3.0,2.25,1300,2.0,0,0,1000,300,2006,562500.0
3.0,2.25,1445,2.0,0,0,1300,145,2005,355000.0
2.0,2.25,860,2.0,0,0,860,0,2009,345000.0
3.0,2.5,3040,2.0,0,0,3040,0,2007,478000.0
3.0,2.5,2424,2.0,0,0,2424,0,2014,391500.0
2.0,1.5,1084,2.0,0,0,1084,0,1976,265000.0
3.0,2.5,2510,2.0,0,0,2510,0,2005,395000.0
2.0,1.5,1220,3.0,0,0,1220,0,2006,286308.0
2.0,2.25,1280,2.0,0,0,1080,200,2009,370000.0
5.0,3.5,3740,2.0,0,0,2860,880,2014,1079000.0
3.0,2.5,1852,2.0,0,0,1852,0,2014,298900.0
4.0,2.5,2580,2.0,0,0,2580,0,2007,775000.0
4.0,3.5,3190,2.0,0,0,3190,0,2010,790000.0
3.0,2.5,3400,2.0,0,0,2300,1100,2014,1050000.0
2.0,1.5,1090,2.0,0,0,1090,0,1982,249000.0
3.0,2.0,2360,1.0,0,0,2360,0,2011,348000.0
5.0,2.5,2460,2.0,0,0,2460,0,2011,358000.0
5.0,2.5,2025,2.0,0,0,2025,0,2007,260000.0
4.0,3.0,4410,2.0,0,0,3400,1010,2006,765000.0
3.0,2.5,2810,2.0,0,0,2810,0,2005,739000.0
5.0,3.5,4490,2.0,0,0,3200,1290,2006,890000.0
4.0,2.5,3070,2.0,0,0,3070,0,2006,462000.0
4.0,2.5,1984,1.0,0,0,1564,420,1962,380000.0
5.0,3.5,4750,2.0,0,2,3350,1400,2013,770000.0
4.0,3.25,2760,2.0,0,0,1900,860,2014,641000.0
4.0,4.0,4360,2.5,1,4,3940,420,2007,2300000.0
4.0,2.5,3060,1.5,0,0,3060,0,2008,369000.0
4.0,3.0,2770,2.0,0,0,2180,590,2014,1112000.0
5.0,2.5,2990,2.0,0,0,2990,0,2015,357000.0
3.0,2.75,1540,2.0,0,0,1230,310,2002,650000.0
3.0,2.5,1400,3.5,0,0,1400,0,2007,563500.0
3.0,2.5,1680,2.0,0,0,1680,0,2007,345000.0
3.0,2.0,2260,1.0,0,0,2260,0,2012,479950.0
4.0,3.5,3400,2.0,0,0,3400,0,2012,660000.0
4.0,2.5,2930,2.0,0,0,2760,170,2007,800000.0
3.0,2.0,1239,1.0,0,0,1239,0,2009,253101.0
3.0,3.5,2100,2.0,0,0,1450,650,2011,555000.0
4.0,1.0,1200,1.5,0,0,1200,0,1933,240000.0
4.0,1.0,1200,1.5,0,0,1200,0,1933,380000.0
2.0,1.5,680,2.0,0,0,680,0,2005,239000.0
4.0,3.25,2690,2.0,0,0,2060,630,2014,760000.0
4.0,2.5,2750,2.0,0,0,2750,0,2011,430000.0
3.0,2.5,2450,2.0,0,0,2450,0,2010,660000.0
4.0,2.5,2620,2.0,0,0,2620,0,2014,399963.0
2.0,2.0,1130,2.0,0,0,800,330,2007,411000.0
4.0,2.75,2790,2.0,0,0,2790,0,2014,483453.0
3.0,2.0,1820,3.0,0,0,1820,0,2014,469950.0
4.0,2.75,2910,2.0,0,0,2910,0,2013,504058.0
4.0,2.5,2568,2.0,0,0,2568,0,2014,425996.0
4.0,2.75,3090,2.0,0,0,3090,0,2010,760005.0
2.0,2.0,1460,2.0,0,0,950,510,2014,699999.0
3.0,2.5,2010,2.0,0,0,1340,670,2014,749950.0
4.0,2.5,2610,2.0,0,0,2610,0,2006,674600.0
2.0,1.5,960,2.0,0,0,920,40,2008,450000.0
3.0,2.5,1528,2.0,0,0,1528,0,2011,272000.0
2.0,1.5,1310,2.0,0,0,1120,190,2006,450000.0
3.0,2.25,1760,3.0,0,0,1760,0,2015,643950.0
3.0,2.5,1420,2.0,0,0,1310,110,2007,290000.0
3.0,2.5,1650,3.0,0,0,1650,0,2007,378000.0
3.0,2.5,2320,1.0,0,0,2320,0,2008,728050.0
4.0,2.5,2628,2.0,0,0,2628,0,2014,499160.0
4.0,2.5,2520,2.0,0,0,2520,0,2009,536000.0
5.0,3.5,2880,2.0,0,0,2260,620,2012,419900.0
3.0,2.25,1440,3.0,0,0,1440,0,2014,469000.0
3.0,2.5,2185,2.0,0,0,2185,0,2009,374000.0
4.0,1.5,1500,2.0,0,0,1500,0,2014,182568.0
3.0,2.5,1769,2.0,0,0,1769,0,2012,334888.0
4.0,4.0,3650,2.0,0,3,3330,320,2013,799900.0
4.0,2.5,2160,2.0,0,0,2160,0,2010,383000.0
3.0,2.5,1820,2.0,0,0,1820,0,1999,580000.0
3.0,2.5,2370,2.0,0,0,2370,0,2014,351999.0
3.0,3.0,3180,2.0,0,2,2240,940,2008,1325000.0
3.0,2.5,1780,2.0,0,0,1780,0,2011,312000.0
4.0,3.5,2650,2.0,0,0,2230,420,2011,674950.0
5.0,2.75,3300,2.0,0,0,3300,0,2007,1105000.0
2.0,2.5,1160,3.0,0,0,1160,0,2007,415000.0
3.0,3.0,3460,2.0,0,0,2850,610,2007,1250000.0
3.0,2.5,1390,2.0,0,0,1390,0,2009,208800.0
2.0,2.5,1260,3.0,0,0,1260,0,2006,452000.0
5.0,2.75,2940,2.0,0,0,2760,180,2010,837000.0
5.0,3.5,3190,2.0,0,0,2430,760,2013,780000.0
4.0,3.5,3930,2.0,0,0,3310,620,2007,1485000.0
5.0,3.75,3570,2.0,0,0,3570,0,2014,1600000.0
3.0,2.5,2420,2.0,0,0,2420,0,2014,369946.0
3.0,2.75,3400,2.0,0,2,2470,930,2009,530000.0
4.0,2.5,2478,2.0,0,0,2478,0,2012,386000.0
4.0,2.5,3070,2.0,0,2,1970,1100,2009,1900000.0
4.0,3.5,3200,2.0,0,2,2500,700,2013,735000.0
5.0,3.25,5790,2.0,0,3,4430,1360,2014,1750000.0
3.0,2.25,1590,3.0,0,0,1590,0,2014,489950.0
3.0,3.0,1730,2.0,0,0,1440,290,2008,357500.0
4.0,2.5,2303,2.0,0,0,2303,0,2013,329995.0
3.0,2.5,1790,2.0,0,0,1790,0,2013,414000.0
3.0,3.5,2490,2.0,0,0,1720,770,2005,533500.0
4.0,2.5,2669,2.0,0,0,2669,0,2014,402395.0
4.0,3.25,2610,2.0,0,0,2160,450,2008,725000.0
6.0,5.25,6160,2.0,0,0,4040,2120,2007,1275000.0
2.0,1.75,1290,2.0,0,0,1290,0,2014,239800.0
5.0,3.5,3560,2.0,0,0,2810,750,2013,616950.0
4.0,3.25,4360,2.0,0,3,3400,960,2007,1258000.0
3.0,2.25,1230,2.0,0,0,1080,150,2009,435000.0
4.0,3.25,3640,2.0,0,0,3640,0,2005,925000.0
2.0,2.5,1780,3.0,0,0,1780,0,1981,631500.0
3.0,1.5,1140,3.0,0,0,1140,0,2005,399995.0
3.0,2.0,1270,3.0,0,0,1270,0,2006,369950.0
5.0,3.5,2780,2.0,0,0,2180,600,2005,475000.0
4.0,2.5,1912,2.0,0,0,1912,0,2012,353000.0
4.0,2.5,2300,2.0,0,0,2300,0,2006,329950.0
3.0,2.5,2828,2.0,0,0,2828,0,2013,367000.0
4.0,2.5,2425,2.0,0,0,2425,0,2013,447500.0
4.0,3.25,3730,2.0,0,0,2760,970,2015,595000.0
1.0,1.0,730,1.0,0,0,730,0,2009,325000.0
2.0,2.5,1990,3.0,0,0,1780,210,2005,690000.0
3.0,2.5,1300,2.0,0,0,880,420,2008,329950.0
4.0,2.5,2560,2.0,0,0,2560,0,2014,399500.0
5.0,2.5,2450,2.0,0,0,2450,0,2007,555000.0
2.0,1.5,1440,2.0,0,0,1100,340,2011,427000.0
3.0,2.25,1140,3.0,0,0,1140,0,2007,375000.0
2.0,1.5,1110,2.0,0,0,930,180,2005,499000.0
3.0,2.5,2620,2.0,0,0,2620,0,2013,750000.0
3.0,2.5,1690,2.0,0,0,1410,280,2014,336900.0
2.0,2.75,1950,3.0,0,0,1950,0,2009,555000.0
4.0,3.5,3530,2.0,0,0,3530,0,2007,1275000.0
4.0,3.5,3310,2.0,0,0,2290,1020,2014,999950.0
5.0,3.0,2620,2.0,0,0,2620,0,2009,975000.0
3.0,2.25,1350,2.0,0,0,1350,0,2010,299000.0
2.0,2.5,1741,2.0,0,0,1446,295,2007,479000.0
3.0,2.5,1650,3.0,0,0,1650,0,2007,428000.0
3.0,2.5,1890,2.0,0,0,1890,0,2012,409000.0
3.0,3.0,1950,3.0,0,0,1610,340,2009,798500.0
4.0,3.5,4490,2.0,0,0,3390,1100,2006,689000.0
6.0,2.25,3206,2.0,0,0,3206,0,2012,375000.0
4.0,3.5,4130,2.0,0,2,4130,0,2011,775000.0
5.0,3.0,2800,2.0,0,0,2800,0,2014,639983.0
4.0,3.0,1984,2.0,0,0,1984,0,2010,300000.0
4.0,2.5,2750,2.0,0,0,2750,0,2014,627000.0
3.0,2.75,1740,1.0,0,0,1740,0,2010,275000.0
4.0,2.25,1800,2.0,0,0,1800,0,2014,352800.0
3.0,2.25,1540,3.0,0,0,1540,0,2008,565000.0
4.0,2.25,2030,2.0,0,0,1610,420,2015,765000.0
4.0,2.5,3310,2.0,0,0,3310,0,2007,644000.0
3.0,1.5,1270,3.0,0,0,1270,0,2007,461000.0
5.0,2.5,2406,2.0,0,0,2406,0,2006,270500.0
2.0,2.25,1540,3.0,0,0,1540,0,2007,640000.0
4.0,2.5,2820,2.0,0,0,2820,0,2013,457000.0
5.0,2.5,2540,2.0,0,0,2540,0,2014,355000.0
2.0,2.25,1230,3.0,0,0,1230,0,2007,356000.0
4.0,2.5,1900,2.0,0,0,1900,0,2014,425000.0
5.0,2.75,2920,2.0,0,0,2920,0,2007,562500.0
3.0,2.5,1450,2.0,0,0,940,510,2008,460000.0
4.0,3.0,5370,2.0,0,0,3500,1870,2005,790000.0
3.0,2.0,1270,3.0,0,0,1270,0,2006,401000.0
3.0,2.5,2550,2.0,0,0,2550,0,2014,1095000.0
4.0,3.0,3070,2.0,0,0,3070,0,2007,850000.0
3.0,2.25,1450,2.0,0,0,1450,0,2010,274500.0
5.0,3.5,4230,2.0,0,0,4230,0,2008,1940000.0
4.0,2.5,3480,2.0,0,0,3480,0,2003,808000.0
3.0,2.25,1490,2.0,0,0,1220,270,2009,312000.0
3.0,2.25,1200,3.0,0,0,1200,0,2005,320000.0
3.0,2.5,2150,2.0,0,0,2150,0,2013,410000.0
3.0,3.5,3690,2.0,0,0,3690,0,2001,725000.0
4.0,2.5,1900,2.0,0,0,1900,0,2007,335000.0
4.0,3.25,1690,2.0,0,0,1320,370,2014,519990.0
4.0,2.75,2790,2.0,0,0,2790,0,2013,533112.0
3.0,2.0,1936,2.0,0,0,1936,0,2014,274900.0
2.0,2.25,1150,2.0,0,0,1150,0,2013,325000.0
4.0,2.5,2040,2.0,0,0,2040,0,2011,350000.0
4.0,2.5,2470,2.0,0,0,2470,0,2006,550000.0
4.0,2.5,1890,2.0,0,0,1890,0,2014,311850.0
3.0,2.5,1626,2.5,0,0,1419,207,2007,526000.0
4.0,2.5,2250,2.0,0,0,2250,0,2012,375000.0
3.0,2.25,1350,2.0,0,0,1160,190,2007,299999.0
3.0,2.5,1460,2.0,0,0,1200,260,2008,436000.0
3.0,2.5,2056,2.0,0,0,2056,0,2014,303000.0
2.0,2.5,1160,2.0,0,0,1040,120,2012,525000.0
3.0,3.0,1384,2.0,0,0,1144,240,2006,575000.0
2.0,1.5,1100,3.0,0,0,1100,0,2008,420000.0
3.0,2.5,2456,2.0,0,0,2456,0,2012,329950.0
4.0,4.25,4500,2.0,0,3,2630,1870,2009,1830000.0
4.0,3.25,3780,1.0,0,1,2240,1540,2006,1175000.0
2.0,2.5,1320,2.0,0,0,990,330,2014,499950.0
4.0,3.0,5940,2.0,0,4,4950,990,2004,1149000.0
3.0,2.0,1650,1.5,0,0,1650,0,2009,400000.0
3.0,3.0,1670,1.0,0,0,1670,0,2014,246950.0
3.0,3.25,1610,2.0,0,0,1220,390,2005,630000.0
5.0,2.75,3370,2.0,0,0,3370,0,2006,561000.0
4.0,2.5,2660,2.0,0,0,2660,0,2010,287000.0
3.0,3.25,1690,2.0,0,0,1380,310,2008,600000.0
3.0,2.25,1620,3.0,0,0,1620,0,2014,490000.0
3.0,1.75,1300,2.0,0,0,840,460,2011,330000.0
4.0,2.5,1610,2.0,0,0,1610,0,2013,286950.0
3.0,3.25,3530,2.0,0,0,2660,870,2015,1550000.0
4.0,2.5,3550,2.0,0,0,3550,0,2007,880000.0
3.0,3.0,1730,3.0,0,0,1730,0,2014,577450.0
5.0,2.75,2400,2.0,0,0,2400,0,2011,405000.0
3.0,2.5,1420,3.0,0,0,1420,0,2014,510000.0
2.0,1.5,1220,2.5,0,0,1110,110,2008,465000.0
4.0,2.25,2360,2.0,0,0,2360,0,2013,1300000.0
4.0,3.5,3990,2.0,0,3,2930,1060,2007,609000.0
3.0,2.5,1260,3.0,0,0,1260,0,2004,336000.0
3.0,2.5,1580,2.0,0,0,1580,0,2013,375000.0
3.0,2.5,1760,2.0,0,0,1760,0,2005,294500.0
5.0,3.5,3420,2.0,0,0,2520,900,2008,925000.0
5.0,2.75,2870,2.0,0,0,2870,0,2006,730000.0
4.0,2.5,1934,2.0,0,0,1934,0,2013,280000.0
3.0,1.5,1220,3.0,0,0,1220,0,2014,500000.0
3.0,2.75,2450,2.0,0,0,2450,0,2013,605000.0
3.0,3.25,1860,3.0,0,0,1860,0,2007,379950.0
3.0,2.5,1500,3.0,0,2,1110,390,2008,605000.0
2.0,1.75,1570,3.0,0,0,1570,0,2007,720000.0
3.0,2.0,1280,2.0,0,0,1040,240,2014,549900.0
3.0,2.5,3192,2.0,0,0,3192,0,2014,427000.0
3.0,2.5,1690,3.0,0,0,1420,270,2005,492000.0
2.0,2.5,1590,2.0,0,0,1590,0,2014,419190.0
3.0,2.5,2870,2.0,0,0,2870,0,2012,650000.0
4.0,2.5,2580,2.0,0,0,2580,0,2005,379950.0
4.0,2.75,1830,2.0,0,0,1830,0,2012,269800.0
4.0,2.5,2927,2.0,0,0,2927,0,2011,407000.0
3.0,1.5,1320,3.0,0,0,1320,0,2008,580000.0
3.0,2.5,1720,2.0,0,0,1720,0,2011,389700.0
2.0,1.0,828,1.0,0,0,828,0,1968,110000.0
3.0,1.5,1040,2.0,0,0,900,140,2015,230000.0
4.0,2.75,2790,2.0,0,0,2790,0,2014,533380.0
3.0,2.5,1410,2.0,0,0,960,450,2014,295500.0
4.0,4.5,4040,2.0,0,0,3220,820,2006,860000.0
4.0,3.5,3370,2.0,0,0,2750,620,2007,812000.0
3.0,2.5,1660,2.0,0,0,1660,0,2009,324500.0
2.0,1.75,910,1.0,0,0,910,0,2004,193000.0
3.0,2.25,1280,3.0,0,0,1280,0,2005,355000.0
4.0,2.75,2360,2.0,0,0,2360,0,2008,525000.0
3.0,2.5,2529,2.0,0,0,2529,0,2012,370950.0
4.0,3.5,4700,1.0,0,2,2660,2040,2002,1242000.0
3.0,2.5,2780,1.0,0,0,2780,0,2006,950000.0
4.0,2.75,3540,2.0,0,0,3540,0,2014,888990.0
3.0,2.5,1580,2.0,0,2,1080,500,2014,705000.0
3.0,2.5,1700,2.0,0,0,1700,0,2014,268000.0
3.0,2.5,1600,2.0,0,0,1600,0,2013,305450.0
2.0,1.75,1410,1.5,0,0,900,510,2011,399900.0
3.0,1.5,1580,3.0,0,0,1580,0,2014,495000.0
3.0,3.5,3940,2.0,0,0,3940,0,2014,857326.0
5.0,2.75,4450,2.0,0,0,3650,800,2014,845950.0
4.0,2.5,2009,2.0,0,0,2009,0,2014,303210.0
6.0,5.0,2732,2.0,0,0,2732,0,2009,343000.0
3.0,2.5,2090,2.0,0,0,2090,0,2005,300000.0
2.0,2.5,980,3.0,0,0,980,0,2008,334900.0
5.0,3.5,2815,2.0,0,0,2815,0,2012,477500.0
4.0,2.5,3170,2.0,0,0,3170,0,2008,820000.0
5.0,3.25,3030,2.0,0,0,2150,880,2014,580000.0
2.0,2.5,1280,2.0,0,0,1060,220,2006,350000.0
3.0,2.5,2030,3.0,0,0,1970,60,2007,910000.0
3.0,2.5,2490,2.5,0,0,2490,0,2012,414000.0
3.0,2.5,3030,2.0,0,0,3030,0,2009,525000.0
2.0,2.5,1470,3.0,0,3,1470,0,2008,650000.0
3.0,2.25,1620,2.5,0,0,1540,80,2012,450000.0
4.0,3.0,5520,2.0,0,3,3570,1950,2008,1270000.0
3.0,3.5,3200,2.0,0,0,3200,0,2007,699000.0
4.0,2.5,2580,2.0,0,0,2580,0,2013,899000.0
4.0,3.0,2050,2.0,0,0,2050,0,2014,353500.0
3.0,2.5,2430,2.0,0,0,2430,0,2011,485000.0
4.0,3.25,3060,2.0,0,0,2300,760,2014,782900.0
2.0,2.0,1540,2.0,0,0,1540,0,2008,529000.0
3.0,3.25,1310,2.0,0,0,1060,250,2008,514700.0
3.0,2.5,1800,2.0,0,0,1800,0,2014,409316.0
3.0,2.5,2370,2.0,0,0,2370,0,2014,388598.0
3.0,2.25,1445,2.0,0,0,1300,145,2004,415000.0
3.0,2.25,1450,2.0,0,0,1140,310,2006,521500.0
3.0,2.5,1740,3.0,0,2,1740,0,2008,580000.0
4.0,2.5,3560,3.0,0,0,3560,0,2014,882566.0
3.0,2.75,2130,2.0,0,0,1080,1050,2010,525000.0
5.0,2.75,2980,2.0,0,0,2980,0,2007,515000.0
3.0,3.0,2840,2.0,0,0,2840,0,2014,589410.0
4.0,2.5,3420,2.0,0,0,3420,0,2009,757500.0
3.0,2.5,1660,2.0,0,0,1660,0,2013,284000.0
2.0,2.25,1150,2.0,0,0,1150,0,2013,338500.0
3.0,2.25,1410,2.0,0,0,1290,120,2005,379500.0
3.0,2.0,1420,2.5,0,0,1340,80,2007,550000.0
3.0,2.5,1860,2.0,0,0,1860,0,2010,294900.0
2.0,1.5,1340,2.0,0,0,1120,220,2008,345000.0
2.0,1.5,1530,2.0,0,0,1200,330,2005,450000.0
3.0,2.5,1509,3.0,0,0,1509,0,2014,420000.0
3.0,2.5,2350,2.0,0,0,2350,0,2013,740000.0
2.0,1.5,1010,3.0,0,0,1010,0,2007,286000.0
5.0,3.5,4495,2.0,0,0,3580,915,2013,870000.0
3.0,2.5,1580,3.0,0,0,1580,0,2009,727000.0
4.0,3.0,2750,2.0,0,0,2750,0,2012,395000.0
4.0,2.25,1890,2.0,0,0,1890,0,2005,535000.0
3.0,2.25,1320,2.0,0,0,1040,280,2007,255000.0
4.0,2.5,2150,2.0,0,0,2150,0,2006,260000.0
4.0,2.5,3340,2.0,0,0,3340,0,2014,810000.0
3.0,2.5,1850,2.0,0,0,1850,0,2010,359782.0
2.0,2.5,1950,2.0,0,0,1500,450,2012,500000.0
5.0,3.25,4240,2.0,0,0,4240,0,2014,1049990.0
4.0,3.5,2700,2.0,0,0,1920,780,2006,810000.0
5.0,4.0,3040,2.0,0,0,2280,760,2011,605000.0
4.0,2.5,2460,2.0,0,0,2460,0,2005,730000.0
4.0,2.5,2110,2.0,0,0,2110,0,2013,327000.0
2.0,1.0,780,2.0,0,0,780,0,2009,370000.0
5.0,3.5,2640,2.0,0,0,2640,0,2001,459000.0
5.0,4.0,5190,2.0,0,1,5190,0,2013,2900000.0
4.0,2.5,2420,2.0,0,0,2420,0,2013,365000.0
4.0,2.5,1987,2.0,0,0,1987,0,2011,255000.0
1.0,1.0,720,1.0,0,0,720,0,1920,375000.0
2.0,1.5,1130,2.0,0,0,1000,130,2006,375000.0
4.0,2.5,2810,2.0,0,0,2810,0,2014,518380.0
3.0,3.25,1500,2.0,0,0,1150,350,2007,346000.0
4.0,2.0,1390,3.0,0,0,1390,0,2008,302059.0
4.0,2.5,2500,2.0,0,0,2500,0,2013,575000.0
4.0,3.5,3906,2.0,0,2,3906,0,2014,549950.0
5.0,6.0,7120,2.0,0,4,5480,1640,2007,900000.0
3.0,2.5,1470,2.0,0,0,930,540,2006,397500.0
5.0,3.5,3230,2.0,0,0,3230,0,2007,1075000.0
3.0,2.5,2700,2.0,0,0,2700,0,2014,775900.0
4.0,2.5,4073,2.0,0,0,4073,0,2008,510000.0
4.0,2.5,3361,2.0,0,0,3361,0,2014,471275.0
4.0,2.25,1610,2.0,0,0,1610,0,2010,288000.0
4.0,3.5,3830,2.0,0,0,3830,0,2014,989990.0
3.0,3.25,1470,2.0,0,0,1180,290,2008,300000.0
5.0,3.0,3190,1.0,0,2,1890,1300,2013,664950.0
4.0,3.25,3250,2.0,0,0,3250,0,2014,699188.0
3.0,2.25,1490,2.0,0,0,1490,0,2009,390000.0
5.0,2.75,2900,2.0,0,0,2900,0,2008,670000.0
4.0,2.5,2540,2.0,0,0,2540,0,2005,487000.0
5.0,2.75,3360,2.0,0,0,3360,0,2014,769995.0
2.0,1.25,860,2.0,0,0,860,0,2007,321950.0
4.0,2.5,3020,2.0,0,0,3020,0,2006,613500.0
3.0,2.5,1330,3.0,0,0,1330,0,2002,300000.0
4.0,2.5,2578,2.0,0,0,2578,0,2014,400950.0
4.0,2.5,2640,2.0,0,0,2640,0,2014,389517.0
3.0,1.75,1260,2.0,0,0,810,450,2011,255000.0
3.0,2.5,1990,3.0,0,0,1990,0,2012,1080000.0
5.0,3.25,3340,2.0,0,2,2500,840,2014,637850.0
4.0,2.5,2840,2.0,0,0,2840,0,2013,636230.0
3.0,2.5,1530,3.0,0,0,1530,0,2009,375000.0
3.0,2.5,1780,3.0,0,0,1600,180,2006,586500.0
4.0,2.5,2340,2.0,0,0,1930,410,2005,544000.0
4.0,2.5,2390,2.0,0,0,2390,0,2002,425000.0
4.0,2.5,2090,2.0,0,0,2090,0,2012,374950.0
3.0,1.0,1140,1.0,0,0,1140,0,1960,294570.0
3.0,2.5,1960,2.0,0,0,1670,290,2012,300000.0
5.0,3.5,2738,2.0,0,0,2738,0,2014,395950.0
4.0,2.5,3691,2.0,0,1,3691,0,2013,800000.0
3.0,2.5,2340,2.0,0,0,2340,0,2013,439990.0
4.0,3.5,2510,2.0,0,0,1990,520,2013,680000.0
6.0,3.0,2800,2.0,0,0,2800,0,1998,677790.0
3.0,2.5,1650,2.0,0,0,1650,0,2013,424950.0
2.0,2.25,1061,2.0,0,0,1061,0,2013,223990.0
4.0,2.5,3402,2.0,0,0,2846,556,2014,498000.0
4.0,2.5,2542,2.0,0,0,2542,0,2014,359950.0
3.0,2.5,3150,2.0,0,0,3150,0,2007,720000.0
4.0,2.5,3010,2.0,0,0,3010,0,2008,530000.0
3.0,2.5,1660,2.0,0,0,1660,0,2011,295000.0
3.0,2.5,1770,2.0,0,0,1770,0,2009,255500.0
3.0,3.0,1960,2.0,0,0,1600,360,2007,556000.0
4.0,2.5,1889,2.0,0,0,1889,0,2012,277950.0
4.0,2.5,3040,2.0,0,0,3040,0,2007,431000.0
4.0,2.75,3420,2.0,0,0,3420,0,2010,780000.0
3.0,3.25,1720,2.0,0,0,1030,690,2004,649000.0
3.0,2.5,1740,2.0,0,0,1740,0,2012,447000.0
4.0,2.5,2450,2.0,0,0,2450,0,2013,712198.0
3.0,1.5,1190,2.0,0,0,920,270,2014,277140.0
4.0,2.5,3753,2.0,0,0,3336,417,2008,363000.0
5.0,3.5,3440,2.0,0,0,3440,0,2014,598992.0
3.0,2.5,2160,3.0,0,0,1830,330,2010,585000.0
4.0,2.75,3820,2.0,0,0,3820,0,2014,1274950.0
2.0,2.0,1120,2.0,0,0,840,280,2007,380950.0
4.0,2.5,2250,2.0,0,0,2250,0,2014,333490.0
3.0,3.25,1540,2.0,0,0,1540,0,2011,520000.0
2.0,2.25,1240,2.0,0,0,1150,90,2009,315000.0
2.0,1.5,1160,2.0,0,0,1020,140,2007,487000.0
5.0,3.5,2760,2.5,0,0,2760,0,2013,424950.0
3.0,2.25,1580,3.0,0,0,1580,0,2013,542300.0
3.0,3.25,1480,2.0,0,0,1180,300,2013,320000.0
4.0,3.25,3740,2.0,0,0,3740,0,2014,1139990.0
4.0,2.5,1950,2.0,0,0,1950,0,2012,425000.0
3.0,3.0,1530,3.0,0,0,1530,0,2012,474950.0
3.0,2.5,1820,2.0,0,0,1820,0,2014,307635.0
3.0,2.5,2760,2.0,0,0,2760,0,2014,834538.0
5.0,2.75,3010,2.0,0,0,3010,0,2014,769995.0
5.0,3.25,3860,2.0,0,2,3860,0,2006,820875.0
4.0,2.5,2490,2.0,0,0,2490,0,2013,595500.0
4.0,2.5,3236,2.0,0,0,3236,0,2005,450000.0
4.0,2.5,2830,2.0,0,0,2830,0,2003,695000.0
3.0,2.0,1451,1.0,0,0,1451,0,2010,300000.0
5.0,3.25,2910,2.0,0,0,2040,870,2013,515000.0
3.0,2.5,1280,3.0,0,0,1280,0,2009,545000.0
3.0,2.25,1110,2.0,0,0,960,150,2008,365000.0
4.0,2.75,2840,2.0,0,0,2840,0,2008,718500.0
3.0,1.75,1410,2.0,0,0,1410,0,2014,279800.0
4.0,2.5,3250,2.0,0,0,3250,0,2014,486940.0
4.0,2.75,3030,2.0,0,0,3030,0,2011,525000.0
4.0,2.5,1983,2.0,0,0,1983,0,2012,345000.0
3.0,3.25,2440,2.0,0,0,1710,730,2005,613000.0
3.0,2.5,2313,2.0,0,0,2313,0,2011,370000.0
3.0,2.25,1260,2.0,0,0,1260,0,2005,449500.0
3.0,2.5,2000,2.0,0,0,2000,0,2011,515000.0
2.0,1.75,1150,2.0,0,0,1150,0,2013,346100.0
4.0,2.5,2820,2.0,0,0,2820,0,2007,398500.0
2.0,1.75,1160,2.0,0,0,1160,0,2008,310000.0
3.0,2.25,1481,2.0,0,0,1481,0,2012,250000.0
5.0,3.5,4390,2.0,0,3,3170,1220,2013,1880000.0
2.0,1.75,1570,3.0,0,0,1570,0,2007,695000.0
4.0,3.0,3410,2.0,0,2,2680,730,2007,1085000.0
5.0,3.25,3480,2.0,0,0,3480,0,2014,864327.0
4.0,3.25,3430,2.0,0,0,3430,0,2014,749995.0
5.0,2.75,2880,2.0,0,0,2880,0,2006,525000.0
3.0,2.5,2990,2.0,0,0,2990,0,2006,659950.0
5.0,5.0,4490,2.0,0,0,3930,560,2013,1800000.0
5.0,4.0,4100,2.0,0,0,4100,0,2011,950000.0
4.0,2.75,3870,2.0,0,0,3870,0,2005,1399950.0
2.0,1.5,800,2.0,0,0,800,0,2008,265050.0
3.0,2.25,1620,3.0,0,0,1540,80,2009,450000.0
4.0,2.5,2910,3.0,0,0,2910,0,2010,915000.0
4.0,3.25,3530,2.0,0,0,3530,0,2007,963000.0
4.0,2.5,2701,2.0,0,0,2701,0,2013,270000.0
2.0,2.5,1380,2.0,0,0,1140,240,2012,294000.0
3.0,2.5,2050,2.0,0,0,2050,0,2011,700000.0
3.0,4.0,3370,2.0,0,0,3370,0,2014,1065000.0
3.0,2.5,2040,2.0,0,0,1470,570,2008,494900.0
3.0,2.5,1610,2.0,0,0,1610,0,2010,415000.0
3.0,2.5,2680,2.0,0,0,2680,0,2013,459990.0
4.0,3.5,3560,2.0,0,0,3560,0,2014,882990.0
4.0,3.5,3880,2.0,0,0,3060,820,2007,620000.0
3.0,2.0,1824,1.0,0,0,1824,0,2010,375900.0
3.0,2.5,2220,2.0,0,0,2010,210,2012,654000.0
4.0,3.25,4140,2.0,0,0,4140,0,2013,1839900.0
3.0,2.5,1322,2.0,0,0,1322,0,2009,215000.0
3.0,2.5,1909,3.0,0,0,1766,143,2006,630500.0
4.0,3.5,3460,2.0,0,0,3460,0,2010,855000.0
4.0,2.5,1954,2.0,0,0,1954,0,2007,235245.0
5.0,2.5,3000,1.0,0,0,1610,1390,2007,770000.0
4.0,2.5,2650,2.0,0,0,2650,0,2012,734990.0
4.0,2.5,2580,2.0,0,0,2580,0,2013,880000.0
4.0,3.0,2650,2.0,0,0,2650,0,2011,525000.0
4.0,3.5,3390,2.0,0,0,3390,0,2008,775000.0
3.0,1.75,1470,3.0,0,0,1470,0,2009,687015.0
3.0,2.5,1910,2.0,0,0,1910,0,2006,663000.0
4.0,2.5,3030,2.0,0,0,3030,0,2005,815000.0
4.0,3.25,2930,2.0,0,0,2930,0,2013,1050000.0
3.0,2.5,1650,2.0,0,0,1650,0,2014,433190.0
4.0,2.5,2870,2.0,0,0,2870,0,2006,725000.0
3.0,2.5,1608,2.0,0,0,1608,0,2013,279950.0
2.0,2.5,1620,2.0,0,0,1620,0,2014,272167.0
3.0,2.5,1350,2.0,0,0,1120,230,2007,468500.0
3.0,2.5,1950,2.0,0,0,1950,0,2010,298000.0
6.0,4.5,3390,2.0,0,0,2440,950,2007,303500.0
3.0,1.75,1300,2.0,0,0,1060,240,2008,308000.0
3.0,3.0,2230,2.5,0,0,1850,380,2014,646800.0
4.0,2.5,1880,2.0,0,0,1880,0,2010,530200.0
5.0,2.5,3370,2.0,0,0,3370,0,2006,405000.0
2.0,2.5,1320,2.0,0,0,990,330,2014,529000.0
3.0,2.5,2920,2.0,0,0,2920,0,2013,675900.0
3.0,3.25,1550,2.0,0,0,1220,330,2013,570000.0
4.0,2.5,2301,2.0,0,0,2301,0,2010,375500.0
3.0,3.25,1710,2.0,0,0,1360,350,2004,445000.0
4.0,3.75,2890,2.0,0,0,2240,650,2013,1100000.0
3.0,2.5,2100,2.0,0,0,2100,0,2006,477000.0
3.0,2.75,2240,2.0,0,0,2100,140,2014,450000.0
3.0,3.0,1460,3.0,0,0,1460,0,2006,427005.0
3.0,1.75,1370,3.0,0,0,1370,0,2014,720000.0
3.0,3.5,3760,2.0,1,4,2830,930,2014,2230000.0
4.0,3.25,2510,2.0,0,0,2510,0,2009,450800.0
2.0,2.25,1210,2.0,0,0,1120,90,2010,461100.0
4.0,3.0,2990,2.0,0,0,2990,0,2014,1061600.0
3.0,2.5,1710,2.0,0,0,1710,0,2006,590000.0
4.0,2.5,3274,2.0,0,0,3274,0,2014,478830.0
4.0,2.25,3300,3.0,0,0,3300,0,2014,760000.0
4.0,3.5,4370,2.0,0,0,4370,0,2008,1025000.0
4.0,2.5,2050,2.0,0,0,2050,0,2006,385000.0
2.0,2.5,1310,2.0,0,0,1160,150,2006,500000.0
3.0,1.5,1680,1.5,0,0,1680,0,2012,425000.0
3.0,3.0,1330,2.0,0,0,1120,210,2005,552100.0
3.0,3.0,1950,3.0,0,0,1610,340,2009,785000.0
5.0,3.25,3090,2.0,0,0,3090,0,2012,615000.0
3.0,2.5,1950,2.0,0,0,1950,0,2013,309000.0
3.0,2.0,1108,3.0,0,0,1108,0,2009,369500.0
4.0,2.25,2190,2.0,0,0,2190,0,2006,391000.0
3.0,1.75,1590,2.0,0,0,1060,530,2014,465000.0
4.0,2.75,3010,2.0,0,0,3010,0,2014,879950.0
3.0,2.0,1330,2.0,0,0,1060,270,2014,372000.0
3.0,2.5,1550,2.0,0,0,1550,0,2011,259000.0
2.0,1.5,1260,2.0,0,0,1260,0,2001,374000.0
4.0,2.5,2550,2.0,0,0,2550,0,2001,561000.0
3.0,2.5,1300,3.0,0,0,1300,0,2007,610000.0
3.0,3.0,2230,2.5,0,0,1850,380,2014,635000.0
1.0,1.5,1170,2.0,0,0,1070,100,2007,235000.0
4.0,3.5,4170,2.0,0,0,3500,670,2007,623300.0
3.0,2.0,1680,1.0,0,0,1680,0,2007,412500.0
4.0,3.25,2864,3.0,0,0,2864,0,2014,380000.0
3.0,2.25,1630,2.0,0,0,1630,0,2005,497000.0
4.0,2.5,2716,2.0,0,0,2716,0,2014,452000.0
3.0,2.5,1750,2.0,0,0,1750,0,2013,312000.0
5.0,3.0,3223,2.0,0,0,3223,0,2014,469950.0
5.0,2.5,2600,2.0,0,0,2600,0,2014,775000.0
4.0,2.75,3320,2.0,0,0,3320,0,2014,679990.0
4.0,2.0,1350,3.0,0,0,1350,0,2008,288790.0
5.0,2.5,3410,2.0,0,0,3410,0,2007,800000.0
3.0,2.5,1572,2.0,0,0,1572,0,2013,299000.0
4.0,2.5,2300,2.0,0,0,2300,0,2013,332000.0
1.0,1.5,1030,1.0,0,0,1030,0,1940,525000.0
3.0,1.75,1458,2.0,0,0,950,508,2014,620000.0
4.0,2.5,2190,2.0,0,0,2190,0,2007,452000.0
4.0,3.0,3640,2.0,0,0,2740,900,2010,630000.0
4.0,2.75,2790,2.0,0,0,2790,0,2013,485000.0
4.0,2.5,2632,2.0,0,0,2632,0,2013,349950.0
4.0,2.75,2910,2.0,0,0,2910,0,2013,499990.0
2.0,2.25,1470,2.0,0,0,1340,130,2005,510000.0
3.0,2.5,2240,2.0,0,2,2240,0,1995,1080000.0
3.0,2.5,2310,2.0,0,0,2310,0,2011,494000.0
3.0,2.5,2370,2.0,0,0,2370,0,2009,429900.0
4.0,2.75,2980,1.0,0,0,1910,1070,2007,505000.0
4.0,2.0,1870,1.0,0,3,1870,0,2009,272000.0
3.0,2.5,1770,3.0,0,0,1770,0,2012,671500.0
4.0,3.5,3510,2.0,0,0,3510,0,2001,729950.0
4.0,2.5,3281,2.0,0,0,3281,0,2014,471835.0
3.0,2.0,1670,1.0,0,0,1670,0,2014,249950.0
5.0,3.5,2760,2.5,0,0,2760,0,2013,424950.0
5.0,3.5,5430,2.0,0,2,4010,1420,2007,1240000.0
4.0,2.5,2990,2.0,0,0,2990,0,2011,440000.0
4.0,3.5,3170,2.0,0,0,2530,640,2008,495000.0
4.0,2.5,3520,2.5,0,0,2650,870,2006,870000.0
2.0,3.0,1650,3.0,0,0,1350,300,2015,559000.0
4.0,2.75,2656,2.0,0,0,2656,0,2014,495000.0
3.0,2.5,2230,2.0,0,0,2230,0,2014,722000.0
3.0,2.5,2280,2.0,0,0,1880,400,2006,567500.0
4.0,2.5,2798,2.0,0,0,2798,0,2011,440000.0
4.0,2.5,2398,2.0,0,0,2398,0,2008,400000.0
4.0,2.5,2350,2.0,0,0,2350,0,2014,459995.0
5.0,2.75,2410,1.0,0,0,1410,1000,2008,365000.0
3.0,2.25,1580,3.0,0,0,1580,0,2015,389950.0
3.0,3.25,1450,2.0,0,0,1180,270,2013,320000.0
4.0,2.5,1750,2.0,0,0,1750,0,2009,415500.0
3.0,2.5,3020,2.0,0,0,2360,660,2008,775000.0
3.0,3.0,1740,3.0,0,0,1740,0,2007,590000.0
2.0,2.25,2200,2.0,0,0,1760,440,2007,950000.0
4.0,2.5,1867,2.0,0,0,1867,0,2013,378950.0
2.0,1.5,1020,3.0,0,0,1020,0,2008,441750.0
4.0,2.75,2475,2.0,0,0,2475,0,2014,335900.0
2.0,1.75,1110,2.0,0,0,1110,0,2014,229800.0
3.0,2.5,1900,2.5,0,0,1700,200,2007,645000.0
3.0,3.25,1560,2.0,0,0,1260,300,2009,448000.0
4.0,2.5,2510,2.0,0,0,2510,0,2011,706000.0
4.0,4.75,4150,3.0,0,0,4150,0,2014,988990.0
3.0,3.0,1660,3.0,0,0,1660,0,2013,716000.0
2.0,1.5,1090,3.0,0,0,1090,0,2009,319000.0
4.0,2.5,1914,2.0,0,0,1914,0,2009,300000.0
4.0,3.25,2730,1.0,0,0,1560,1170,2007,625000.0
3.0,2.75,2470,2.0,0,0,2470,0,2007,773000.0
5.0,2.5,2340,2.0,0,0,2340,0,2009,392000.0
4.0,3.5,2660,2.0,0,0,1920,740,2014,549995.0
3.0,2.5,2410,2.0,0,0,2410,0,2009,480000.0
3.0,2.25,1430,2.0,0,0,1430,0,2010,355000.0
2.0,2.5,1570,3.0,0,0,1570,0,2007,208400.0
5.0,2.75,3010,2.0,0,0,3010,0,2014,831548.0
4.0,2.5,1613,2.0,0,0,1613,0,2009,279500.0
3.0,2.5,2380,2.0,0,0,2380,0,2008,445000.0
5.0,2.5,2570,2.0,0,0,2570,0,2006,492500.0
4.0,2.5,2550,2.0,0,0,2550,0,2009,435000.0
3.0,2.25,1330,3.0,0,0,1330,0,2007,325000.0
2.0,1.5,1160,2.0,0,0,970,190,2005,453000.0
5.0,3.5,3240,2.0,0,0,2760,480,2014,612995.0
4.0,2.5,2710,2.0,0,0,2710,0,2011,540000.0
3.0,1.0,1150,1.0,0,0,1150,0,1959,465000.0
3.0,2.25,1860,3.0,0,0,1860,0,2014,799950.0
3.0,2.25,1280,2.0,0,0,1080,200,2008,495000.0
3.0,2.5,1810,3.0,0,0,1810,0,2014,579950.0
2.0,2.25,1240,2.0,0,0,1150,90,2008,331000.0
4.0,3.5,1460,3.0,0,0,1460,0,2008,580000.0
2.0,2.5,1640,2.0,0,0,1640,0,2014,669000.0
4.0,4.25,5010,2.0,0,1,4000,1010,2014,2351960.0
3.0,3.25,1300,2.0,0,0,1080,220,2005,539900.0
4.0,2.5,2510,2.0,0,0,2510,0,2010,490000.0
3.0,3.5,2710,2.0,0,0,1650,1060,2005,627000.0
4.0,3.5,3217,2.0,0,0,2587,630,2008,458000.0
3.0,2.5,1650,2.0,0,0,1520,130,2007,440000.0
4.0,3.5,3950,2.0,0,0,3950,0,2015,1698000.0
2.0,2.5,1680,3.0,0,0,1680,0,2009,935000.0
5.0,3.5,3420,2.0,0,2,2700,720,2013,641000.0
3.0,2.75,2300,2.0,0,0,1700,600,2007,452000.0
4.0,2.75,3010,2.0,0,2,2570,440,2012,625000.0
4.0,3.5,4680,2.0,0,0,3040,1640,2008,1350000.0
5.0,3.5,3630,2.0,0,0,2790,840,2014,834950.0
3.0,3.5,3530,2.0,0,0,2370,1160,2008,1500000.0
4.0,2.5,2280,2.0,0,0,2280,0,2006,305000.0
3.0,2.5,3090,2.0,0,0,3090,0,2007,659000.0
1.0,1.0,550,2.0,0,0,550,0,2008,353000.0
4.0,3.25,2840,2.0,0,3,2330,510,2014,535000.0
4.0,2.5,3130,2.0,0,0,3130,0,2013,999000.0
3.0,2.5,1440,3.0,0,0,1440,0,2009,375000.0
4.0,3.5,2840,3.0,0,0,2840,0,2008,685000.0
4.0,2.5,2623,2.0,0,0,2623,0,2012,333000.0
1.0,1.0,390,1.0,0,0,390,0,1920,245000.0
4.0,3.25,5640,2.0,0,2,4900,740,2015,1999950.0
2.0,2.25,1260,2.0,0,0,1170,90,2008,329950.0
2.0,1.0,894,2.0,0,0,894,0,2011,403000.0
4.0,2.5,3370,2.0,0,0,3370,0,2014,559630.0
3.0,2.25,1250,3.0,0,0,1250,0,2007,344000.0
3.0,1.5,1180,3.0,0,0,1180,0,2008,435000.0
2.0,2.5,1520,2.0,0,0,1240,280,2007,430000.0
3.0,2.5,2000,2.0,0,0,2000,0,2010,417000.0
5.0,2.75,3180,2.0,0,0,3180,0,2014,895950.0
4.0,2.75,3050,2.0,0,0,3050,0,2014,563950.0
3.0,1.5,2580,1.0,0,0,1360,1220,1953,332220.0
5.0,6.0,6880,2.0,0,3,4070,2810,2007,1488000.0
3.0,2.5,2570,2.5,0,0,2570,0,2007,680000.0
4.0,3.5,2950,2.0,0,0,2270,680,2012,825750.0
3.0,2.5,1690,2.0,0,0,1410,280,2014,338000.0
4.0,2.75,2790,2.0,0,0,2790,0,2012,535365.0
3.0,2.25,1720,2.0,0,0,1240,480,2011,608000.0
3.0,2.25,2890,3.0,0,0,2890,0,2014,930000.0
2.0,1.75,1130,1.0,0,0,1130,0,2006,565000.0
2.0,2.25,1460,2.0,0,0,1260,200,2005,495000.0
3.0,2.5,2510,2.0,0,0,2510,0,2007,667000.0
4.0,2.5,3390,2.0,0,0,3390,0,2014,495000.0
4.0,2.5,3570,2.0,0,0,3570,0,2014,928990.0
4.0,2.5,2280,2.0,0,0,2280,0,2006,345000.0
5.0,3.5,2920,2.0,0,0,2260,660,2014,1065000.0
4.0,3.0,2590,2.0,0,0,2590,0,2014,519995.0
5.0,2.75,3210,2.0,0,0,3210,0,2014,924000.0
3.0,2.0,1230,1.0,0,0,1230,0,2010,295000.0
3.0,2.5,3800,2.0,0,0,3210,590,2005,472000.0
3.0,2.5,1500,2.0,0,0,1500,0,2005,405000.0
4.0,2.25,2510,2.0,0,0,1840,670,2012,410000.0
3.0,1.5,1400,3.0,0,0,1400,0,2007,419500.0
3.0,2.25,1450,2.0,0,0,1450,0,2009,382000.0
2.0,2.5,1390,2.0,0,0,1180,210,2007,370000.0
3.0,2.75,3160,2.0,0,0,3160,0,2005,553000.0
4.0,3.75,4350,2.0,0,0,4350,0,2013,2065000.0
4.0,2.5,2720,2.0,0,0,2720,0,2015,455950.0
3.0,3.25,1290,3.0,0,0,1290,0,2008,331000.0
3.0,2.25,1606,3.0,0,0,1606,0,2009,417250.0
5.0,3.5,4460,3.0,0,2,3280,1180,2015,490000.0
4.0,3.25,2800,2.0,0,0,2800,0,2011,325000.0
5.0,3.5,3250,2.0,0,0,2410,840,2010,705000.0
6.0,3.5,4310,2.0,0,0,3260,1050,2013,1174660.0
3.0,2.25,1310,2.0,0,0,1060,250,2007,365000.0
2.0,1.5,1240,2.0,0,0,1080,160,2009,403000.0
3.0,2.5,1950,2.0,0,0,1950,0,2007,409000.0
3.0,2.5,1800,2.0,0,0,1800,0,2011,391000.0
4.0,2.5,2650,2.0,0,0,2650,0,2014,542525.0
2.0,1.0,820,3.0,0,0,820,0,2006,339950.0
4.0,2.75,2620,2.0,0,0,2620,0,2012,499990.0
4.0,3.25,3980,2.0,0,0,3980,0,2011,1765000.0
3.0,3.5,1660,2.0,0,0,1260,400,2009,608000.0
4.0,2.5,2130,2.0,0,0,2130,0,2014,392000.0
3.0,1.75,1790,1.5,0,0,1790,0,2003,320000.0
3.0,1.75,1410,2.0,0,0,1410,0,2014,274800.0
3.0,2.25,1330,2.0,0,0,1080,250,2007,325000.0
4.0,2.5,2190,2.0,0,0,2190,0,2009,418500.0
3.0,2.5,2540,2.0,0,0,2540,0,2006,300000.0
3.0,2.5,2244,2.0,0,0,2244,0,2012,269950.0
3.0,2.5,2026,2.0,0,0,2026,0,2010,358000.0
3.0,2.5,1730,2.0,0,0,1730,0,2013,350000.0
4.0,3.5,3910,2.0,0,0,3130,780,2007,782000.0
3.0,2.5,1580,3.0,0,1,1580,0,2009,779000.0
4.0,2.5,2510,2.0,0,0,2510,0,2007,685000.0
2.0,2.25,1000,3.0,0,0,1000,0,2006,305000.0
4.0,2.5,1660,2.0,0,0,1660,0,2007,350000.0
4.0,3.5,3060,2.0,0,0,2410,650,2012,775000.0
3.0,2.5,1980,2.0,0,0,1980,0,2012,317750.0
2.0,1.0,980,2.0,0,0,980,0,2010,438000.0
2.0,2.5,1050,2.0,0,0,1050,0,2005,325000.0
4.0,3.25,3080,2.0,0,0,2230,850,2012,830000.0
3.0,2.25,1900,2.0,0,0,1900,0,2006,353000.0
4.0,2.5,2200,2.0,0,0,2200,0,2010,460000.0
3.0,1.5,1360,3.0,0,0,1360,0,2008,370000.0
3.0,2.5,2238,2.0,0,0,2238,0,2011,330000.0
4.0,2.5,2590,2.0,0,0,2590,0,2014,569888.0
3.0,2.5,2517,2.0,0,0,2517,0,2014,353900.0
4.0,3.5,3510,2.0,0,0,3510,0,2001,695000.0
3.0,1.75,1290,2.0,0,0,1060,230,2008,288790.0
5.0,3.0,2230,1.0,0,0,1330,900,2014,334950.0
4.0,2.75,3140,2.0,0,0,3140,0,2013,869950.0
3.0,3.5,3350,2.0,0,2,2670,680,2014,557500.0
4.0,2.5,2245,2.0,0,0,2245,0,2014,389990.0
3.0,1.75,1420,3.0,0,0,1420,0,2006,455000.0
3.0,3.0,1560,3.0,0,0,1560,0,2006,598500.0
4.0,2.75,2810,2.0,0,0,2810,0,2011,750000.0
2.0,2.25,1630,2.0,0,0,1330,300,2014,729999.0
3.0,2.5,1740,2.0,0,0,1740,0,2012,299950.0
3.0,2.25,1390,3.0,0,0,1390,0,2007,374950.0
3.0,2.5,1070,2.0,0,0,900,170,2009,386950.0
5.0,3.25,2850,2.0,0,0,2370,480,2006,535000.0
5.0,3.25,4100,2.0,0,2,4100,0,2011,890000.0
4.0,2.5,3260,2.0,0,1,2820,440,2007,1050000.0
4.0,3.5,3660,2.0,0,0,2840,820,2014,1107460.0
4.0,2.5,2708,2.0,0,0,2708,0,2014,436952.0
3.0,2.5,1800,2.0,0,0,1800,0,2011,365000.0
3.0,2.5,1150,3.0,0,0,1150,0,2007,288000.0
3.0,2.5,2230,2.0,0,0,2230,0,2014,700000.0
4.0,3.25,3540,2.0,0,0,3540,0,2007,800000.0
4.0,3.5,2490,2.0,0,0,1780,710,2015,899000.0
3.0,2.5,2670,2.0,0,0,2670,0,2007,465750.0
2.0,2.5,1430,3.0,0,0,1410,20,2008,485000.0
5.0,2.75,2670,2.0,0,0,2670,0,2014,494995.0
3.0,2.5,2555,2.0,0,0,2555,0,2006,255000.0
3.0,2.5,1970,2.0,0,0,1970,0,2011,530000.0
3.0,2.0,1980,3.0,0,0,1980,0,2007,435000.0
3.0,2.5,2010,2.0,0,0,1610,400,2014,639000.0
3.0,1.5,1270,3.0,0,0,1270,0,2007,440000.0
4.0,2.5,3950,3.0,0,0,3950,0,2013,914500.0
3.0,2.0,1870,1.0,0,0,1870,0,2009,580000.0
1.0,1.5,1180,2.0,0,0,1070,110,2007,250000.0
3.0,2.5,1420,3.0,0,0,1420,0,2007,410000.0
4.0,2.75,2810,2.0,0,0,2810,0,2014,531155.0
3.0,2.5,1400,2.0,0,0,1400,0,2005,358000.0
3.0,2.5,1950,2.0,0,0,1950,0,2009,425000.0
3.0,2.25,1930,2.0,0,0,1930,0,2004,326000.0
4.0,2.5,2210,2.0,0,0,2210,0,2013,650000.0
4.0,3.5,2630,2.0,0,0,2200,430,2008,749950.0
3.0,1.75,1600,1.0,0,0,1600,0,2014,239950.0
3.0,2.5,1480,2.0,0,0,1150,330,2010,315000.0
2.0,2.5,750,2.0,0,0,750,0,2006,375000.0
3.0,1.5,1290,3.0,0,0,1290,0,2007,375000.0
3.0,3.25,1340,3.0,0,0,1340,0,2008,349000.0
2.0,1.5,1020,3.0,0,0,1020,0,2008,450000.0
3.0,3.0,2330,2.5,0,0,1950,380,2014,669950.0
5.0,3.0,2360,1.0,0,0,1390,970,2008,504600.0
3.0,2.5,1495,3.0,0,0,1405,90,2006,400000.0
4.0,3.5,3770,2.0,0,0,3770,0,2008,1020000.0
5.0,2.5,2890,2.0,0,0,2890,0,2006,518000.0
3.0,2.75,1320,3.0,0,0,1320,0,2008,535000.0
4.0,2.5,2330,2.0,0,0,2330,0,2013,337500.0
4.0,2.5,3120,2.0,0,0,3120,0,2005,380000.0
5.0,3.0,2960,2.0,0,0,2960,0,2004,875000.0
3.0,2.25,1630,3.0,0,0,1630,0,2008,385000.0
5.0,3.5,5230,2.0,0,0,4450,780,2014,1987500.0
4.0,3.0,3150,2.0,0,0,3150,0,2008,649500.0
4.0,3.75,3280,2.0,0,0,2320,960,2008,1050000.0
3.0,1.0,1030,1.0,0,2,1030,0,1943,249000.0
4.0,2.5,3130,2.0,0,0,3130,0,2008,525000.0
3.0,3.5,1240,2.0,0,0,1000,240,2008,402000.0
4.0,2.75,3560,2.0,0,0,3560,0,2014,1750000.0
5.0,2.5,2170,2.0,0,0,2170,0,2014,359800.0
3.0,2.5,1520,2.0,0,0,1520,0,2009,330000.0
3.0,2.5,1270,2.0,0,0,1060,210,2008,433000.0
4.0,3.25,3610,2.0,0,0,2640,970,2007,1010800.0
3.0,2.75,3230,2.0,0,0,2680,550,2014,599832.0
5.0,3.0,2300,2.0,0,0,2300,0,2013,312891.0
2.0,2.5,1460,2.0,0,0,1160,300,2008,449000.0
3.0,2.5,1750,3.0,0,0,1750,0,2013,495000.0
5.0,2.75,3030,2.0,0,0,3030,0,2013,819995.0
3.0,3.5,1522,2.0,0,0,1248,274,2006,407500.0
4.0,3.75,3890,2.0,0,0,3890,0,2007,850000.0
5.0,4.0,4590,2.0,0,0,4590,0,2008,1720000.0
4.0,4.0,4620,2.0,0,0,4620,0,2014,1459000.0
4.0,2.75,3220,2.0,0,0,3220,0,2012,579000.0
5.0,2.75,3170,2.0,0,0,3170,0,2014,890776.0
2.0,2.5,980,3.0,0,0,980,0,2008,352500.0
3.0,1.75,2340,1.0,0,0,2340,0,2010,529000.0
3.0,2.25,1620,3.0,0,0,1540,80,2009,484000.0
3.0,2.5,1910,3.0,0,0,1910,0,2007,400000.0
3.0,2.5,2420,2.0,0,0,2420,0,2009,649950.0
3.0,4.5,3850,2.0,0,0,3120,730,2013,915000.0
5.0,2.5,3220,2.0,0,0,3220,0,2006,534950.0
4.0,2.5,3040,2.0,0,0,3040,0,2008,776000.0
3.0,1.75,1496,2.0,0,0,1248,248,2006,370000.0
3.0,1.75,1630,3.0,0,0,1630,0,2014,610000.0
5.0,3.5,4200,2.0,0,0,3140,1060,2012,850000.0
3.0,2.5,2430,2.0,0,0,2430,0,2007,443000.0
5.0,4.25,4010,2.0,0,0,4010,0,2015,1150000.0
3.0,2.5,1510,2.5,0,0,1330,180,2011,453000.0
4.0,3.5,2340,2.0,0,2,1730,610,2011,735000.0
2.0,2.75,2700,1.0,0,0,2700,0,2007,810000.0
3.0,3.5,4360,2.0,0,3,2960,1400,2008,1555000.0
5.0,6.5,7270,2.0,0,0,6420,850,2010,2238890.0
3.0,2.5,1350,3.0,0,0,1270,80,2006,377500.0
3.0,3.25,1380,3.0,0,0,1380,0,2008,482000.0
2.0,2.5,1830,2.0,0,0,1530,300,2011,600000.0
3.0,2.5,1470,2.0,0,0,1180,290,2007,420000.0
4.0,2.5,2940,2.0,0,0,2940,0,2006,480000.0
2.0,2.0,1110,3.0,0,0,980,130,2008,406000.0
4.0,2.5,2790,2.0,0,0,2790,0,2009,505000.0
4.0,3.75,3790,2.0,0,0,3290,500,2006,1865000.0
4.0,2.5,3570,2.0,0,0,3570,0,2014,942990.0
3.0,2.25,1230,3.0,0,0,1230,0,2009,440000.0
3.0,3.25,1370,2.0,0,0,1100,270,2006,390000.0
3.0,3.25,1380,3.0,0,0,1380,0,2008,475000.0
1.0,2.0,1070,2.0,0,0,880,190,2007,420000.0
4.0,4.0,4920,2.0,0,0,4280,640,2012,1408760.0
5.0,3.5,5150,2.0,0,2,3700,1450,2007,1378000.0
6.0,3.0,2390,2.0,0,0,2390,0,2014,462500.0
4.0,2.75,2460,2.0,0,0,2460,0,2011,579950.0
4.0,2.5,3650,2.0,0,0,3650,0,2008,861111.0
4.0,3.5,4300,2.0,0,0,4300,0,2014,1450000.0
3.0,2.25,1610,2.0,0,0,1610,0,2012,290000.0
4.0,2.5,2610,2.0,0,0,2610,0,2008,535000.0
3.0,2.5,1750,3.0,0,0,1750,0,2008,585000.0
3.0,2.5,3310,2.0,0,2,2440,870,2008,670000.0
4.0,3.75,5090,1.0,0,0,4180,910,2013,3000000.0
3.0,2.0,1060,2.0,0,0,730,330,2006,346000.0
4.0,4.0,4420,2.0,0,0,4420,0,2013,1325000.0
3.0,2.5,2100,2.0,0,0,2100,0,2008,999999.0
3.0,1.75,1650,3.0,0,0,1650,0,2014,599000.0
4.0,2.5,2380,2.0,0,0,2380,0,2010,332000.0
2.0,2.25,1170,2.0,0,0,1170,0,2009,336750.0
4.0,2.5,2531,2.0,0,0,2531,0,2013,370000.0
3.0,2.25,998,2.0,0,0,798,200,2007,324000.0
3.0,2.25,1333,3.0,0,3,1333,0,2009,338500.0
5.0,3.5,4410,2.0,0,3,2920,1490,2014,1881580.0
3.0,2.75,1160,2.0,0,0,880,280,2007,402723.0
4.0,3.25,2630,2.0,0,0,2630,0,2014,715000.0
3.0,1.5,1160,3.0,0,0,1160,0,2008,459000.0
3.0,2.5,2140,2.0,0,0,1960,180,2006,589999.0
4.0,2.5,1980,2.0,0,0,1980,0,2007,405000.0
3.0,2.5,3030,2.0,0,0,3030,0,2009,509900.0
2.0,2.0,1490,2.0,0,0,1190,300,2009,327000.0
2.0,1.5,2370,2.0,0,0,2370,0,2005,1057000.0
3.0,2.5,1820,2.0,0,0,1570,250,2008,327500.0
3.0,2.0,1260,2.0,0,0,810,450,2011,249000.0
5.0,4.5,4350,2.0,0,0,4350,0,2014,1375000.0
1.0,1.25,1100,3.0,0,0,1100,0,2014,516500.0
3.0,2.5,2050,2.0,0,0,2050,0,2006,465000.0
3.0,2.5,2198,2.0,0,2,2198,0,2010,388000.0
3.0,2.25,1230,3.0,0,0,1230,0,2013,549000.0
2.0,2.0,1400,2.0,0,0,940,460,2006,553000.0
3.0,2.5,1410,2.0,0,0,1140,270,2010,530000.0
3.0,2.5,2110,2.0,0,0,1410,700,2014,747450.0
2.0,2.5,1590,2.0,0,0,1220,370,2009,305000.0
5.0,2.5,3370,2.0,0,0,3370,0,2007,540000.0
5.0,4.0,4500,2.0,0,0,4500,0,2007,750000.0
4.0,2.5,2930,2.0,0,0,2930,0,2008,422000.0
4.0,2.5,2470,2.0,0,0,2470,0,2005,337000.0
5.0,2.75,3080,2.0,0,0,3080,0,2014,579950.0
4.0,2.75,2260,2.0,0,0,2260,0,2014,341780.0
4.0,3.0,1670,2.0,0,0,1350,320,2008,710200.0
3.0,3.25,1540,3.0,0,0,1540,0,2013,690000.0
4.0,3.5,3830,2.0,0,0,3120,710,2014,1700000.0
2.0,2.5,980,3.0,0,0,980,0,2008,329000.0
3.0,2.5,1450,1.0,0,0,840,610,2007,330000.0
4.0,3.5,2850,2.0,0,0,1950,900,2014,608500.0
3.0,1.75,1140,2.0,0,0,1140,0,2014,230000.0
4.0,3.5,3070,2.0,0,0,2190,880,2009,785000.0
3.0,3.0,1680,3.0,0,0,1680,0,2014,610950.0
3.0,2.5,3087,2.0,0,0,3087,0,2014,399950.0
5.0,4.5,4850,2.0,1,4,3540,1310,2007,3567000.0
4.0,3.25,1900,2.0,0,0,1250,650,2014,579000.0
2.0,1.5,940,2.0,0,0,940,0,2009,362500.0
3.0,3.25,1730,2.0,0,2,1320,410,2008,645000.0
3.0,3.0,2780,2.0,0,0,2780,0,2013,594866.0
3.0,3.0,2780,2.0,0,0,2780,0,2013,625000.0
3.0,2.25,1500,2.0,0,0,1220,280,2006,490000.0
2.0,1.0,710,2.0,0,0,710,0,1943,399950.0
3.0,2.5,1260,2.0,0,0,940,320,2007,380000.0
3.0,2.5,1870,2.0,0,0,1870,0,2009,270000.0
2.0,2.5,1430,3.0,0,0,1430,0,2009,505000.0
3.0,2.5,1520,3.0,0,0,1520,0,2006,385000.0
2.0,1.5,1210,2.0,0,0,1020,190,2007,414500.0
3.0,2.5,2540,2.0,0,0,2540,0,2010,347500.0
4.0,3.5,4910,1.5,0,0,3110,1800,2007,1222500.0
4.0,2.75,2770,2.0,0,0,2770,0,2014,572000.0
3.0,2.25,1190,3.0,0,0,1190,0,2008,475000.0
5.0,3.75,4170,2.0,0,2,4170,0,2006,1088000.0
4.0,2.75,2500,2.0,0,0,2500,0,2008,350000.0
2.0,2.25,1530,3.0,0,0,1480,50,2006,520000.0
5.0,2.75,3600,2.0,0,0,3600,0,2014,679950.0
4.0,3.25,3410,2.0,0,0,3410,0,2007,1575000.0
4.0,2.5,3118,2.0,0,2,3118,0,2014,541800.0
4.0,3.0,3990,2.0,0,0,3990,0,2003,810000.0
5.0,3.75,4470,2.0,0,0,4470,0,2008,1537000.0
3.0,2.5,1425,3.0,0,0,1425,0,2008,467000.0
3.0,1.75,1500,1.0,0,0,1500,0,2014,224000.0
3.0,2.5,2270,2.0,0,0,2270,0,2003,507250.0
3.0,2.0,1490,3.0,0,0,1490,0,2014,429000.0
4.0,2.5,2520,2.0,0,0,2520,0,2014,610685.0
4.0,3.5,3510,2.0,0,0,2600,910,2009,1007500.0
3.0,2.5,1310,2.0,0,0,1180,130,2008,475000.0
3.0,2.5,1530,3.0,0,0,1530,0,2009,360000.0
4.0,2.5,2310,2.0,0,0,2310,0,2014,400000.0
2.0,0.75,1020,2.0,0,0,1020,0,2009,402101.0
3.0,2.5,1600,2.0,0,0,1600,0,2004,400000.0
2.0,0.75,1020,2.0,0,0,1020,0,2008,325000.0
